Field,Career,GPA,Extracurricular_Activities,Internships,Projects,Leadership_Positions,Field_Specific_Courses,Research_Experience,Coding_Skills,Communication_Skills,Problem_Solving_Skills,Teamwork_Skills,Analytical_Skills,Presentation_Skills,Networking_Skills,Industry_Certifications,Academic_Stream,Education_Level,Age_Group,Work_Experience_Years,Career_Break,Career_Break_Months,Preferred_Work_Mode,Location_Preference,Family_Support_Score,English_Proficiency,Entrepreneurship_Interest,Risk_Tolerance,Leadership_Readiness,Certifications_Interest,Work_Life_Balance_Priority,Salary_Expectation_Lakh,Industry_Preference,Public_Speaking_Confidence,Conflict_Resolution_Skills,Stress_Management_Skills,Adaptability_Score,Mentoring_Experience,Innovation_Interest,Customer_Focus,Data_Driven_Thinking,Continuous_Learning,Career_Goal_Clarity,Willing_To_Relocate,Prefer_Corporate,Domain_Expertise_Depth,Current_Role_Success,Success_Percentage
Engineering,Urban Planner,3.530438534147387,5,0,2,0,3,1,4,4,2,2,1,0,1,1,Science,Bachelors,36-40,7,1,10,Hybrid,Tier2_City,5,3,2,4,2,1,3,18.22,Other,4,2,5,2,0,0,3,1,2,2,1,0,4,4,50.62
Chemistry,Art Director,4.018247221685561,1,2,0,0,8,1,3,4,0,3,0,3,0,1,Science,PhD,25-30,7,0,0,Hybrid,Any,1,1,3,5,1,1,4,13.94,Other,1,3,1,3,3,3,3,5,1,2,0,0,4,5,53.72
Engineering,Chemist,4.636733223332204,1,0,0,0,5,0,1,1,1,2,2,3,4,1,Science,Masters,31-35,4,0,0,Office,Any,4,5,2,3,2,1,3,15.66,Other,3,3,3,1,1,2,5,2,1,2,1,1,5,1,37.47
Physics,Manager,4.052692953534206,3,1,3,0,1,0,4,1,3,1,2,1,2,0,Science,Masters,25-30,14,0,0,Hybrid,Tier2_City,2,2,4,5,1,0,1,7.4,Finance,3,1,1,3,5,2,1,5,4,4,0,1,5,2,64.83
Law,Education Administrator,4.834850008942559,0,2,4,0,0,0,4,4,3,4,4,3,2,0,Arts,Bachelors,31-35,12,0,0,Hybrid,Any,1,5,2,5,4,3,2,23.04,Manufacturing,1,3,3,4,5,4,4,3,3,2,1,1,3,1,71.69
Marketing,Accountant,4.029891529095423,2,0,0,1,2,0,0,2,4,3,1,2,4,1,Commerce,Bachelors,25-30,2,1,12,Hybrid,Tier1_City,1,5,2,2,3,2,3,14.06,Tech,2,5,3,4,1,2,5,1,1,2,0,0,1,1,39.1
Medicine,Cybersecurity Analyst,3.226644909827205,4,0,1,1,0,1,1,2,4,2,2,3,0,0,Science,Bachelors,25-30,8,0,0,Office,Tier2_City,4,2,0,3,5,0,1,24.07,Education,2,2,5,4,2,0,2,2,1,4,0,0,4,3,56.25
Computer Science,Special Education Teacher,4.378898512867637,2,1,0,0,0,0,2,3,3,4,4,2,4,0,Science,Masters,25-30,11,0,0,Remote,Tier3_City,3,1,2,3,1,3,2,40.23,Healthcare,5,3,1,4,2,1,1,4,5,3,0,1,5,2,76.36
Education,Civil Engineer,3.6712135301622952,3,2,0,1,3,0,0,0,1,0,2,3,3,1,Arts,Masters,25-30,6,0,0,Remote,Tier1_City,3,1,2,3,3,2,4,24.07,Education,5,5,4,1,3,3,4,2,1,1,1,0,4,3,35.68
Medicine,Artist,3.905219850365391,5,2,2,1,7,0,2,4,4,4,0,3,2,1,Science,Masters,25-30,0,0,0,Remote,Any,2,4,1,5,3,1,4,47.87,Finance,3,5,5,2,5,3,1,5,2,3,0,0,4,4,49.75
Business,Architect,3.983628858616102,0,2,1,1,5,1,2,4,1,3,0,0,4,1,Commerce,High School,25-30,7,0,0,Remote,Tier1_City,5,4,4,4,1,3,4,9.95,Education,1,4,1,3,2,0,2,4,1,4,0,0,5,5,39.57
Education,Graphic Designer,4.831142370138503,5,1,1,1,5,1,1,1,4,2,4,0,2,0,Arts,PhD,25-30,9,0,0,Hybrid,Tier1_City,1,1,3,3,4,1,5,42.96,Manufacturing,2,4,1,4,1,2,1,5,2,3,0,1,2,4,67.03
Engineering,Acoustics Specialist,2.519861098579108,4,2,3,1,4,1,1,3,2,3,4,1,2,0,Science,Masters,18-24,12,0,0,Office,Tier1_City,4,1,0,5,0,3,5,14.67,Manufacturing,3,3,1,2,4,0,5,3,1,2,1,0,5,3,51.81
Chemistry,Organic Chemist,3.4993573182286166,4,2,4,0,7,0,2,1,2,1,4,2,2,0,Science,Bachelors,18-24,4,0,0,Hybrid,Tier1_City,5,4,3,2,3,5,5,46.89,Healthcare,2,5,4,3,0,3,5,4,4,4,0,1,5,4,54.37
Engineering,Interior Designer,3.051281363601992,0,0,0,1,0,0,3,0,1,0,3,0,3,0,Science,Bachelors,25-30,5,0,0,Remote,Tier2_City,5,4,2,4,3,4,5,13.68,Other,1,1,5,1,3,0,1,1,4,4,0,1,4,5,45.33
Architecture,Game Developer,4.882464657587002,3,2,1,1,1,1,2,2,1,0,1,3,2,1,Interdisciplinary,Bachelors,18-24,8,1,48,Hybrid,Tier2_City,3,1,1,2,4,1,1,38.11,Tech,2,4,4,5,5,3,3,4,5,1,1,1,1,5,52.49
Chemistry,Music Teacher,2.849628835834241,0,2,3,1,0,0,2,3,2,3,4,2,3,0,Science,Bachelors,18-24,9,0,0,Flexible,Tier1_City,1,2,2,4,4,1,1,5.92,Education,4,5,3,1,2,2,1,2,3,1,0,0,4,4,57.48
Law,Market Research Analyst,3.325656325067502,0,2,3,0,7,0,2,0,4,3,1,3,0,1,Arts,Bachelors,36-40,14,0,0,Hybrid,Tier3_City,2,1,2,5,2,1,4,32.6,Healthcare,5,4,2,5,2,5,5,2,5,3,0,1,4,2,64.48
Music,Conductor,2.861092300527823,5,1,1,1,0,1,2,2,1,3,4,3,1,1,Arts,Bachelors,18-24,13,0,0,Flexible,Tier1_City,4,2,5,1,4,5,2,13.28,Manufacturing,2,2,4,4,1,3,4,4,1,2,0,0,5,1,57.63
Medicine,Chemical Engineer,4.189086124027632,6,2,2,0,4,1,1,2,3,3,3,3,1,1,Science,Bachelors,31-35,7,1,10,Remote,Tier3_City,1,2,5,4,3,0,5,34.5,Other,1,5,3,2,2,0,1,2,1,1,0,0,4,5,49.43
Marketing,School Psychologist,4.670245899434831,4,0,4,0,3,1,1,0,3,1,0,1,2,1,Commerce,Masters,25-30,13,0,0,Remote,Tier1_City,5,2,0,2,1,2,2,32.88,Tech,1,5,4,2,0,4,2,5,1,3,0,0,4,2,46.71
Physics,Psychologist,4.045535068198723,1,0,2,1,6,1,2,0,0,3,0,0,4,0,Science,Bachelors,36-40,10,1,19,Office,Tier2_City,5,4,0,5,0,1,1,46.41,Tech,4,2,1,3,3,3,2,1,1,3,0,1,1,4,39.57
Biology,Special Education Teacher,3.0815093503014723,7,0,0,1,6,0,4,3,0,2,1,1,3,1,Science,Bachelors,25-30,13,0,0,Hybrid,Tier1_City,2,3,3,4,2,1,5,32.45,Finance,1,4,2,5,2,4,4,3,2,5,1,1,2,1,57.46
Computer Science,Surgeon,3.293037413815491,2,1,2,0,8,1,0,0,3,1,1,4,2,0,Science,Bachelors,25-30,13,1,53,Office,Tier2_City,3,1,2,1,1,0,1,22.19,Other,4,2,2,5,4,4,4,5,3,5,1,1,2,5,55.35
Finance,Digital Marketing Specialist,4.411688423234405,8,0,4,0,8,1,3,0,0,1,0,1,4,1,Commerce,Bachelors,25-30,2,0,0,Flexible,Tier3_City,2,5,5,1,0,0,1,12.1,Manufacturing,3,3,3,3,4,4,4,3,4,2,0,1,2,1,30.22
Chemistry,Forensic Psychologist,4.91524984804653,1,2,3,0,9,1,0,0,4,1,0,3,0,0,Science,Masters,25-30,12,1,35,Remote,Any,2,5,3,3,0,4,3,33.9,Tech,2,1,4,2,5,0,4,1,3,5,0,0,2,2,55.59
Architecture,Judge,4.597910696845415,1,1,4,1,8,0,1,0,2,3,4,3,2,1,Interdisciplinary,Bachelors,25-30,4,1,24,Office,Tier1_City,1,1,2,3,0,3,1,8.47,Finance,1,4,4,2,5,0,1,4,2,2,0,0,4,2,40.72
Biology,Analytical Chemist,2.878498258050343,6,2,1,0,3,1,0,4,1,0,1,0,3,1,Science,Bachelors,18-24,3,0,0,Hybrid,Tier2_City,3,2,0,2,5,1,4,41.94,Finance,5,5,4,3,3,2,4,2,1,2,0,1,3,2,36.63
Medicine,Illustrator,4.419582883962078,8,2,0,0,7,1,1,4,2,0,1,2,1,1,Science,Masters,40+,13,0,0,Flexible,Tier2_City,5,4,1,4,1,3,1,14.62,Manufacturing,2,3,3,5,4,3,4,4,2,4,0,0,3,3,57.95
Music,Web Developer,3.6660943730625073,5,0,0,1,8,0,1,1,2,3,0,3,1,0,Arts,High School,25-30,0,0,0,Hybrid,Any,3,4,5,4,2,0,5,27.64,Tech,4,4,4,4,4,5,3,4,4,3,0,0,4,5,38.26
Computer Science,Art Therapist,2.5841469169994107,0,2,4,1,6,1,3,2,1,0,2,2,4,1,Science,Masters,25-30,4,0,0,Remote,Tier3_City,1,2,5,3,2,0,4,31.01,Other,2,1,2,3,5,1,2,1,3,5,0,1,4,4,52.12
Chemistry,Counselor,3.409774458210828,7,1,1,1,5,1,0,0,1,2,0,2,2,0,Science,Bachelors,31-35,9,1,55,Hybrid,Tier1_City,1,1,3,4,0,4,1,20.04,Tech,2,5,2,2,2,5,1,5,1,1,1,0,2,4,32.22
Chemistry,Nurse,4.997478345619685,2,0,4,0,5,1,0,0,2,3,1,4,0,0,Science,Bachelors,25-30,6,0,0,Flexible,Tier2_City,2,5,3,4,1,2,4,34.2,Education,1,2,5,4,4,4,5,1,5,2,1,0,4,5,51.15
Marketing,Chemical Engineer,3.2274262997873766,1,1,4,1,1,0,4,2,0,1,1,4,2,1,Commerce,PhD,36-40,0,0,0,Remote,Tier1_City,1,4,4,1,5,5,1,14.76,Tech,5,1,4,4,2,3,3,4,4,2,0,0,5,2,52.3
Architecture,Marketing Manager,3.038927520900584,5,1,1,1,5,1,1,2,2,3,1,2,0,0,Interdisciplinary,PhD,25-30,3,0,0,Remote,Tier3_City,3,2,5,3,0,5,4,4.63,Finance,3,4,4,5,0,4,3,3,1,3,1,0,1,2,45.49
Psychology,Teacher,4.566338664638026,1,0,4,0,0,0,4,0,4,1,4,0,2,0,Arts,Masters,31-35,5,0,0,Hybrid,Tier3_City,2,4,4,5,4,5,2,48.09,Healthcare,5,5,2,3,1,5,5,1,5,3,1,0,1,3,61.94
Art,Doctor,3.19249995864387,5,0,2,0,6,1,2,3,4,0,2,3,3,1,Arts,Bachelors,18-24,10,1,42,Office,Any,2,2,1,3,2,0,3,18.04,Manufacturing,4,4,2,4,5,2,3,5,4,5,0,1,5,2,65.05
Engineering,Paralegal,2.9207042900764284,1,2,4,0,4,1,1,3,4,1,2,3,0,1,Science,Bachelors,36-40,11,1,39,Hybrid,Tier2_City,2,4,5,5,3,1,4,36.53,Healthcare,5,1,1,1,2,0,1,1,1,5,1,1,1,1,58.7
Music,Art Director,3.78292121385146,6,1,3,0,8,1,2,1,2,4,4,1,2,0,Arts,Masters,31-35,8,0,0,Remote,Tier2_City,3,5,4,1,0,4,5,26.85,Tech,5,5,1,4,1,5,2,2,5,2,0,0,3,3,60.84
Law,Psychologist,4.581031654142441,9,0,0,0,9,0,0,1,2,4,3,3,0,0,Arts,Bachelors,18-24,10,1,51,Hybrid,Tier2_City,2,4,1,2,4,2,3,34.44,Other,4,1,5,4,2,5,4,5,1,4,0,0,2,2,60.76
Law,Data Scientist,3.452044937923984,5,2,3,0,3,0,3,2,0,3,0,1,0,1,Arts,Bachelors,18-24,7,1,23,Remote,Tier2_City,4,1,2,4,2,5,3,8.21,Other,5,4,2,4,2,1,3,2,3,1,0,0,3,5,41.89
Physics,Software Developer,3.038082477030586,7,1,3,0,5,1,1,3,4,1,0,4,4,1,Science,Bachelors,25-30,1,0,0,Remote,Tier1_City,4,3,4,1,5,4,1,27.39,Finance,3,5,5,3,3,5,1,3,3,1,0,0,3,4,46.24
Marketing,Graphic Designer,3.3871950610516777,3,0,2,0,1,0,3,3,2,0,2,4,1,0,Commerce,High School,40+,10,1,49,Hybrid,Tier3_City,3,2,4,4,1,0,4,21.43,Healthcare,2,5,4,5,2,0,3,4,5,2,1,0,5,4,60.94
Marketing,Urban Planner,4.033337379126986,2,0,4,1,5,0,1,2,1,2,3,3,3,1,Commerce,PhD,25-30,2,0,0,Hybrid,Tier1_City,5,3,3,2,2,5,3,24.24,Manufacturing,3,5,4,5,4,2,1,2,3,3,0,1,5,2,55.08
Architecture,Investment Banker,2.790305704303844,3,0,3,1,3,1,3,2,3,2,2,2,2,1,Interdisciplinary,Bachelors,25-30,9,0,0,Hybrid,Tier1_City,5,5,1,2,1,2,5,48.41,Education,2,4,2,1,4,2,3,2,3,2,1,1,2,2,51.15
Education,Curriculum Developer,3.0508604172686944,3,2,1,0,7,0,2,4,0,4,2,0,3,0,Arts,Masters,18-24,12,0,0,Remote,Tier3_City,2,5,3,1,1,3,5,9.41,Healthcare,2,3,3,1,2,4,1,4,4,2,0,0,5,4,59.8
Medicine,Microbiologist,4.690325622614975,6,2,1,0,5,0,4,2,1,4,2,0,0,1,Science,Bachelors,25-30,4,1,34,Hybrid,Any,3,3,4,2,5,2,5,38.47,Other,5,4,5,4,5,0,4,3,2,1,1,0,1,3,49.23
Chemistry,Surgeon,3.1417042275029963,8,2,3,0,0,0,3,1,3,3,0,3,4,0,Science,Bachelors,25-30,10,0,0,Office,Tier2_City,2,5,5,5,5,1,1,18.53,Education,2,2,3,4,5,0,1,4,3,2,0,1,1,4,59.96
Music,Interior Designer,4.179276864405921,7,1,3,1,8,0,1,3,2,2,4,3,1,0,Arts,Bachelors,40+,6,0,0,Hybrid,Tier3_City,2,5,2,2,0,5,2,16.65,Other,4,3,4,4,5,1,5,2,5,2,0,0,1,1,58.14
Chemistry,Education Administrator,4.212333987547685,0,1,4,1,9,1,4,1,3,3,0,0,3,1,Science,Bachelors,25-30,2,0,0,Hybrid,Tier3_City,4,2,0,4,0,5,4,15.73,Tech,3,4,5,1,0,3,3,1,4,3,0,1,1,3,41.2
Computer Science,Data Scientist,3.621420878875026,0,0,0,1,5,0,2,1,4,3,0,2,4,0,Science,PhD,36-40,11,0,0,Remote,Tier1_City,1,2,1,4,2,3,3,19.39,Tech,2,2,4,5,4,2,4,2,5,4,0,1,5,4,71.95
Business,Mechanical Engineer,2.759921182051804,1,1,2,0,4,0,0,0,0,3,2,4,4,1,Commerce,Masters,25-30,6,1,12,Remote,Tier1_City,3,2,1,4,5,3,4,19.78,Manufacturing,5,1,1,1,1,4,3,4,3,1,1,1,3,5,47.36
Physics,Urban Planner,3.74708005223676,7,2,2,1,2,0,3,1,1,1,3,1,4,1,Science,PhD,18-24,4,0,0,Flexible,Any,1,1,2,4,4,5,3,15.73,Education,5,2,2,5,0,5,1,5,1,4,0,1,1,3,57.95
Education,Biochemist,3.500019315410001,4,2,4,1,8,1,2,0,1,4,2,0,2,0,Arts,Masters,25-30,9,0,0,Hybrid,Any,4,1,2,5,2,1,1,34.37,Education,5,5,1,1,1,1,3,5,1,3,1,1,2,2,51.6
Engineering,Nuclear Physicist,2.929644640829822,0,0,2,1,3,1,2,1,4,1,0,3,1,0,Science,Masters,25-30,5,0,0,Hybrid,Tier2_City,1,1,1,3,3,3,4,5.24,Manufacturing,1,3,5,5,2,5,2,4,3,5,0,1,4,5,57.42
Medicine,Market Research Analyst,2.8670739690819045,6,2,2,1,6,0,1,4,2,1,4,2,3,0,Science,PhD,40+,5,0,0,Flexible,Tier1_City,4,1,1,1,1,0,1,18.62,Other,3,4,1,1,2,0,1,5,1,2,0,0,3,3,51.77
Biology,Aerospace Engineer,3.8951305108248526,9,0,3,1,8,1,2,3,1,1,2,0,4,1,Science,Bachelors,36-40,10,0,0,Office,Any,5,3,2,4,1,5,1,16.17,Healthcare,5,4,5,5,2,4,1,4,2,4,1,1,1,3,56.14
Chemistry,Microbiologist,3.8695643464862863,6,1,4,1,8,0,3,4,4,2,3,1,3,0,Science,Bachelors,18-24,10,0,0,Office,Tier3_City,4,2,5,2,0,2,4,38.32,Manufacturing,4,5,3,3,4,2,3,1,5,2,0,1,5,3,62.54
Finance,Game Developer,3.752472237757201,1,2,1,1,0,1,3,0,3,0,4,2,0,1,Commerce,High School,18-24,13,0,0,Office,Tier1_City,3,5,2,4,4,2,4,9.89,Tech,5,3,2,3,5,2,4,4,2,2,0,0,3,3,51.03
Law,Conductor,3.5092061094428795,6,1,2,1,6,1,1,1,3,0,1,4,4,1,Arts,Bachelors,18-24,11,0,0,Remote,Tier1_City,5,4,2,2,5,1,3,47.21,Education,1,3,3,2,0,3,5,1,4,1,1,0,1,2,55.8
Art,Game Developer,4.543993395432022,3,0,0,1,5,0,1,0,0,2,0,2,1,0,Arts,Bachelors,36-40,3,0,0,Flexible,Any,2,1,4,2,5,0,5,11.01,Finance,3,5,4,5,1,0,4,5,3,4,1,1,5,1,43.04
Medicine,Animator,4.868112458444806,4,0,0,1,1,1,0,0,0,3,2,1,1,1,Science,Bachelors,36-40,11,0,0,Flexible,Tier1_City,3,5,5,4,0,3,1,20.39,Other,2,3,2,5,3,2,5,3,5,5,1,0,2,2,53.17
Law,Sound Engineer,3.5918948428140984,4,2,4,1,0,1,3,3,2,1,4,2,0,1,Arts,Masters,31-35,7,1,14,Remote,Tier1_City,3,2,1,5,3,5,2,12.39,Finance,3,5,1,5,5,4,2,5,3,1,1,1,2,5,60.46
Psychology,Financial Advisor,3.561989740642229,5,1,1,1,1,1,0,0,2,3,1,0,3,0,Arts,Bachelors,25-30,8,0,0,Office,Tier2_City,3,3,1,2,2,2,3,16.47,Tech,2,2,5,2,0,4,5,4,3,2,1,1,4,1,44.78
Education,Curriculum Developer,3.4823549430047414,7,1,4,1,7,1,0,0,2,1,2,4,3,1,Arts,Bachelors,25-30,1,1,48,Hybrid,Tier1_City,1,5,2,2,2,2,3,38.77,Education,2,5,2,1,1,4,4,5,2,4,1,1,4,5,35.01
Law,Landscape Architect,3.062612942473321,0,0,3,0,6,1,0,2,0,0,1,1,3,1,Arts,Bachelors,25-30,8,0,0,Office,Tier1_City,1,4,3,4,4,2,5,25.39,Education,5,4,4,3,3,0,5,3,1,4,0,0,4,1,39.33
Marketing,Manager,4.385635955324699,8,0,3,1,2,0,2,4,2,1,2,4,3,0,Commerce,Bachelors,25-30,10,0,0,Remote,Tier1_City,2,5,0,2,0,2,5,10.64,Manufacturing,4,1,3,2,0,0,5,5,1,1,1,0,1,1,52.43
Marketing,Accountant,2.572426267357782,0,0,4,1,4,0,2,3,0,0,2,0,0,0,Commerce,Masters,25-30,11,0,0,Hybrid,Tier1_City,1,2,1,2,0,4,1,5.19,Healthcare,4,2,4,3,0,2,2,3,5,5,0,1,2,1,58.95
Physics,Ecologist,3.0655981145157054,7,0,3,0,7,0,1,3,4,1,3,1,2,0,Science,Bachelors,18-24,3,0,0,Remote,Tier3_City,3,5,4,4,3,1,3,13.81,Manufacturing,5,4,1,4,5,3,5,2,5,1,1,1,1,3,52.24
Chemistry,Legal Analyst,3.926535042580322,0,2,1,1,5,1,2,3,4,3,0,0,1,0,Science,PhD,18-24,5,0,0,Hybrid,Tier2_City,4,3,0,4,2,3,3,47.44,Finance,1,2,5,2,2,3,3,4,5,5,0,0,1,4,64.64
Music,Organic Chemist,3.048544481664348,9,0,1,0,1,0,0,4,4,0,0,4,0,0,Arts,Masters,36-40,13,1,46,Remote,Tier1_City,2,2,3,1,0,5,2,42.73,Education,2,4,5,2,5,3,2,4,4,1,1,0,2,1,53.04
Finance,Web Developer,3.3873579653113475,0,1,3,1,4,1,2,0,3,3,2,1,1,0,Commerce,Bachelors,31-35,6,0,0,Hybrid,Tier1_City,2,1,5,5,5,5,1,23.69,Healthcare,4,3,1,3,0,1,2,3,1,4,1,1,2,3,49.38
Marketing,Industrial-Organizational Psychologist,4.647235248464243,3,2,3,0,3,0,2,2,3,4,1,4,0,0,Commerce,High School,25-30,3,0,0,Office,Tier1_City,3,2,4,5,4,5,1,25.65,Manufacturing,3,5,5,5,5,5,3,1,4,2,1,1,4,3,53.21
Chemistry,Interior Designer,2.520192130328506,1,1,0,0,7,0,3,1,1,1,3,4,4,0,Science,Masters,25-30,7,0,0,Flexible,Tier1_City,5,5,2,2,2,3,5,45.27,Healthcare,1,4,2,4,5,0,2,3,5,5,0,1,3,1,67.72
Physics,Aerospace Engineer,4.675831753841454,2,2,4,1,3,0,4,0,0,3,1,4,0,1,Science,Masters,25-30,12,1,47,Remote,Tier3_City,1,4,3,5,3,1,1,30.79,Other,5,4,2,3,5,0,2,2,2,4,0,1,5,4,58.42
Art,Conductor,3.4753446162259887,1,0,0,1,2,0,2,4,1,2,3,0,0,0,Arts,Masters,31-35,13,1,25,Flexible,Tier1_City,5,2,2,2,4,0,2,44.4,Other,1,3,1,2,1,2,4,4,5,5,0,0,4,3,69.72
Chemistry,Web Developer,4.215755640189045,1,0,2,0,7,0,2,3,4,3,4,2,3,1,Science,Masters,31-35,9,0,0,Hybrid,Tier2_City,3,2,4,1,1,1,1,26.12,Finance,4,1,1,5,2,5,4,4,2,5,1,1,2,4,73.93
Medicine,AI Researcher,3.748473690096581,9,2,0,0,5,1,1,0,0,2,0,4,4,0,Science,Bachelors,31-35,7,0,0,Office,Tier3_City,5,2,4,4,5,2,4,12.4,Healthcare,5,1,4,4,0,4,1,5,1,5,0,0,4,5,48.36
Art,Aerospace Engineer,4.647663156368122,6,0,0,0,8,0,1,0,2,2,4,0,1,1,Arts,Bachelors,31-35,0,0,0,Hybrid,Tier1_City,3,2,2,4,3,2,4,37.12,Other,4,5,5,5,2,0,1,3,3,1,1,0,5,1,34.83
Education,Psychologist,3.889936345687226,6,1,0,0,7,0,3,4,0,4,2,0,3,1,Arts,Bachelors,18-24,7,1,26,Flexible,Tier1_City,1,5,0,4,4,1,2,27.74,Education,2,3,3,3,3,3,2,2,3,5,0,1,4,4,59.27
Chemistry,Marketing Specialist,2.8090174336257374,9,0,2,0,4,0,1,2,3,4,1,0,1,0,Science,Masters,25-30,9,1,10,Office,Any,1,1,1,5,0,1,5,34.42,Other,1,2,1,5,1,1,2,5,5,2,1,1,1,5,56.85
Psychology,Risk Analyst,3.969376352477013,0,0,3,1,2,0,0,0,3,2,0,1,3,0,Arts,Masters,25-30,13,1,9,Hybrid,Any,2,4,1,1,1,3,3,10.39,Healthcare,2,4,4,2,3,4,3,1,1,5,0,1,3,1,49.72
Law,Music Therapist,2.8915102368398724,3,0,2,1,6,0,3,0,1,1,0,4,3,1,Arts,Bachelors,25-30,11,0,0,Hybrid,Any,5,2,5,5,3,3,1,33.44,Healthcare,3,5,1,2,1,4,3,5,2,1,1,1,2,3,47.84
Law,Interior Designer,3.138968178304591,0,1,1,0,4,0,1,1,2,2,0,0,3,0,Arts,Bachelors,31-35,2,0,0,Flexible,Tier2_City,5,4,4,5,0,4,5,20.97,Manufacturing,2,1,1,1,4,1,2,2,3,5,1,0,2,1,34.04
Finance,Judge,2.5381646499431385,9,1,1,0,3,0,3,3,2,1,3,1,2,1,Commerce,Bachelors,25-30,4,1,12,Office,Any,5,5,3,1,5,5,5,18.6,Healthcare,1,2,2,4,3,1,5,3,3,1,1,0,4,5,49.13
Medicine,Art Therapist,3.047476225015817,6,1,4,0,3,1,0,3,2,4,3,3,0,0,Science,Bachelors,18-24,13,1,42,Hybrid,Tier3_City,5,1,2,1,1,4,1,34.56,Healthcare,3,3,5,3,4,0,4,1,1,4,1,0,4,2,55.53
Engineering,Teacher,3.2267695431117165,5,0,1,1,1,1,0,1,1,0,2,2,1,0,Science,Masters,25-30,9,1,47,Remote,Tier2_City,4,2,3,1,2,5,3,30.84,Finance,4,4,1,5,5,1,5,4,2,2,0,0,2,2,47.86
Medicine,Entrepreneur,4.4096604694609045,2,1,4,0,9,0,3,0,2,3,1,3,4,1,Science,Masters,40+,7,0,0,Office,Tier2_City,2,1,2,1,0,2,1,33.51,Healthcare,3,4,5,2,2,2,4,5,3,1,1,1,2,1,47.15
Computer Science,Art Therapist,3.528697356766357,2,0,0,0,0,0,4,2,2,4,4,3,3,0,Science,Masters,18-24,10,0,0,Flexible,Tier1_City,2,2,3,4,4,4,3,48.37,Manufacturing,1,1,4,1,3,4,2,2,1,3,1,1,2,3,65.8
Marketing,Physicist,4.407120397209464,9,1,2,1,5,1,1,3,3,4,2,2,0,1,Commerce,Bachelors,31-35,5,0,0,Remote,Tier2_City,4,2,5,3,3,4,2,35.96,Manufacturing,5,1,1,3,0,4,4,3,1,3,1,1,3,2,48.06
Law,Chemist,4.87526061928022,5,1,0,0,2,0,3,2,0,1,4,1,3,1,Arts,Bachelors,25-30,3,1,11,Flexible,Tier1_City,5,3,2,3,1,0,3,33.12,Education,3,5,3,2,5,3,1,5,4,4,0,1,3,5,47.14
Architecture,Art Director,4.803756541848001,3,0,4,0,0,0,1,2,1,1,2,3,3,0,Interdisciplinary,Masters,18-24,14,0,0,Remote,Tier1_City,4,4,4,1,0,1,5,31.84,Other,4,4,2,3,1,0,2,2,1,5,0,0,5,3,55.25
Architecture,Lawyer,3.977176081351389,4,2,2,0,1,0,3,0,2,0,0,0,3,0,Interdisciplinary,Masters,25-30,3,0,0,Flexible,Tier1_City,5,1,0,3,2,3,2,21.74,Finance,3,4,3,2,0,3,2,1,3,2,0,1,5,3,38.61
Engineering,Inorganic Chemist,4.054943922412952,0,0,3,0,3,0,0,3,4,3,0,3,3,1,Science,Masters,31-35,11,0,0,Office,Tier1_City,4,4,1,3,3,4,4,42.44,Tech,2,4,2,3,0,0,2,5,2,4,1,1,4,5,63.71
Finance,Brand Manager,3.086418262922494,8,0,1,0,4,0,1,3,4,0,3,2,1,1,Commerce,Masters,25-30,3,0,0,Hybrid,Tier2_City,2,4,3,1,3,3,2,20.9,Education,5,4,1,2,5,0,3,5,1,5,0,1,1,4,49.96
Business,Nuclear Physicist,2.766411210226466,3,1,3,1,7,0,0,4,2,2,0,2,1,0,Commerce,Bachelors,36-40,5,0,0,Hybrid,Tier2_City,4,4,5,3,0,5,3,35.91,Healthcare,1,2,1,5,2,5,2,3,3,4,1,0,5,3,49.55
Marketing,Artist,2.767842218069962,2,2,0,1,6,1,2,0,3,0,1,0,1,0,Commerce,Bachelors,25-30,6,0,0,Hybrid,Tier1_City,3,1,1,5,2,4,2,16.78,Other,5,3,5,4,2,5,2,2,4,5,0,0,3,2,51.7
Marketing,Acoustics Specialist,3.93042065815363,1,0,3,1,2,0,0,1,1,3,1,1,3,1,Commerce,Bachelors,18-24,12,0,0,Hybrid,Tier3_City,5,2,3,2,5,5,2,9.94,Finance,2,2,2,2,0,0,2,2,2,5,1,0,3,3,50.73
Computer Science,Interior Designer,3.272845118630083,6,2,1,0,0,0,3,0,0,2,0,3,4,1,Science,High School,36-40,4,1,6,Flexible,Tier2_City,4,2,4,2,5,4,4,9.1,Education,5,3,4,3,5,2,5,4,5,3,1,0,4,1,44.28
Chemistry,Actuary,3.942509494713492,9,1,2,0,2,1,3,1,2,0,0,2,3,1,Science,Bachelors,25-30,9,1,8,Office,Tier2_City,5,2,5,1,1,2,3,32.82,Manufacturing,2,2,3,2,0,1,4,4,5,4,1,0,3,5,53.35
Chemistry,Dentist,4.565848763989988,9,2,1,1,5,1,0,3,1,2,1,0,1,1,Science,High School,25-30,13,0,0,Hybrid,Tier1_City,1,2,4,4,0,0,5,18.41,Finance,3,5,4,1,0,5,1,2,1,5,1,0,2,3,42.56
Music,Music Therapist,3.45206242822771,6,2,4,1,3,0,2,1,3,4,4,3,4,0,Arts,Masters,31-35,7,1,36,Flexible,Tier3_City,5,2,3,1,1,5,2,15.93,Finance,1,3,2,5,1,1,2,5,5,2,1,0,1,2,64.65
Business,Landscape Architect,3.9156942609742016,2,0,0,0,7,1,0,2,1,3,0,2,2,0,Commerce,Bachelors,25-30,6,0,0,Hybrid,Tier2_City,4,2,3,4,5,1,1,30.83,Healthcare,2,4,4,1,2,5,4,1,2,2,1,0,1,5,38.29
Psychology,Biomedical Engineer,3.4713398553946284,9,0,3,1,0,1,4,0,0,3,3,2,0,1,Arts,Bachelors,31-35,7,1,49,Office,Any,5,5,3,2,3,1,5,4.21,Finance,2,3,2,3,3,2,1,4,2,4,1,0,1,5,51.07
Marketing,Legal Secretary,4.36795643229726,7,1,3,1,4,0,1,3,4,1,4,1,1,1,Commerce,PhD,18-24,14,1,38,Office,Tier1_City,3,5,5,1,1,2,2,14.57,Other,3,4,5,2,2,3,4,4,3,1,0,0,4,4,64.45
Architecture,Chemical Engineer,2.895547940326997,8,2,2,1,0,1,4,1,3,4,3,1,4,1,Interdisciplinary,Bachelors,25-30,3,0,0,Flexible,Tier1_City,3,2,4,5,2,2,5,19.01,Other,2,5,5,2,0,0,2,1,5,3,0,0,4,3,56.88
Physics,Astronomer,4.308895919099701,2,0,1,0,1,0,3,2,4,2,3,1,3,1,Science,Bachelors,18-24,7,0,0,Remote,Tier1_City,4,1,0,3,4,1,1,36.29,Finance,1,3,4,1,3,2,4,3,5,3,1,1,2,2,59.04
Chemistry,Organic Chemist,4.0833618625398245,7,0,1,1,5,1,4,1,3,4,1,4,0,1,Science,Masters,36-40,12,0,0,Hybrid,Tier1_City,4,4,0,4,5,5,5,28.62,Tech,4,1,4,4,5,3,4,5,3,2,0,1,2,2,72.46
Computer Science,Animator,4.513594197725976,8,2,1,0,5,1,3,1,0,0,4,0,4,0,Science,Bachelors,18-24,5,1,14,Hybrid,Tier1_City,5,4,3,3,5,1,5,43.23,Healthcare,5,4,2,5,5,1,4,4,5,3,0,1,3,4,51.57
Engineering,Zoologist,2.966120105564698,3,1,3,0,8,1,1,2,3,0,3,1,1,1,Science,Bachelors,31-35,2,0,0,Hybrid,Any,2,1,2,3,2,0,1,18.72,Finance,2,3,5,2,3,4,2,3,5,4,1,1,3,3,49.41
Engineering,Biomedical Engineer,3.409148680327732,6,2,3,0,7,0,1,2,2,2,0,0,1,0,Science,Bachelors,36-40,12,0,0,Hybrid,Tier2_City,3,5,0,1,1,4,1,16.93,Finance,5,2,4,2,3,0,3,2,2,1,1,0,3,5,43.63
Marketing,Music Teacher,4.079120339560614,5,1,3,0,5,0,0,0,0,0,4,0,2,0,Commerce,Bachelors,25-30,7,0,0,Office,Tier1_City,3,4,4,3,0,0,1,4.56,Tech,5,3,2,3,2,0,3,4,5,4,1,0,4,3,46.57
Medicine,Nurse,4.880409785984379,3,0,1,1,4,0,1,4,3,1,3,2,4,1,Science,PhD,25-30,12,1,37,Hybrid,Tier3_City,1,5,4,5,3,1,4,47.73,Tech,4,4,2,1,0,0,4,1,5,2,0,0,3,4,65.84
Engineering,Legal Consultant,4.072392548064631,8,1,3,0,2,0,4,0,4,4,4,4,3,1,Science,Masters,25-30,6,1,38,Hybrid,Tier1_City,1,3,5,3,4,4,1,26.57,Manufacturing,2,1,4,3,5,5,2,2,5,3,1,0,5,1,73.65
Marketing,Curriculum Developer,2.884064393203676,4,1,2,0,8,0,2,1,2,0,1,2,3,1,Commerce,Masters,25-30,9,0,0,Remote,Tier1_City,2,4,4,1,0,1,5,26.62,Healthcare,1,1,3,5,5,1,4,2,4,4,0,0,4,3,57.55
Music,Civil Engineer,3.1479830280031185,8,1,3,1,1,1,3,1,0,0,0,1,1,0,Arts,Masters,25-30,4,1,51,Remote,Tier2_City,3,3,1,5,0,0,1,46.4,Tech,2,2,1,2,5,0,3,5,5,1,1,1,1,1,40.3
Architecture,Software Developer,4.450911168580807,8,0,2,1,6,1,1,2,1,2,3,0,0,1,Interdisciplinary,Masters,31-35,10,1,7,Office,Tier2_City,4,3,1,2,2,0,2,16.63,Finance,5,5,2,1,0,0,5,3,4,5,0,0,3,1,59.2
Finance,Biochemist,4.804682988310068,1,2,4,0,6,0,4,1,2,2,3,2,0,1,Commerce,Bachelors,40+,3,1,10,Remote,Tier2_City,3,3,4,3,1,5,1,18.61,Tech,3,1,5,1,4,5,5,5,4,3,1,0,1,1,50.42
Business,Software Developer,4.003754338502018,8,2,1,0,6,1,0,4,4,0,2,3,2,1,Commerce,Masters,36-40,0,0,0,Remote,Tier1_City,4,3,0,1,5,5,1,33.85,Education,4,5,1,1,1,5,4,2,5,3,1,1,4,3,50.22
Business,Web Developer,4.570196678252482,5,1,1,1,1,0,2,2,0,1,0,3,4,1,Commerce,Bachelors,36-40,9,0,0,Hybrid,Tier1_City,4,2,1,2,5,0,3,39.9,Manufacturing,1,4,2,5,2,1,3,5,3,5,1,1,5,3,59.09
Biology,Architect,3.1387198663822367,2,0,2,0,1,1,1,4,1,3,3,0,0,1,Science,Masters,36-40,2,0,0,Remote,Any,2,2,2,2,2,4,5,35.87,Manufacturing,1,3,3,4,5,5,5,1,5,3,0,1,1,2,51.91
Finance,Construction Manager,4.414580737184015,9,1,2,1,2,1,0,1,0,1,0,4,3,0,Commerce,Masters,25-30,1,0,0,Remote,Any,3,1,3,4,1,5,5,40.07,Other,5,5,1,4,4,5,5,4,4,4,1,1,4,2,44.17
Marketing,Graphic Designer,2.721829040517122,3,1,2,1,6,0,4,2,0,0,4,2,4,1,Commerce,Bachelors,31-35,7,0,0,Flexible,Tier1_City,5,4,1,5,2,5,2,30.03,Healthcare,1,4,5,4,4,5,4,1,5,2,1,1,1,5,58.89
Business,Risk Analyst,4.98173947780012,3,1,2,1,5,1,3,2,0,0,4,4,3,0,Commerce,Bachelors,36-40,13,0,0,Office,Tier2_City,3,1,1,3,5,3,4,43.55,Manufacturing,5,4,1,3,5,2,4,2,3,3,0,1,4,1,61.71
Architecture,Music Therapist,2.896821226895141,7,2,0,1,1,1,3,1,2,1,0,2,0,1,Interdisciplinary,Bachelors,25-30,7,0,0,Hybrid,Tier1_City,3,3,0,1,0,3,3,28.86,Healthcare,1,4,4,3,4,5,3,5,3,2,1,1,5,2,45.54
Art,Biomedical Engineer,3.322279400547208,1,0,4,0,5,1,4,2,3,2,0,1,4,1,Arts,Bachelors,40+,11,0,0,Hybrid,Tier1_City,1,1,0,4,3,5,2,13.78,Education,1,2,2,5,2,3,1,3,1,2,0,1,2,4,56.31
Architecture,Zoologist,3.720865401745997,4,1,3,1,2,0,0,1,1,3,2,2,2,1,Interdisciplinary,Masters,25-30,4,0,0,Flexible,Tier3_City,2,2,2,5,1,1,2,28.46,Other,5,2,4,1,1,4,5,3,2,4,1,1,2,2,44.85
Business,Investment Banker,3.656134112635971,3,0,4,0,1,1,0,0,4,2,1,3,3,0,Commerce,Masters,31-35,13,0,0,Remote,Tier2_City,5,5,5,4,4,4,5,36.51,Finance,4,5,3,4,3,3,1,2,5,5,0,0,3,5,70.72
Biology,Game Developer,4.680543589762815,1,0,4,0,4,0,4,1,3,4,1,2,3,0,Science,High School,31-35,4,1,42,Hybrid,Tier3_City,5,5,2,5,4,2,3,33.72,Education,1,4,1,2,1,1,5,4,1,3,1,1,3,4,44.68
Finance,Construction Manager,3.5406792476043205,2,2,4,1,5,0,1,3,3,2,2,1,3,0,Commerce,Bachelors,40+,14,1,58,Hybrid,Tier2_City,5,5,5,5,0,5,5,14.42,Healthcare,2,5,4,4,1,1,5,5,1,1,1,1,1,5,45.73
Marketing,Analytical Chemist,3.851035641318067,4,1,3,0,9,1,1,0,3,1,2,2,4,0,Commerce,Bachelors,18-24,10,0,0,Office,Tier2_City,4,5,2,3,2,3,4,4.93,Healthcare,3,1,3,5,5,3,5,1,1,3,0,0,3,4,48.99
Education,School Psychologist,3.690179762543067,7,2,2,1,9,1,0,3,2,3,1,4,2,1,Arts,Bachelors,31-35,3,1,32,Flexible,Tier1_City,2,5,2,5,2,4,5,14.87,Healthcare,5,5,4,4,5,5,4,1,3,4,1,0,4,4,50.37
Engineering,Chemist,2.904276111470244,4,1,3,0,9,0,0,4,3,0,0,2,4,0,Science,Bachelors,25-30,0,0,0,Hybrid,Tier3_City,1,4,1,4,5,4,1,49.25,Finance,1,3,5,2,0,1,1,3,5,4,0,0,3,4,44.82
Music,Inorganic Chemist,3.5715372051038616,5,1,0,0,6,1,4,4,4,0,2,1,4,0,Arts,Bachelors,25-30,0,1,55,Hybrid,Any,4,3,2,5,0,3,5,11.67,Other,4,4,4,2,4,4,2,1,5,5,1,0,3,5,54.33
Art,Art Director,2.804905802367072,2,2,3,0,2,0,1,1,2,1,2,0,4,0,Arts,PhD,31-35,12,0,0,Office,Tier2_City,5,2,5,3,5,4,1,24.83,Other,2,5,2,2,4,0,4,4,5,2,0,0,3,2,59.18
Medicine,Music Therapist,3.353321389356216,0,1,3,0,7,1,0,0,3,3,4,1,4,1,Science,Bachelors,25-30,5,0,0,Flexible,Tier1_City,4,5,2,3,5,4,2,33.0,Healthcare,5,2,4,5,3,2,5,2,4,1,1,1,2,2,51.94
Business,Data Scientist,3.108749716678445,6,0,1,1,7,1,4,4,1,4,1,4,0,0,Commerce,Bachelors,31-35,14,0,0,Flexible,Any,4,4,4,4,4,3,4,44.34,Education,2,3,4,4,0,4,1,5,2,3,1,0,4,2,63.45
Architecture,Accountant,4.118273725440004,7,1,3,1,9,0,2,0,0,1,0,2,2,0,Interdisciplinary,Masters,25-30,3,0,0,Office,Tier1_City,5,2,1,2,5,0,1,38.73,Other,3,5,4,5,3,5,1,1,4,1,1,1,4,1,44.06
Psychology,Special Education Teacher,4.963985951202176,0,1,2,0,9,0,4,4,1,4,1,1,1,0,Arts,Bachelors,25-30,3,0,0,Flexible,Tier2_City,5,5,1,2,5,5,4,45.72,Finance,4,5,4,2,5,1,3,2,3,2,0,0,5,5,49.2
Chemistry,Pharmacist,4.80465554005941,2,0,2,1,6,0,1,0,1,4,1,2,1,0,Science,PhD,31-35,2,0,0,Remote,Tier1_City,1,3,1,5,4,1,5,31.41,Education,5,5,4,4,2,2,4,5,1,2,0,1,2,3,42.93
Finance,Financial Analyst,2.700773559372515,5,0,3,1,8,1,2,3,1,3,2,3,2,1,Commerce,PhD,25-30,13,0,0,Hybrid,Tier1_City,2,1,3,1,2,2,5,43.67,Finance,5,2,1,3,0,5,2,2,1,1,1,0,4,4,55.63
Marketing,Principal,3.1410770620679367,9,1,2,1,5,0,3,4,3,2,0,4,4,0,Commerce,Bachelors,18-24,8,1,14,Remote,Tier1_City,3,3,2,5,1,1,2,15.4,Healthcare,1,5,1,5,4,3,3,1,4,4,0,0,2,2,64.07
Psychology,Digital Marketing Specialist,4.97981233718659,1,0,3,0,5,1,3,1,1,0,0,2,0,1,Arts,Bachelors,40+,2,0,0,Remote,Tier2_City,3,3,5,4,3,0,5,23.24,Other,2,1,5,3,3,0,1,2,3,2,1,1,4,3,37.53
Medicine,Fluid Mechanics Engineer,4.031539630293674,9,0,3,1,7,1,0,0,1,1,1,1,2,0,Science,Bachelors,25-30,7,0,0,Hybrid,Tier2_City,3,5,2,4,5,0,1,42.66,Finance,5,1,1,3,0,3,3,4,2,3,1,0,2,2,43.02
Medicine,Advertising Manager,2.9536008704304835,9,0,0,1,6,1,1,3,0,3,1,0,0,1,Science,Bachelors,31-35,1,0,0,Flexible,Tier2_City,1,1,2,4,1,4,2,18.3,Tech,2,1,3,1,0,2,5,3,2,1,0,0,4,5,30.76
Medicine,Aerospace Engineer,4.288515704810253,7,1,0,1,3,0,0,1,3,4,1,0,3,1,Science,High School,25-30,3,1,40,Hybrid,Tier2_City,4,1,0,4,4,1,4,43.95,Education,3,5,2,2,1,0,4,5,1,2,1,0,2,3,33.56
Finance,Mechanical Engineer,3.3274408007378207,5,0,0,1,3,0,2,0,4,1,4,2,3,1,Commerce,Masters,25-30,0,0,0,Office,Tier2_City,5,2,0,4,1,0,2,20.07,Tech,1,3,4,3,0,3,2,5,1,4,0,0,1,3,46.58
Education,Inorganic Chemist,4.434419461952392,5,1,2,0,9,1,3,1,0,3,3,3,0,1,Arts,Bachelors,25-30,10,0,0,Remote,Tier3_City,2,4,0,3,3,1,4,20.08,Tech,3,2,4,5,0,2,2,4,5,1,0,0,5,3,61.8
Finance,Software Developer,4.489898353129243,5,0,2,0,5,1,4,1,0,0,1,4,3,1,Commerce,Bachelors,25-30,4,0,0,Office,Any,3,2,3,2,1,0,3,17.52,Healthcare,1,1,4,2,4,0,1,2,4,4,1,0,1,4,48.21
Chemistry,Industrial-Organizational Psychologist,3.09882846394756,9,0,1,1,4,1,2,0,1,1,3,0,4,0,Science,Bachelors,25-30,1,0,0,Hybrid,Tier1_City,2,5,2,4,1,2,1,28.71,Healthcare,1,1,5,2,2,1,3,5,1,3,1,0,1,2,33.78
Engineering,Actuary,3.148532439341283,0,1,1,1,3,0,4,4,3,1,3,1,4,0,Science,PhD,25-30,10,0,0,Office,Tier1_City,2,1,1,1,1,0,1,9.07,Tech,2,3,5,5,3,0,2,3,3,5,1,1,2,2,78.96
Psychology,Manager,4.946497618234126,3,1,3,1,1,1,1,0,0,1,2,4,3,0,Arts,Bachelors,25-30,12,0,0,Hybrid,Tier2_City,5,3,1,1,1,1,4,4.72,Finance,1,1,3,4,2,5,2,1,2,1,0,0,2,1,45.24
Law,Risk Analyst,2.942114261569148,8,2,4,1,4,0,0,4,3,3,2,0,3,0,Arts,Bachelors,18-24,0,0,0,Hybrid,Tier1_City,1,3,4,1,0,4,5,45.18,Healthcare,3,2,4,5,0,2,5,5,2,3,0,1,2,2,40.11
Computer Science,Construction Manager,3.568052007762488,5,1,1,1,4,0,1,4,3,3,4,4,3,1,Science,Bachelors,25-30,0,0,0,Hybrid,Any,5,4,5,1,5,1,5,46.66,Education,3,3,5,4,4,4,5,4,3,4,0,0,2,4,59.56
Psychology,Biologist,4.8419642332465225,6,2,1,1,0,0,4,4,3,1,0,0,2,1,Arts,PhD,18-24,1,0,0,Hybrid,Tier1_City,1,5,0,3,4,3,3,6.58,Tech,3,4,4,2,4,2,1,4,2,4,1,0,5,3,49.51
Chemistry,Legal Consultant,4.784433016197197,0,2,4,0,1,1,4,2,4,0,1,0,4,1,Science,Bachelors,18-24,4,0,0,Remote,Tier2_City,4,5,3,1,3,1,4,28.84,Education,2,2,1,5,4,4,3,3,4,4,0,0,5,5,53.16
Music,Cybersecurity Analyst,4.844691084959512,4,2,1,0,5,1,4,2,2,3,0,0,0,1,Arts,Masters,36-40,11,0,0,Hybrid,Tier1_City,2,2,4,4,4,2,3,28.37,Other,2,2,4,3,4,3,5,4,3,1,1,0,2,5,55.55
Business,Psychologist,2.7366523722458016,2,2,0,0,3,0,1,0,3,4,1,3,1,1,Commerce,Masters,31-35,14,1,20,Hybrid,Tier2_City,3,1,3,5,0,5,4,20.5,Education,4,5,3,5,1,5,3,2,5,3,1,1,5,1,61.77
Law,Conductor,2.8572916874039227,9,1,1,1,8,1,3,3,0,4,1,2,2,1,Arts,Bachelors,31-35,14,0,0,Office,Tier1_City,2,1,1,1,0,2,3,29.74,Education,5,4,3,3,0,1,1,5,2,4,1,1,3,1,54.58
Finance,Musician,2.8318927223434582,2,0,0,0,0,1,1,2,4,0,0,1,0,0,Commerce,Masters,25-30,8,1,29,Office,Tier3_City,5,4,5,3,0,2,4,24.53,Tech,4,4,5,3,1,0,4,5,4,4,1,0,4,3,55.85
Medicine,Quantum Physicist,2.9225676227611146,9,1,1,0,5,1,1,1,3,3,0,1,0,0,Science,Bachelors,36-40,5,0,0,Flexible,Any,1,3,2,3,5,0,1,26.01,Manufacturing,4,3,4,2,1,2,1,5,1,5,1,0,4,4,47.49
Art,Composer,4.329947854487081,7,1,0,0,5,1,4,4,4,4,4,4,3,1,Arts,Masters,31-35,11,0,0,Hybrid,Tier1_City,4,2,1,1,0,2,3,38.5,Other,1,1,3,4,0,1,4,2,3,3,0,1,1,3,75.86
Computer Science,Urban Planner,4.270302172612565,4,2,2,1,8,0,1,1,4,3,4,0,3,1,Science,Masters,31-35,3,1,13,Hybrid,Tier1_City,4,4,1,5,1,1,3,27.72,Healthcare,1,4,1,4,4,4,5,2,1,3,1,0,4,4,51.1
Marketing,Web Developer,3.9217470824320095,0,2,3,1,7,1,4,3,2,2,3,1,3,0,Commerce,Bachelors,25-30,14,0,0,Office,Tier2_City,1,1,0,1,4,5,4,18.21,Education,4,3,5,3,3,4,2,5,5,5,0,0,2,1,70.87
Marketing,Civil Engineer,4.773169897618123,4,0,2,0,5,0,2,2,1,1,4,0,3,1,Commerce,Bachelors,40+,2,0,0,Hybrid,Tier2_City,1,2,1,3,2,4,2,30.33,Tech,5,4,1,4,4,2,1,5,1,4,1,0,4,4,42.06
Music,Biochemist,2.7285586255257464,9,1,0,0,3,1,4,2,3,1,4,4,3,0,Arts,Masters,36-40,7,0,0,Remote,Tier1_City,1,5,3,2,3,2,2,33.12,Manufacturing,4,2,3,5,4,5,3,4,2,2,0,0,4,3,62.09
Chemistry,Dentist,4.227090230705596,9,2,3,0,6,0,2,1,3,0,3,4,2,0,Science,Bachelors,36-40,2,0,0,Office,Tier3_City,4,3,2,4,0,1,1,34.13,Tech,2,4,5,3,1,4,3,1,2,4,0,1,5,3,47.13
Engineering,Special Education Teacher,4.324391677289254,5,0,2,0,1,1,1,0,0,2,0,3,2,1,Science,Bachelors,18-24,0,1,40,Remote,Tier1_City,2,1,0,3,4,0,5,32.06,Healthcare,3,1,4,3,2,1,4,2,2,2,1,1,3,2,33.28
Biology,Organic Chemist,2.8442277221353844,5,2,2,0,0,0,2,3,0,0,1,4,0,0,Science,High School,25-30,3,0,0,Remote,Tier1_City,2,1,4,1,0,0,5,34.24,Tech,4,3,2,1,4,1,3,4,2,4,1,0,5,4,37.35
Education,Digital Marketing Specialist,4.860005103276796,3,0,1,0,5,0,2,4,4,2,0,3,0,0,Arts,Masters,25-30,10,0,0,Office,Tier2_City,4,4,1,4,5,4,1,17.57,Finance,1,1,4,5,0,1,5,5,3,3,0,1,2,1,68.95
Finance,Legal Consultant,4.232418287013929,8,1,2,0,0,0,2,2,2,3,2,3,2,1,Commerce,Masters,25-30,12,1,53,Office,Tier1_City,3,3,0,1,0,4,5,23.97,Other,5,5,4,4,0,2,4,5,4,3,1,1,5,5,62.19
Computer Science,Pharmacist,2.570033964053364,1,0,3,1,1,0,0,0,3,0,2,2,2,0,Science,High School,36-40,4,1,19,Office,Tier2_City,5,1,0,1,0,1,4,34.43,Finance,1,1,1,4,0,4,2,5,2,2,1,0,2,2,31.4
Medicine,Special Education Teacher,3.1403263020407377,3,1,4,1,5,1,4,2,0,2,3,2,4,1,Science,Bachelors,18-24,4,1,30,Remote,Tier1_City,4,1,0,2,0,4,2,38.46,Education,2,1,4,1,1,4,1,1,5,1,0,0,3,1,48.16
Psychology,Biotechnologist,2.6804769950926723,3,2,0,1,4,0,0,0,0,1,0,3,2,0,Arts,Bachelors,18-24,4,0,0,Flexible,Tier3_City,3,1,3,4,0,4,1,23.4,Tech,1,3,2,5,3,3,4,2,5,1,0,1,1,1,38.34
Architecture,Art Director,4.910965462374742,6,0,3,1,2,1,2,1,3,3,0,1,2,0,Interdisciplinary,Masters,25-30,7,1,53,Office,Tier2_City,5,4,4,4,3,0,4,20.17,Tech,1,2,5,2,3,0,5,5,2,4,1,1,1,1,50.69
Biology,Physical Chemist,2.9004710121277184,0,0,2,0,9,1,0,0,4,3,3,4,0,0,Science,Bachelors,18-24,7,1,45,Office,Tier2_City,2,1,0,2,4,1,1,36.65,Education,5,4,5,2,3,0,4,4,4,5,0,1,3,4,60.21
Biology,Brand Manager,3.367809440810041,7,2,3,0,6,0,1,0,3,4,3,4,0,0,Science,Masters,18-24,11,1,55,Office,Tier1_City,1,4,3,3,5,5,2,13.44,Education,5,4,2,5,4,4,5,3,5,4,1,0,4,1,77.84
Architecture,Inorganic Chemist,4.211817026159037,8,0,0,0,6,0,0,2,1,4,4,3,0,1,Interdisciplinary,Bachelors,31-35,12,1,12,Hybrid,Tier1_City,5,5,4,1,0,4,5,3.45,Other,1,3,1,4,4,5,4,3,3,2,1,1,3,5,54.11
Chemistry,Legal Consultant,2.710316957673639,7,1,0,0,9,1,1,4,2,2,4,1,1,0,Science,PhD,25-30,3,1,36,Remote,Tier2_City,1,5,2,5,0,1,4,25.14,Manufacturing,1,3,2,2,2,4,4,1,4,2,0,0,2,5,53.24
Psychology,Forensic Psychologist,4.813356405229975,6,0,2,1,0,1,0,4,2,3,2,3,3,0,Arts,Bachelors,18-24,14,0,0,Office,Tier1_City,3,5,3,1,0,2,2,11.15,Tech,4,2,5,2,2,1,2,2,4,3,0,1,5,3,54.89
Medicine,Physical Chemist,3.2210095901722107,2,1,2,1,8,0,3,2,0,0,0,0,3,0,Science,Bachelors,25-30,8,0,0,Office,Tier1_City,4,5,0,1,0,0,1,20.78,Healthcare,2,2,2,4,2,2,4,2,4,4,1,0,3,2,45.24
Law,Legal Analyst,3.458602337458382,5,1,3,0,2,1,2,1,2,4,2,4,0,0,Arts,Bachelors,25-30,0,1,25,Hybrid,Tier2_City,4,2,1,3,1,5,3,16.69,Healthcare,4,5,1,5,1,4,5,1,5,5,1,0,5,5,52.81
Biology,Illustrator,2.587772190845789,6,0,0,1,9,1,0,1,3,3,2,3,0,0,Science,PhD,18-24,4,0,0,Office,Tier1_City,1,2,3,1,1,0,4,39.53,Healthcare,5,4,4,1,3,3,4,3,3,4,0,0,2,4,55.98
Biology,Legal Analyst,3.5177457779973405,3,1,2,1,8,0,4,3,3,3,1,3,4,1,Science,Masters,31-35,4,0,0,Hybrid,Tier3_City,5,5,2,2,2,0,1,18.58,Education,4,4,4,5,4,3,3,3,2,4,0,1,4,2,58.19
Art,Landscape Architect,4.474534296871223,5,1,2,1,3,1,2,3,2,0,0,3,2,0,Arts,Bachelors,31-35,4,0,0,Hybrid,Any,5,5,4,2,0,3,1,33.11,Education,4,5,5,1,2,5,2,5,5,4,1,0,2,4,47.24
Computer Science,Electrical Engineer,3.246009415877806,8,0,1,0,7,0,1,4,0,4,3,0,0,0,Science,Masters,31-35,7,1,24,Hybrid,Tier2_City,3,3,2,4,2,1,2,34.67,Education,1,3,1,5,1,4,5,4,4,1,1,0,5,5,55.92
Physics,Ecologist,4.866727517831674,1,1,3,0,4,0,1,3,1,3,3,3,3,0,Science,Masters,31-35,8,0,0,Remote,Any,4,1,4,5,3,2,1,24.45,Healthcare,1,4,4,2,5,0,1,5,4,5,0,0,5,2,68.53
Medicine,Investment Banker,3.656642158463877,8,2,2,0,0,0,0,1,2,1,4,1,4,0,Science,Masters,18-24,2,0,0,Remote,Any,1,3,3,1,2,4,4,6.81,Manufacturing,2,1,4,3,2,2,4,2,4,4,1,1,3,5,46.6
Music,Legal Secretary,4.233320187856757,1,0,3,0,4,1,4,3,0,0,0,3,3,0,Arts,Bachelors,40+,8,0,0,Office,Tier1_City,2,3,4,1,4,2,4,35.92,Other,3,3,4,3,4,3,5,5,4,1,0,1,5,1,51.52
Biology,Digital Marketing Specialist,2.5750569415538203,4,2,3,0,5,0,2,3,3,3,4,2,3,0,Science,Bachelors,36-40,12,0,0,Remote,Tier1_City,4,3,0,3,1,1,1,6.53,Finance,3,3,3,4,2,4,3,2,5,4,1,1,4,2,72.06
Marketing,Market Research Analyst,4.667307110789476,4,2,2,0,8,0,3,1,3,3,1,3,1,1,Commerce,Bachelors,36-40,10,0,0,Remote,Tier2_City,4,3,5,2,1,0,2,7.66,Tech,4,2,4,5,1,4,4,5,1,5,0,0,2,5,57.97
Chemistry,Data Scientist,4.208145911143043,8,2,4,1,0,0,3,1,3,3,2,4,0,1,Science,Masters,18-24,7,0,0,Flexible,Tier2_City,3,3,3,5,0,3,4,12.21,Finance,2,5,3,5,5,1,3,4,1,3,1,0,5,4,58.97
Chemistry,Cybersecurity Analyst,4.913237023860994,5,1,3,0,7,0,0,4,3,3,4,4,4,1,Science,PhD,36-40,2,1,19,Remote,Tier1_City,4,3,1,4,0,1,3,16.18,Tech,2,3,2,4,5,3,4,5,5,1,1,1,3,2,57.11
Physics,Marketing Manager,4.974768783245132,4,2,4,1,4,0,0,3,3,0,4,3,3,0,Science,Masters,36-40,1,1,48,Office,Tier1_City,3,5,2,2,3,5,5,42.78,Education,5,2,5,4,1,1,4,5,1,2,1,0,4,2,45.7
Engineering,Marketing Specialist,4.999330581432263,7,1,4,1,7,1,1,2,4,1,4,4,4,1,Science,Bachelors,36-40,14,1,37,Flexible,Tier2_City,3,3,2,4,5,5,2,34.72,Healthcare,1,1,5,1,2,2,1,5,5,2,1,0,1,2,64.97
Biology,Architectural Technologist,4.327125619257021,1,2,1,0,9,0,0,0,0,3,0,0,4,1,Science,Bachelors,18-24,3,0,0,Hybrid,Tier2_City,2,2,3,3,3,1,2,21.2,Finance,5,1,3,1,4,2,1,2,5,1,0,1,2,3,29.41
Psychology,Cybersecurity Analyst,3.947128679720315,9,0,4,1,9,1,0,0,0,3,4,3,2,0,Arts,Masters,31-35,14,0,0,Office,Tier1_City,5,1,1,3,4,4,5,49.0,Education,3,4,1,3,1,5,3,5,5,2,0,1,4,1,61.15
Chemistry,Nurse,3.808824007043836,4,1,3,1,1,1,3,0,1,3,1,3,4,0,Science,Masters,40+,12,0,0,Flexible,Tier3_City,4,2,3,1,0,2,5,14.45,Tech,2,5,3,2,3,3,2,3,4,2,1,0,2,2,56.82
Finance,Legal Secretary,3.2661935112806586,8,0,2,0,1,1,2,2,4,0,0,2,2,0,Commerce,Masters,31-35,11,0,0,Flexible,Any,3,4,0,5,0,2,4,31.66,Other,3,5,4,5,1,1,4,3,2,2,0,0,1,5,53.15
Medicine,Electrical Engineer,4.535038582814483,5,0,3,1,6,1,4,3,4,0,1,1,3,0,Science,Masters,25-30,1,0,0,Hybrid,Tier3_City,3,2,5,4,3,4,1,42.82,Other,1,2,1,3,0,5,1,4,1,5,0,1,2,4,50.91
Medicine,Credit Analyst,4.059626368366994,0,0,4,1,7,0,3,0,2,1,2,0,2,0,Science,Masters,36-40,3,1,57,Hybrid,Tier1_City,5,4,5,2,3,3,1,40.7,Finance,1,4,5,3,2,5,2,1,5,2,0,0,1,5,47.88
Art,Nurse,3.161821736340002,8,1,2,1,7,1,2,1,3,3,2,0,0,0,Arts,Bachelors,25-30,4,0,0,Hybrid,Tier1_City,5,5,0,3,3,0,3,7.24,Finance,1,5,2,2,3,0,3,5,3,3,1,1,1,3,49.8
Physics,Physician Assistant,4.893662289514454,1,2,4,0,9,0,0,2,1,0,3,3,2,1,Science,Bachelors,25-30,1,0,0,Office,Tier2_City,3,4,1,1,1,0,1,35.77,Finance,3,4,2,3,4,1,5,5,4,5,1,0,5,2,44.49
Art,Analytical Chemist,3.665565635571012,4,1,0,1,9,0,1,1,1,4,3,0,4,0,Arts,Masters,25-30,11,1,44,Flexible,Any,4,3,3,1,2,5,3,15.12,Finance,2,2,3,3,3,3,1,2,3,1,1,1,4,1,52.78
Law,Inorganic Chemist,3.508612031722521,4,2,4,0,4,1,3,2,1,3,3,1,4,0,Arts,Masters,36-40,7,0,0,Office,Tier3_City,4,3,1,4,2,3,3,19.72,Finance,5,4,3,2,5,3,4,1,1,4,1,0,1,4,53.22
Psychology,Urban Planner,4.066659819095489,5,1,4,0,8,1,3,1,2,4,4,0,1,1,Arts,High School,18-24,0,1,45,Hybrid,Tier2_City,4,3,1,3,0,4,2,25.98,Education,2,3,3,3,5,1,1,1,1,1,1,1,5,3,32.46
Marketing,Industrial-Organizational Psychologist,2.7663130583164137,0,2,4,0,5,0,0,3,0,0,3,1,1,1,Commerce,Bachelors,25-30,2,1,35,Hybrid,Tier1_City,5,4,0,5,1,1,2,40.17,Tech,2,3,3,5,1,4,4,5,3,5,1,1,4,2,45.38
Art,Doctor,3.476694363201802,4,0,2,0,6,1,3,4,4,4,4,2,0,0,Arts,Masters,31-35,6,0,0,Hybrid,Tier3_City,4,4,0,3,3,2,4,10.81,Tech,4,3,5,4,1,4,1,5,5,2,0,1,1,1,71.96
Psychology,Physicist,2.8888746942900165,7,2,3,0,9,1,1,2,4,3,4,2,4,1,Arts,High School,31-35,9,0,0,Remote,Tier3_City,4,4,1,4,0,1,5,8.1,Manufacturing,2,3,4,2,0,0,3,5,3,4,1,0,5,4,59.47
Physics,Risk Analyst,4.738447243509663,5,2,4,0,4,1,0,2,3,3,1,3,1,0,Science,Bachelors,25-30,0,1,47,Office,Any,4,1,1,4,1,2,5,10.21,Healthcare,5,1,5,4,5,5,3,1,5,4,1,0,3,4,47.35
Law,Biochemist,4.668327046159529,2,0,2,0,8,1,4,3,4,0,3,4,0,0,Arts,Bachelors,36-40,12,0,0,Remote,Tier2_City,5,1,4,3,4,1,3,13.26,Other,4,1,2,5,3,5,3,3,4,4,1,0,3,4,76.41
Finance,Education Administrator,2.8907330590900697,1,2,0,1,5,0,4,4,3,2,2,4,4,0,Commerce,Masters,36-40,10,0,0,Hybrid,Tier2_City,1,1,0,4,5,4,5,5.8,Finance,2,5,2,3,1,0,3,2,5,5,1,1,2,4,82.29
Architecture,Legal Analyst,4.181146331924776,4,1,2,1,1,1,1,3,2,3,2,4,3,1,Interdisciplinary,Masters,18-24,14,1,41,Office,Tier2_City,1,3,1,3,1,4,3,46.54,Other,4,1,2,3,4,0,3,3,3,1,1,0,3,1,59.59
Medicine,Civil Engineer,2.7788353224114584,3,0,1,1,8,1,0,1,1,2,3,0,2,1,Science,Bachelors,25-30,1,0,0,Remote,Any,4,5,4,2,0,3,5,18.0,Tech,2,4,4,3,4,3,4,5,2,3,0,1,5,2,31.95
Education,Geneticist,3.7478446735368864,8,0,1,0,6,1,2,0,3,2,4,0,4,0,Arts,Masters,18-24,2,0,0,Flexible,Tier2_City,1,2,5,3,2,1,4,11.32,Healthcare,1,4,4,4,5,3,4,1,4,4,1,0,3,2,54.87
Education,Manager,4.703454724004015,8,0,3,1,3,1,0,4,1,4,0,0,4,1,Arts,Bachelors,25-30,13,0,0,Remote,Tier1_City,4,1,5,3,3,1,2,32.98,Healthcare,1,1,1,1,3,4,5,3,4,1,1,1,4,1,48.13
Engineering,Advertising Manager,3.587360794318797,3,1,1,0,3,0,4,1,1,2,4,4,3,1,Science,Bachelors,25-30,13,1,19,Flexible,Tier2_City,5,2,5,4,5,3,2,39.99,Education,2,4,4,4,3,1,3,1,3,1,1,0,5,4,65.32
Law,Chemical Engineer,3.125604034324163,3,2,1,1,0,1,4,4,4,2,4,3,0,0,Arts,Masters,36-40,1,0,0,Hybrid,Any,4,1,1,4,4,3,3,38.4,Finance,4,5,2,1,0,2,2,5,2,3,0,0,2,5,61.53
Computer Science,Sound Engineer,4.20346156527688,7,1,3,0,7,1,2,3,1,1,2,3,0,0,Science,Masters,36-40,1,0,0,Remote,Tier2_City,2,4,4,1,5,4,5,36.78,Manufacturing,5,2,4,4,3,1,4,3,2,3,1,0,5,4,48.78
Biology,Credit Analyst,4.050705676954926,6,2,2,1,6,1,3,4,0,1,0,4,0,1,Science,Masters,18-24,11,0,0,Office,Tier2_City,3,4,1,1,5,4,1,5.37,Healthcare,1,1,4,5,4,5,4,1,1,5,0,1,5,2,63.08
Psychology,Brand Manager,4.411934498793247,9,2,4,0,7,0,4,2,4,3,3,3,3,1,Arts,Masters,18-24,10,0,0,Flexible,Tier3_City,5,3,5,2,1,5,4,39.76,Education,4,3,4,4,3,4,5,4,2,3,0,0,5,1,69.28
Medicine,Teacher,3.2616513873191497,5,2,2,0,8,1,3,4,0,0,4,3,1,0,Science,Masters,25-30,5,1,55,Hybrid,Tier2_City,2,3,5,1,0,1,5,26.59,Finance,5,4,3,4,1,4,4,3,1,3,0,1,3,4,52.39
Art,Acoustics Specialist,2.850100871049182,8,0,2,0,8,1,2,3,0,1,4,3,2,1,Arts,Bachelors,25-30,6,1,9,Office,Tier1_City,2,2,5,3,0,4,1,33.51,Tech,4,4,4,2,1,4,1,2,5,4,0,0,5,1,55.27
Music,Acoustics Specialist,4.329258935051668,1,2,1,1,5,0,0,2,4,2,4,1,2,1,Arts,Bachelors,25-30,5,0,0,Flexible,Tier3_City,3,3,3,4,5,4,4,47.95,Manufacturing,2,2,3,3,5,4,4,1,5,1,1,1,2,4,53.96
Biology,Quantum Physicist,4.2551413838908285,3,0,0,1,9,0,0,3,0,3,3,2,0,1,Science,Bachelors,36-40,10,0,0,Remote,Tier2_City,2,5,0,1,3,1,4,41.1,Finance,1,5,2,3,5,3,1,5,5,3,1,1,2,5,56.66
Business,Music Teacher,3.868288782433178,4,2,3,0,8,0,2,3,4,2,2,1,1,1,Commerce,Bachelors,36-40,5,0,0,Office,Any,3,5,5,1,0,3,2,41.79,Education,1,4,1,3,3,0,5,5,1,2,0,1,3,1,42.94
Medicine,Lawyer,3.266538240940534,8,0,3,0,0,1,4,2,4,4,1,1,2,0,Science,PhD,25-30,14,0,0,Remote,Any,4,5,1,2,5,1,3,11.53,Other,1,3,5,1,2,0,1,3,2,5,0,0,2,5,75.8
Biology,Advertising Manager,4.991145418478679,5,1,2,1,7,1,1,2,4,4,0,4,0,0,Science,Bachelors,36-40,8,0,0,Hybrid,Tier2_City,5,3,2,2,0,0,5,25.39,Education,2,2,1,5,3,1,2,5,3,3,1,0,3,1,58.92
Law,Aerospace Engineer,4.465419975571884,8,2,2,0,2,1,3,1,2,0,1,3,1,0,Arts,Masters,25-30,7,0,0,Remote,Any,5,1,5,3,3,1,4,47.62,Education,5,4,5,1,0,1,4,4,4,3,1,0,1,4,52.25
Biology,Mechanical Engineer,4.431485172025243,5,2,0,1,5,1,3,2,0,2,3,0,4,0,Science,Masters,31-35,13,0,0,Hybrid,Tier1_City,5,2,2,4,4,0,5,30.39,Education,5,3,2,2,4,5,2,2,2,3,0,0,4,1,54.89
Music,Nurse,4.625849303720974,0,1,1,0,8,0,4,1,3,4,0,1,4,1,Arts,Masters,25-30,7,0,0,Remote,Tier2_City,3,2,4,2,5,1,4,7.82,Education,1,4,3,2,4,4,3,3,1,3,1,0,5,5,58.52
Finance,Advertising Manager,4.008209051718943,3,0,0,1,7,1,2,1,3,0,0,0,2,0,Commerce,Bachelors,18-24,5,1,30,Hybrid,Tier1_City,3,2,0,1,2,0,2,37.4,Manufacturing,5,3,4,4,3,4,5,3,3,5,0,1,2,2,48.37
Computer Science,Financial Analyst,4.630926056299487,8,2,2,1,1,0,1,2,2,2,1,1,2,0,Science,Masters,36-40,4,1,48,Hybrid,Tier1_City,2,1,4,4,2,0,3,5.02,Healthcare,1,2,3,2,2,2,5,5,1,4,0,1,2,5,43.6
Biology,Inorganic Chemist,4.10867958228191,5,2,2,0,4,1,4,1,3,4,2,4,3,0,Science,Bachelors,25-30,8,0,0,Hybrid,Any,5,3,0,4,5,1,1,37.89,Healthcare,5,5,5,2,4,0,4,1,1,4,0,0,1,4,65.59
Medicine,Special Education Teacher,2.6309330908387456,0,0,1,1,1,1,2,1,2,0,0,4,4,0,Science,Bachelors,31-35,11,0,0,Hybrid,Any,2,1,2,1,1,5,1,44.35,Tech,1,1,4,5,2,4,4,5,4,5,1,1,5,2,62.25
Chemistry,Interior Designer,3.652558707271316,3,2,0,1,2,0,1,3,0,3,0,4,3,0,Science,Masters,25-30,1,1,42,Hybrid,Tier2_City,4,4,5,2,4,4,2,22.99,Healthcare,5,1,5,2,4,5,5,1,3,3,0,1,3,2,47.9
Music,Teacher,2.798324605616324,7,2,1,0,2,1,0,3,1,2,1,2,3,0,Arts,Bachelors,18-24,6,1,57,Remote,Tier1_City,2,1,2,1,1,2,4,22.44,Education,4,5,5,4,1,1,4,5,5,1,0,0,1,5,44.86
Business,Fluid Mechanics Engineer,3.834980909106675,6,1,4,0,0,0,1,4,4,3,4,1,2,0,Commerce,High School,18-24,5,0,0,Flexible,Tier2_City,5,3,5,4,2,4,2,17.3,Healthcare,1,4,4,3,0,1,1,1,2,3,0,1,5,2,51.45
Marketing,Artist,4.716951938231046,6,2,0,1,0,0,2,2,1,3,4,4,2,0,Commerce,Masters,25-30,6,1,19,Hybrid,Any,3,1,4,5,3,0,3,44.22,Other,1,2,1,1,4,1,1,1,5,1,0,0,5,4,60.07
Architecture,Teacher,4.898186716205212,4,1,2,0,1,1,3,4,2,2,2,3,1,1,Interdisciplinary,Bachelors,31-35,11,1,29,Remote,Tier1_City,2,3,5,5,5,1,1,28.75,Other,3,3,1,1,3,2,1,4,1,2,1,1,3,1,59.33
Finance,Principal,4.160724083330697,3,0,3,1,8,1,4,0,2,3,3,4,1,0,Commerce,PhD,25-30,3,0,0,Hybrid,Tier1_City,2,1,5,3,0,1,5,30.23,Healthcare,1,2,5,1,1,4,5,4,4,4,0,0,1,5,58.42
Medicine,Teacher,3.972879632011275,1,0,4,1,0,0,2,1,2,4,4,3,2,1,Science,PhD,31-35,8,0,0,Office,Tier3_City,3,1,3,1,2,1,1,34.1,Education,5,5,2,4,2,4,5,4,3,4,0,1,1,4,69.3
Education,Financial Advisor,4.65730735015493,6,2,1,1,1,1,3,1,0,0,3,1,3,0,Arts,PhD,31-35,6,0,0,Remote,Any,3,2,2,1,4,1,3,17.11,Manufacturing,4,4,3,5,0,5,2,5,4,1,1,0,4,4,54.64
Law,Nurse,3.0595783475027627,3,1,3,1,9,1,2,1,3,3,2,4,4,1,Arts,Bachelors,31-35,1,0,0,Remote,Tier1_City,5,2,0,3,2,5,4,23.34,Education,4,4,1,4,2,4,3,2,4,2,0,0,3,1,50.67
Education,Illustrator,2.817958136929298,3,0,4,1,6,1,0,4,3,4,1,3,2,0,Arts,High School,25-30,12,0,0,Office,Tier3_City,4,2,1,3,4,2,2,37.86,Healthcare,5,5,4,1,2,5,4,4,3,4,0,1,4,5,58.03
Finance,Marketing Specialist,4.1726064815789545,4,1,0,0,2,1,1,4,4,2,2,4,4,0,Commerce,PhD,36-40,3,1,28,Hybrid,Tier2_City,5,3,1,3,4,3,1,49.32,Healthcare,2,2,5,4,4,2,5,3,3,2,0,1,5,1,62.14
Biology,Accountant,3.079459469292483,9,0,2,1,8,0,2,0,0,3,0,4,0,0,Science,Bachelors,25-30,4,1,11,Hybrid,Tier1_City,2,5,1,4,5,0,1,4.61,Tech,1,1,3,4,1,4,2,2,3,4,0,0,4,1,50.28
Marketing,Marketing Specialist,4.486900033314599,1,0,4,1,0,1,4,2,4,1,1,2,2,0,Commerce,PhD,25-30,1,0,0,Flexible,Tier3_City,5,5,2,1,4,2,5,5.0,Education,4,2,3,4,0,5,3,3,4,1,0,0,3,5,56.57
Education,Physical Chemist,3.6174336709955552,6,1,4,1,4,1,4,4,4,4,0,4,0,0,Arts,PhD,18-24,9,0,0,Remote,Tier3_City,5,5,3,4,1,4,2,23.12,Tech,5,4,5,3,1,0,1,4,1,4,1,1,5,3,73.32
Psychology,Human Resources Specialist,3.926889204981678,2,1,4,0,2,1,0,2,2,4,3,1,4,1,Arts,Masters,25-30,7,0,0,Hybrid,Tier1_City,3,5,2,3,3,3,5,34.0,Tech,4,4,3,4,1,4,4,3,4,4,1,0,1,2,59.76
Business,Organic Chemist,2.8953839187410795,5,0,3,1,7,1,2,2,3,2,3,2,0,1,Commerce,Bachelors,18-24,0,0,0,Hybrid,Tier2_City,4,3,0,1,2,3,5,21.16,Finance,4,5,2,5,5,4,5,5,1,1,1,0,4,3,39.16
Art,Curriculum Developer,4.164288462463572,1,0,3,0,3,0,0,2,1,0,2,1,0,1,Arts,Bachelors,31-35,14,0,0,Remote,Tier3_City,4,2,5,4,3,1,4,49.98,Other,5,2,5,3,4,1,2,3,2,5,1,1,1,5,50.58
Music,Financial Analyst,4.951268699389723,8,2,0,0,9,1,1,4,3,0,2,2,1,0,Arts,Masters,18-24,2,1,22,Remote,Tier1_City,5,2,2,4,0,2,1,12.18,Tech,3,1,3,4,2,4,1,2,1,5,0,1,1,3,49.65
Art,Aerospace Engineer,4.515997212203385,3,1,2,1,8,0,0,1,1,4,2,1,3,0,Arts,Bachelors,25-30,14,0,0,Hybrid,Tier2_City,3,2,2,3,2,4,2,3.37,Other,4,2,3,2,1,3,3,4,2,4,0,1,3,5,50.89
Psychology,Education Administrator,2.906842382845228,7,1,4,0,4,0,4,2,3,0,3,4,2,1,Arts,Bachelors,31-35,13,0,0,Remote,Tier1_City,3,3,2,1,3,1,4,11.94,Healthcare,4,4,1,1,2,2,2,3,5,5,0,0,4,3,73.19
Medicine,Social Media Manager,2.6044188309164533,8,1,2,1,6,0,2,3,4,1,3,2,1,0,Science,Masters,25-30,0,0,0,Hybrid,Tier1_City,2,1,2,3,3,1,4,44.68,Healthcare,2,2,3,3,1,1,3,3,2,3,0,1,2,3,48.43
Physics,Advertising Manager,4.651834849957352,1,1,1,0,9,1,3,0,0,1,0,4,0,0,Science,PhD,18-24,14,0,0,Flexible,Tier1_City,1,4,0,1,5,5,4,9.82,Finance,3,4,3,2,0,2,5,3,4,5,1,0,1,4,64.73
Art,Electrical Engineer,4.580640837376311,4,2,0,0,9,1,1,1,4,3,1,1,1,0,Arts,Masters,18-24,4,0,0,Office,Tier2_City,2,3,2,5,5,0,3,25.51,Finance,2,4,1,1,3,3,2,3,5,2,0,0,3,2,54.02
Engineering,School Counselor,4.345987400541032,6,2,2,1,4,0,1,4,2,3,3,1,1,0,Science,Masters,31-35,7,0,0,Hybrid,Tier1_City,2,1,3,2,0,3,3,22.71,Education,5,3,5,5,3,1,4,2,4,3,0,0,2,1,58.05
Psychology,Financial Advisor,4.259691896657534,0,0,0,0,7,1,1,0,3,2,3,0,4,1,Arts,Bachelors,18-24,6,0,0,Remote,Tier1_City,2,2,4,2,4,4,4,34.29,Finance,1,1,1,2,3,5,1,1,4,5,0,0,5,4,55.63
Finance,School Psychologist,4.352835427280627,7,2,0,0,9,1,4,2,0,4,0,3,3,1,Commerce,Masters,25-30,8,0,0,Hybrid,Tier1_City,1,2,0,2,2,3,3,5.57,Manufacturing,5,5,4,5,4,5,2,5,2,3,0,1,2,5,59.77
Law,Landscape Architect,2.55565746072483,0,2,3,0,4,0,3,4,1,2,2,1,2,0,Arts,PhD,25-30,1,0,0,Hybrid,Tier3_City,3,5,3,3,5,2,2,33.96,Healthcare,3,1,4,5,4,5,5,4,3,3,1,0,3,5,55.83
Law,Cybersecurity Analyst,4.663175859286654,8,1,0,0,8,0,4,2,4,1,4,1,3,1,Arts,Bachelors,31-35,11,0,0,Flexible,Tier2_City,3,5,1,5,2,0,1,19.67,Healthcare,5,2,2,2,2,1,5,1,4,5,1,1,5,1,68.64
Chemistry,Art Therapist,3.091994905369644,2,1,3,0,2,0,4,2,4,2,0,3,4,1,Science,Bachelors,31-35,7,0,0,Flexible,Tier1_City,4,1,1,1,0,1,2,46.52,Other,3,3,3,2,4,3,3,5,5,2,0,1,1,4,57.07
Medicine,Biomedical Engineer,3.33235887561504,8,2,4,0,1,0,0,4,4,3,4,2,2,0,Science,Masters,36-40,7,1,50,Hybrid,Any,4,4,0,4,5,0,1,42.9,Finance,2,4,4,3,3,3,3,3,4,2,0,1,5,4,66.68
Computer Science,Judge,3.1151013588551897,4,1,2,0,3,1,3,0,0,3,3,2,4,0,Science,Masters,18-24,13,0,0,Remote,Tier3_City,5,1,4,1,5,1,3,21.78,Other,4,1,5,5,4,0,4,1,3,3,0,0,4,2,65.27
Chemistry,Astronomer,3.13813421577424,1,2,2,1,7,1,1,1,3,3,0,2,4,0,Science,Masters,25-30,5,0,0,Flexible,Tier2_City,5,1,2,4,4,0,2,49.67,Finance,5,4,5,2,3,1,5,5,3,5,0,0,1,4,55.28
Chemistry,Principal,2.979138856000485,8,2,1,1,0,0,4,2,4,1,4,0,0,1,Science,Masters,25-30,2,0,0,Office,Tier2_City,5,4,0,1,2,1,5,5.44,Healthcare,5,4,4,5,1,2,5,5,4,2,0,0,1,4,56.99
Chemistry,Data Scientist,4.700345884900015,0,2,1,0,2,1,3,0,1,2,3,4,4,1,Science,Bachelors,18-24,1,0,0,Hybrid,Tier1_City,4,1,2,5,2,3,4,40.07,Finance,4,3,1,4,5,4,5,1,3,5,1,0,5,5,47.35
Art,Biotechnologist,2.943944364943792,9,2,3,1,0,0,1,0,3,3,3,0,2,0,Arts,Bachelors,25-30,13,1,53,Hybrid,Any,4,1,2,4,2,3,1,23.39,Education,5,1,2,4,3,3,1,3,2,5,1,0,2,2,57.15
Psychology,Psychologist,4.398898563837819,5,0,4,0,9,0,4,2,0,1,3,3,0,1,Arts,Masters,25-30,7,0,0,Hybrid,Tier1_City,2,3,1,3,4,3,1,23.37,Finance,5,3,1,4,3,0,1,3,1,4,0,0,4,2,59.54
Physics,Civil Engineer,4.955992807964004,6,1,1,1,3,0,2,4,2,0,2,3,3,0,Science,Masters,25-30,5,1,8,Flexible,Tier2_City,3,4,4,1,5,3,5,11.0,Finance,1,4,2,5,0,3,5,4,3,4,1,1,4,4,63.3
Biology,Graphic Designer,3.1793598459799126,6,2,4,1,1,1,0,4,3,4,1,4,2,0,Science,Masters,31-35,3,0,0,Remote,Tier2_City,4,2,2,1,0,0,5,27.2,Education,1,1,4,5,5,5,1,5,4,4,1,0,3,4,60.59
Art,Legal Analyst,3.4231655862225674,7,0,3,0,1,1,3,1,2,3,2,3,3,0,Arts,PhD,25-30,4,0,0,Office,Any,1,5,0,4,2,1,4,6.98,Education,4,4,1,2,0,2,5,4,3,5,1,1,1,1,60.59
Business,Digital Marketing Specialist,2.809185306703053,2,0,0,1,6,0,2,3,3,1,4,4,4,0,Commerce,Bachelors,31-35,4,1,9,Remote,Tier1_City,2,2,1,3,3,3,3,31.98,Education,2,4,4,2,0,4,3,3,4,1,1,1,3,4,54.7
Psychology,Legal Secretary,4.198432165187918,8,0,4,0,3,0,0,2,1,2,3,0,1,0,Arts,Bachelors,25-30,12,0,0,Flexible,Tier2_City,1,2,2,3,4,0,2,14.35,Other,5,1,2,3,0,4,3,5,5,5,0,1,3,3,58.66
Education,Quantum Physicist,3.042545352225704,5,1,1,1,6,1,0,1,1,4,4,2,4,1,Arts,Masters,25-30,8,0,0,Hybrid,Tier3_City,1,5,5,5,1,1,2,37.07,Healthcare,5,5,5,3,3,3,1,4,4,2,0,1,3,5,55.51
Marketing,Surgeon,3.150103588707886,1,1,3,0,9,1,3,1,1,0,0,4,0,0,Commerce,Masters,25-30,12,1,41,Remote,Tier1_City,3,5,5,3,0,0,2,31.55,Finance,2,3,1,3,2,4,3,4,5,2,0,0,4,3,54.12
Chemistry,Chemical Engineer,4.593931751349638,6,1,4,1,2,1,4,3,4,4,3,4,2,1,Science,Masters,18-24,12,1,11,Remote,Tier1_City,1,1,5,3,3,5,3,38.08,Education,5,2,4,1,0,5,3,4,1,2,1,0,3,2,68.15
Art,Game Developer,3.097782299256246,6,2,1,0,1,0,2,0,1,3,0,4,2,1,Arts,Masters,18-24,8,0,0,Hybrid,Tier1_City,1,4,1,3,2,3,4,38.24,Education,2,4,2,4,4,5,4,5,2,1,1,0,5,5,49.84
Business,Clinical Psychologist,3.481745251179499,6,1,2,1,1,0,2,4,4,0,2,2,3,1,Commerce,Masters,25-30,7,0,0,Remote,Tier1_City,1,5,1,2,1,2,2,12.25,Healthcare,4,3,5,5,4,4,4,2,1,3,0,0,4,3,59.23
Marketing,AI Researcher,3.353117308058557,4,0,0,1,7,1,3,4,0,4,3,0,0,1,Commerce,Bachelors,36-40,7,0,0,Hybrid,Tier1_City,1,4,0,5,0,0,1,3.03,Manufacturing,4,3,1,4,4,2,5,2,4,5,1,0,5,4,62.07
Education,Legal Secretary,4.638088856438534,9,2,1,1,7,1,4,4,3,0,2,3,0,1,Arts,Bachelors,31-35,11,0,0,Remote,Tier2_City,2,1,0,1,4,3,1,20.19,Finance,2,1,2,5,3,5,2,3,1,4,0,1,4,3,63.24
Medicine,Financial Advisor,3.2955815174574354,6,1,0,0,4,1,2,3,1,0,2,2,4,1,Science,Bachelors,18-24,1,0,0,Remote,Tier3_City,2,2,3,4,1,4,1,46.2,Manufacturing,2,1,1,1,1,3,2,5,5,2,0,1,1,3,41.16
Engineering,AI Researcher,4.13503794626819,6,0,2,0,0,1,2,0,1,4,4,1,2,1,Science,Masters,36-40,13,1,27,Hybrid,Any,3,5,2,1,5,1,5,30.16,Manufacturing,3,1,1,5,5,0,4,5,1,2,1,0,3,4,60.63
Biology,Fluid Mechanics Engineer,3.086564558782252,4,0,3,0,6,0,1,1,2,3,4,1,3,1,Science,High School,31-35,2,0,0,Hybrid,Tier2_City,3,5,5,5,1,5,5,37.19,Education,1,3,3,3,5,5,5,1,2,3,1,0,3,5,40.58
Physics,Advertising Manager,4.611991759018725,0,0,3,0,0,1,4,3,4,0,2,3,2,1,Science,Bachelors,31-35,13,1,54,Hybrid,Tier1_City,1,1,1,4,3,3,3,44.34,Other,1,1,4,4,1,0,4,4,3,3,0,1,1,1,65.53
Medicine,Surgeon,3.608781067481261,1,0,3,0,7,0,4,3,0,1,4,0,4,0,Science,Bachelors,36-40,7,0,0,Hybrid,Any,5,4,3,5,0,4,2,45.58,Healthcare,5,2,3,4,0,1,3,3,5,3,0,1,1,4,54.54
Law,Illustrator,3.702283812456078,5,0,1,0,5,1,2,4,2,3,4,3,0,0,Arts,Bachelors,25-30,12,0,0,Hybrid,Tier3_City,1,4,0,3,3,0,5,27.86,Finance,5,3,1,4,4,2,5,5,1,5,0,0,2,4,64.8
Biology,Actuary,4.142804960514647,8,2,2,1,3,1,0,0,3,2,1,4,1,1,Science,Masters,18-24,4,1,9,Hybrid,Tier2_City,1,3,4,4,3,0,1,28.42,Finance,2,1,2,1,5,3,5,1,1,2,1,1,3,5,40.01
Engineering,Forensic Psychologist,3.1789548549240907,4,0,0,0,1,1,3,0,1,3,1,3,1,1,Science,High School,25-30,6,0,0,Remote,Tier1_City,3,2,1,3,2,4,5,42.99,Finance,2,4,4,4,0,4,2,1,1,1,0,1,2,2,36.75
Biology,Graphic Designer,4.526727421449568,6,1,2,0,3,0,3,4,0,2,1,3,2,0,Science,High School,25-30,13,0,0,Remote,Any,4,3,4,1,4,5,1,40.95,Other,1,3,2,2,3,2,2,5,5,1,0,1,4,4,55.33
Computer Science,Financial Analyst,2.833409539522841,2,1,1,1,6,1,4,2,1,2,0,4,0,1,Science,Masters,25-30,7,0,0,Remote,Tier1_City,3,4,4,1,1,4,2,35.85,Manufacturing,5,5,2,3,4,3,2,3,1,3,1,1,5,1,52.95
Engineering,Zoologist,3.458329830429524,4,1,2,1,2,1,4,2,1,1,1,1,0,1,Science,Bachelors,25-30,5,1,18,Office,Tier1_City,2,3,5,4,0,1,3,31.41,Tech,1,5,5,3,0,3,1,3,3,1,1,1,4,1,40.65
Chemistry,Forensic Psychologist,4.57974215882226,4,2,4,1,6,1,1,0,3,3,4,3,3,1,Science,Bachelors,36-40,14,0,0,Hybrid,Tier3_City,3,4,1,4,5,0,4,32.01,Healthcare,4,3,1,5,2,2,3,2,4,5,0,1,1,4,71.06
Music,Advertising Manager,2.6302305452919708,6,1,0,1,8,1,0,2,2,3,0,0,0,1,Arts,Bachelors,36-40,4,0,0,Hybrid,Tier2_City,4,5,3,5,4,4,4,20.06,Tech,1,3,2,1,3,5,3,2,1,1,1,1,2,4,34.28
Biology,Principal,3.906227519871636,8,0,0,0,2,1,2,3,2,1,3,4,1,1,Science,Masters,36-40,7,0,0,Office,Tier1_City,1,1,3,5,4,2,1,42.52,Manufacturing,1,5,1,5,5,2,3,3,3,3,0,0,5,4,62.28
Chemistry,Electrical Engineer,4.45509659655362,8,0,2,0,2,0,0,3,2,1,2,4,0,1,Science,Bachelors,36-40,0,0,0,Hybrid,Tier2_City,4,3,1,3,0,2,5,32.04,Education,2,4,3,5,5,2,3,1,5,1,0,1,3,4,38.82
Finance,Human Resources Specialist,4.167067827464544,7,0,3,1,1,0,1,3,0,3,0,4,4,0,Commerce,Masters,36-40,0,1,25,Hybrid,Tier3_City,3,5,5,4,4,4,5,13.51,Tech,5,4,3,3,3,1,3,2,4,2,1,1,2,2,41.85
Computer Science,Physician Assistant,3.707280889803618,4,0,1,0,8,1,1,2,1,3,4,1,4,0,Science,Bachelors,18-24,0,0,0,Remote,Tier3_City,5,5,2,1,2,1,1,14.27,Tech,4,4,2,2,3,4,3,1,5,5,0,1,1,4,48.85
Medicine,Marketing Specialist,4.242331841841257,1,0,1,0,3,1,2,2,1,2,0,0,4,0,Science,Bachelors,25-30,2,0,0,Office,Tier1_City,2,1,4,5,4,0,2,43.5,Healthcare,1,2,1,1,2,2,1,2,4,5,1,1,1,5,45.19
Finance,Architectural Technologist,2.872303785803789,1,1,3,1,9,0,4,4,1,1,4,0,0,1,Commerce,Bachelors,25-30,9,0,0,Office,Tier1_City,4,1,3,5,2,2,1,32.41,Manufacturing,1,2,5,1,5,1,5,1,3,5,1,1,2,5,62.27
Computer Science,Chemist,2.875489021490888,5,0,3,1,3,1,4,2,4,0,0,1,2,1,Science,Bachelors,36-40,12,1,37,Office,Tier2_City,3,5,1,1,1,4,2,21.74,Healthcare,2,4,4,1,1,0,2,4,3,2,0,1,2,2,49.11
Chemistry,Biologist,3.628861613443145,4,2,4,0,7,1,1,2,3,3,3,1,4,0,Science,Masters,25-30,11,1,46,Flexible,Any,1,5,0,5,1,4,3,11.79,Education,3,5,3,2,5,5,2,5,4,2,0,0,1,3,60.44
Law,Surgeon,3.836476269529689,5,1,1,1,5,1,3,3,3,3,2,2,2,0,Arts,Masters,31-35,5,1,47,Office,Tier1_City,3,3,0,3,3,3,3,31.68,Other,5,2,3,1,1,1,2,3,3,2,0,0,5,2,53.33
Psychology,Brand Manager,4.784256073444613,7,2,0,1,6,0,0,0,0,0,0,2,1,1,Arts,PhD,18-24,5,0,0,Office,Tier2_City,1,3,1,4,2,4,1,11.66,Other,5,1,5,4,2,5,3,4,2,4,0,1,4,4,40.76
Architecture,Legal Consultant,3.473202689679896,5,2,3,1,2,0,4,4,3,4,1,2,3,0,Interdisciplinary,Bachelors,25-30,4,0,0,Hybrid,Tier1_City,5,2,2,1,5,1,3,25.1,Other,5,2,2,2,5,4,2,3,4,5,0,0,1,3,62.59
Physics,Animator,3.552043577299158,4,0,0,0,4,1,1,0,0,3,4,1,3,0,Science,Bachelors,31-35,12,0,0,Hybrid,Tier1_City,2,2,0,4,1,2,5,34.84,Finance,1,5,3,5,1,0,1,1,1,3,1,1,4,3,49.4
Marketing,Artist,3.1945883188332846,4,2,1,1,0,1,0,2,0,0,0,0,4,0,Commerce,Masters,18-24,12,1,13,Flexible,Any,4,5,2,5,4,3,2,29.57,Other,1,5,3,4,2,2,3,2,1,1,1,0,4,1,39.95
Biology,Teacher,3.397415508003208,2,0,1,1,6,1,1,0,3,4,0,4,4,1,Science,Bachelors,25-30,13,1,43,Flexible,Tier1_City,3,2,1,5,0,2,4,46.34,Other,1,3,4,5,0,2,3,2,1,4,1,1,5,5,55.25
Music,Lawyer,4.189948884236825,9,1,3,0,8,0,3,4,4,4,1,2,4,0,Arts,Bachelors,25-30,6,1,45,Hybrid,Tier3_City,3,5,1,1,0,2,4,4.87,Manufacturing,3,5,5,1,2,2,1,2,1,1,0,1,2,2,48.9
Psychology,Civil Engineer,3.430427496410908,7,1,0,0,0,0,2,2,1,4,2,2,1,1,Arts,Bachelors,25-30,4,0,0,Hybrid,Tier1_City,4,1,4,3,2,1,3,16.15,Other,1,4,5,2,1,2,5,5,1,1,0,0,2,2,42.28
Biology,Construction Manager,4.028674977067648,0,1,0,1,4,1,2,1,4,0,1,1,4,1,Science,High School,31-35,13,0,0,Flexible,Tier1_City,1,1,1,2,5,4,2,5.68,Other,5,5,1,4,2,0,1,5,2,2,0,0,2,2,50.56
Computer Science,Architect,4.1217569716624,1,0,4,0,8,0,2,1,0,1,1,1,2,1,Science,PhD,25-30,1,0,0,Hybrid,Any,2,3,2,1,3,1,5,12.15,Education,5,2,5,2,2,1,1,3,1,4,0,1,1,4,38.81
Business,Sound Engineer,2.791824164134669,8,2,2,1,0,1,4,2,3,4,4,3,2,0,Commerce,Masters,25-30,3,1,47,Remote,Tier2_City,5,4,3,2,4,4,4,8.83,Education,2,2,4,2,4,5,1,2,3,3,0,0,3,4,63.4
Biology,Industrial-Organizational Psychologist,4.2361452035970295,2,1,1,0,6,1,3,2,3,3,4,3,1,1,Science,Masters,18-24,0,0,0,Hybrid,Tier2_City,4,5,0,2,2,3,5,37.44,Tech,3,2,5,2,2,5,5,4,5,1,1,0,3,1,54.75
Law,Artist,3.163312865874347,8,2,3,0,4,0,3,1,2,4,4,0,1,0,Arts,Bachelors,36-40,6,1,48,Remote,Tier3_City,2,3,0,3,0,1,5,20.36,Healthcare,4,5,1,5,1,5,2,3,3,1,1,1,3,2,48.85
Architecture,Biochemist,2.984792558853759,6,2,1,0,8,1,1,3,4,0,4,2,0,0,Interdisciplinary,Bachelors,25-30,3,0,0,Hybrid,Tier1_City,3,2,4,2,2,1,4,46.48,Tech,1,4,4,2,3,1,1,5,3,4,1,0,5,3,50.75
Art,Quantum Physicist,4.965997373748745,7,1,2,0,0,1,3,0,3,1,0,2,3,0,Arts,Bachelors,31-35,12,0,0,Office,Tier2_City,2,5,3,2,4,5,4,4.1,Tech,4,4,3,1,0,3,3,5,2,3,1,1,5,5,50.17
Biology,Financial Analyst,3.2343602998872445,4,2,1,1,1,0,3,4,3,0,4,2,0,0,Science,Bachelors,31-35,3,0,0,Remote,Tier1_City,5,3,2,3,5,0,3,33.69,Finance,1,3,2,4,2,1,2,2,2,3,1,0,3,4,56.04
Finance,Aerospace Engineer,3.0526079662204646,7,2,1,0,8,1,2,3,0,3,0,4,0,0,Commerce,Bachelors,18-24,12,0,0,Flexible,Tier3_City,2,2,2,2,5,1,2,48.62,Healthcare,3,1,3,3,1,1,2,5,3,3,1,0,2,3,55.89
Finance,Analytical Chemist,2.6513727520738204,0,1,4,1,8,0,4,2,4,1,2,2,3,1,Commerce,Masters,36-40,3,0,0,Flexible,Tier2_City,3,5,4,2,1,5,1,11.26,Finance,3,4,1,2,5,5,4,1,3,1,0,1,2,1,51.59
Law,Special Education Teacher,3.5616587379612907,9,2,2,1,8,1,4,0,0,0,4,2,2,1,Arts,Masters,31-35,2,0,0,Office,Tier1_City,5,3,1,2,4,0,2,23.79,Other,5,2,4,4,5,1,1,5,1,2,1,1,3,2,41.66
Architecture,Financial Analyst,3.1570178353582445,3,0,2,1,1,1,4,2,3,2,2,3,0,1,Interdisciplinary,Bachelors,25-30,7,0,0,Flexible,Any,5,4,3,1,1,4,1,35.99,Education,3,3,3,5,1,1,2,2,5,4,0,1,2,1,67.74
Medicine,Chemical Engineer,3.5429377125706645,1,2,2,1,6,0,2,1,3,3,4,3,3,1,Science,PhD,18-24,3,0,0,Hybrid,Tier2_City,5,3,0,1,1,4,4,32.76,Other,4,4,1,5,4,5,3,3,2,3,1,0,3,3,57.08
Marketing,Architectural Technologist,4.488364759861513,2,0,1,0,3,1,0,2,0,2,3,2,4,0,Commerce,Masters,36-40,7,1,9,Hybrid,Tier2_City,3,5,3,1,1,4,5,29.6,Finance,4,4,3,2,5,5,5,5,5,2,1,1,1,1,52.9
Chemistry,Surgeon,3.3325605850966813,0,1,1,1,4,0,1,3,4,3,3,4,0,0,Science,Masters,31-35,8,1,41,Office,Tier1_City,1,2,4,3,2,5,2,18.36,Education,3,1,2,2,1,1,5,4,5,3,1,0,4,4,71.28
Marketing,Art Therapist,4.081783645909969,7,2,3,1,6,0,0,1,1,2,4,4,2,0,Commerce,Masters,18-24,0,0,0,Hybrid,Any,3,5,1,5,0,5,5,37.23,Tech,4,1,3,1,3,0,2,4,2,1,0,0,4,3,35.8
Education,Music Teacher,3.6571810874409687,4,2,2,0,8,0,4,1,3,1,2,4,4,1,Arts,Bachelors,25-30,14,0,0,Hybrid,Any,1,5,5,2,5,0,2,33.7,Other,1,1,3,3,1,4,5,1,5,3,1,0,4,3,71.43
Medicine,Counselor,2.9701337600899334,2,0,1,1,2,0,2,2,1,0,0,2,0,1,Science,Bachelors,36-40,3,0,0,Hybrid,Tier2_City,1,3,3,2,2,4,2,10.65,Finance,2,4,3,2,3,4,4,3,1,1,0,0,3,5,28.76
Art,Music Therapist,3.785745090093581,2,1,4,0,7,0,4,4,1,4,0,0,2,0,Arts,Bachelors,31-35,5,1,8,Office,Tier2_City,3,5,1,3,0,2,5,48.31,Other,5,4,1,2,5,3,5,1,2,4,0,0,1,5,46.35
Art,Astronomer,3.8350834002502494,2,0,3,0,9,0,2,2,4,0,3,4,1,1,Arts,Masters,31-35,7,0,0,Office,Tier1_City,2,1,3,2,5,1,3,29.12,Healthcare,2,2,4,1,0,1,5,1,3,1,1,0,5,4,57.5
Finance,School Psychologist,3.776939010389461,9,2,3,1,7,1,0,4,4,1,0,3,3,0,Commerce,High School,25-30,13,0,0,Office,Tier1_City,3,4,0,1,4,5,4,27.7,Finance,4,5,5,5,2,2,5,2,4,3,1,1,4,4,61.19
Marketing,Dentist,4.455013829125546,2,0,0,0,7,0,4,4,3,3,2,0,1,0,Commerce,Bachelors,31-35,5,1,7,Office,Tier2_City,5,2,2,5,5,5,3,42.87,Education,5,1,1,3,0,4,3,2,1,5,1,0,2,4,56.17
Education,Cybersecurity Analyst,4.895015349024119,9,1,1,1,1,1,0,0,2,2,1,1,2,1,Arts,High School,25-30,11,0,0,Office,Tier1_City,2,4,3,4,5,5,3,33.1,Manufacturing,2,2,5,5,2,5,4,2,2,2,0,0,3,1,42.55
Biology,Civil Engineer,2.789592185568712,2,1,1,1,8,1,3,0,2,2,2,1,0,0,Science,High School,18-24,5,1,11,Hybrid,Any,4,3,2,2,5,0,2,6.5,Other,2,2,5,2,5,2,4,4,5,1,0,1,3,5,42.98
Computer Science,Judge,4.9244302351510925,7,1,0,1,1,1,4,3,2,3,4,0,4,0,Science,Masters,31-35,9,0,0,Remote,Tier1_City,4,3,2,1,3,4,4,26.81,Other,4,3,3,3,0,3,5,5,3,1,0,1,5,3,62.85
Engineering,Acoustics Specialist,4.850058869606623,5,0,1,0,1,0,3,4,3,2,4,1,1,1,Science,Masters,40+,3,0,0,Office,Tier3_City,4,1,2,4,4,2,2,39.69,Healthcare,5,2,2,2,3,2,2,3,4,5,1,1,2,2,63.49
Finance,Music Teacher,4.19395392950903,6,1,4,1,3,0,1,0,1,1,4,3,3,1,Commerce,Bachelors,25-30,8,0,0,Remote,Tier1_City,5,3,4,5,2,1,1,35.9,Education,5,1,5,1,2,1,3,2,2,3,1,1,1,2,47.42
Psychology,Market Research Analyst,3.4179952255902,2,2,1,0,6,0,2,4,3,4,3,4,3,0,Arts,Bachelors,25-30,6,1,39,Flexible,Tier1_City,5,3,0,4,2,1,2,48.63,Other,2,5,5,1,2,1,2,3,1,2,1,1,4,1,54.03
Medicine,Credit Analyst,4.556321619347527,4,1,2,0,4,1,1,3,3,4,1,4,1,1,Science,Bachelors,31-35,13,1,34,Office,Tier2_City,1,3,2,1,0,4,5,4.17,Manufacturing,5,2,3,5,0,0,1,1,1,2,1,1,1,2,55.49
Finance,Social Media Manager,4.6155039189897,3,2,3,0,0,0,4,2,1,2,3,1,0,0,Commerce,Bachelors,25-30,10,0,0,Office,Tier3_City,5,4,0,4,2,2,2,15.28,Other,5,4,2,4,4,1,3,5,3,2,1,1,2,1,57.77
Art,Aerospace Engineer,4.3399875162742365,9,2,0,1,8,0,3,3,2,4,0,2,2,1,Arts,Bachelors,36-40,5,0,0,Flexible,Tier3_City,1,1,3,3,1,0,1,28.81,Healthcare,1,4,3,5,5,4,5,4,1,2,1,0,2,4,45.94
Computer Science,Clinical Psychologist,2.9756595823162195,3,2,1,0,6,1,4,0,0,0,1,3,1,0,Science,Bachelors,31-35,0,0,0,Hybrid,Tier1_City,4,5,5,4,5,5,2,32.12,Manufacturing,4,2,5,3,4,1,3,3,2,4,1,1,3,5,38.52
Music,Art Director,4.620174962429094,5,1,4,0,5,0,4,2,2,4,0,4,0,0,Arts,Bachelors,18-24,1,1,21,Remote,Tier1_City,3,2,0,2,2,5,1,15.89,Tech,4,1,1,1,0,1,3,5,3,1,0,0,1,4,41.44
Education,Graphic Designer,3.3216876558717177,2,2,2,0,1,1,1,3,1,1,1,3,4,1,Arts,Masters,40+,11,0,0,Hybrid,Any,3,1,1,2,0,4,4,41.86,Tech,1,5,5,5,1,2,2,3,4,4,1,1,5,1,59.27
Computer Science,Construction Manager,4.099808066213616,2,2,3,1,6,0,2,4,4,3,4,2,1,1,Science,Masters,31-35,5,1,40,Remote,Tier3_City,5,4,2,3,0,1,2,10.72,Other,2,5,1,1,0,3,1,1,2,4,0,1,2,3,59.05
Architecture,Game Developer,2.9065140660169515,1,1,1,1,7,1,0,4,4,0,2,1,2,0,Interdisciplinary,High School,36-40,10,0,0,Hybrid,Tier3_City,4,5,3,1,1,5,1,3.04,Finance,3,1,4,4,5,1,3,2,1,3,0,1,3,3,48.29
Business,Music Teacher,2.8071475694364025,7,0,3,1,7,0,1,3,1,1,2,0,1,0,Commerce,Bachelors,31-35,14,0,0,Hybrid,Tier1_City,4,5,2,2,0,1,4,47.76,Finance,2,4,2,5,3,4,1,1,4,1,0,0,4,4,51.8
Engineering,Clinical Psychologist,3.94020707912061,6,0,4,0,6,1,3,3,1,0,1,3,2,1,Science,Masters,36-40,0,0,0,Office,Tier3_City,1,2,2,5,3,1,5,21.4,Finance,1,4,4,1,3,3,1,3,4,3,1,0,5,2,46.43
Law,Nuclear Physicist,3.4173088153767788,0,1,2,1,0,1,0,2,2,3,0,4,4,1,Arts,Bachelors,18-24,14,1,35,Hybrid,Tier1_City,1,5,3,2,5,4,3,48.0,Finance,5,3,3,2,1,1,2,4,3,4,0,1,5,3,60.55
Architecture,Judge,3.2642480881225384,8,0,3,0,1,0,1,2,4,2,4,3,4,1,Interdisciplinary,Masters,25-30,14,1,53,Hybrid,Tier2_City,4,1,3,2,5,3,1,16.06,Other,1,2,5,4,5,3,2,3,1,3,1,1,3,1,65.31
Biology,Judge,4.73130610120689,3,1,2,1,9,0,1,1,4,3,3,3,1,1,Science,Masters,36-40,10,0,0,Hybrid,Tier1_City,5,5,4,1,5,3,5,5.98,Manufacturing,4,2,4,2,4,4,5,4,5,4,1,1,5,2,71.82
Business,Education Administrator,3.47806375943829,1,0,1,0,8,0,4,2,0,0,2,4,3,0,Commerce,Bachelors,18-24,4,0,0,Hybrid,Tier1_City,5,4,4,4,4,3,4,39.31,Healthcare,5,4,2,3,3,2,5,4,4,5,1,0,5,1,54.82
Computer Science,Legal Secretary,4.393055231437546,9,1,1,0,3,0,1,3,2,1,1,0,4,1,Science,Bachelors,18-24,0,0,0,Remote,Tier2_City,4,5,4,2,2,2,5,42.28,Healthcare,2,2,1,4,5,2,3,3,4,4,0,1,3,4,43.97
Psychology,Fluid Mechanics Engineer,3.379806291204417,5,1,0,0,4,1,3,1,4,1,0,0,1,1,Arts,Masters,31-35,12,0,0,Remote,Tier1_City,3,4,0,3,3,4,2,26.13,Finance,5,1,1,1,3,0,5,3,2,1,0,1,3,2,50.58
Physics,Marketing Manager,4.706698356227317,1,0,0,1,5,1,3,4,3,0,4,0,1,0,Science,High School,36-40,2,1,48,Office,Tier2_City,3,5,1,4,2,1,3,6.47,Tech,4,5,3,2,2,4,2,4,3,3,0,0,2,3,46.35
Biology,Landscape Architect,3.03465248070438,7,2,1,0,7,1,0,0,1,3,1,3,4,1,Science,Masters,18-24,11,0,0,Hybrid,Tier3_City,1,2,1,5,3,5,1,33.74,Education,1,3,3,3,5,5,5,3,5,2,0,0,3,3,58.97
Medicine,Game Developer,3.03520223868938,4,0,1,1,9,0,4,0,4,0,4,4,2,1,Science,PhD,36-40,11,1,56,Remote,Any,4,1,0,1,2,2,4,11.56,Finance,2,1,5,2,2,1,5,5,1,2,0,1,4,5,67.31
Marketing,School Psychologist,3.889122687659381,9,0,2,1,3,1,1,3,3,1,2,4,0,1,Commerce,Masters,31-35,11,1,15,Hybrid,Tier1_City,3,4,4,5,1,3,3,42.92,Finance,3,1,4,4,1,5,5,4,1,1,0,0,1,4,53.48
Architecture,Counselor,3.540502869453479,1,0,0,0,3,0,1,3,4,2,2,1,4,0,Interdisciplinary,Bachelors,25-30,6,1,33,Hybrid,Tier1_City,5,5,1,4,0,0,4,15.88,Other,3,1,5,2,3,5,1,4,2,3,1,0,3,2,47.77
Psychology,Music Therapist,4.4055254090013145,5,0,2,0,3,0,4,1,3,2,3,3,1,0,Arts,Masters,36-40,4,1,41,Office,Tier2_City,2,3,4,4,0,2,5,42.84,Tech,1,2,1,2,0,1,5,3,5,2,1,0,2,5,57.97
Education,Human Resources Specialist,3.8866809115217658,9,1,3,1,4,1,3,0,1,2,4,1,3,0,Arts,Bachelors,25-30,14,0,0,Flexible,Tier1_City,2,3,3,4,1,2,4,23.07,Education,2,5,1,5,4,0,2,1,1,3,1,1,4,1,53.66
Architecture,Financial Controller,3.684050513285868,1,0,3,1,5,0,0,0,2,3,4,1,1,1,Interdisciplinary,Bachelors,18-24,11,1,19,Office,Tier1_City,4,1,0,5,3,4,4,31.03,Manufacturing,2,3,4,1,1,4,1,5,4,2,0,0,1,4,55.62
Computer Science,Chemist,3.5174559868109245,9,1,1,1,0,0,2,3,2,2,1,3,3,1,Science,PhD,25-30,14,0,0,Hybrid,Tier2_City,1,4,4,4,4,5,5,40.11,Manufacturing,5,4,5,2,0,3,5,3,4,1,0,1,3,3,66.96
Physics,Cybersecurity Analyst,4.323727224104063,1,1,4,0,8,1,4,0,3,1,4,0,4,0,Science,Bachelors,25-30,9,0,0,Remote,Tier2_City,2,2,0,5,3,2,5,4.9,Education,1,1,3,5,0,3,5,2,2,2,1,1,2,1,54.91
Music,Animator,4.619109644588507,7,0,4,0,2,0,3,0,1,2,0,0,0,1,Arts,PhD,25-30,0,1,52,Remote,Tier3_City,5,2,2,4,0,5,3,41.59,Education,5,1,4,1,1,5,2,5,1,2,0,0,1,1,28.51
Medicine,Astronomer,4.34869899064042,1,2,2,1,5,1,0,1,4,3,3,3,2,1,Science,PhD,36-40,0,0,0,Hybrid,Any,5,1,0,3,4,4,1,9.52,Manufacturing,1,1,3,4,1,2,3,2,2,2,0,0,1,1,52.83
Medicine,Organic Chemist,2.578588311773689,5,1,1,1,2,0,2,4,1,4,0,3,2,0,Science,Bachelors,31-35,14,1,11,Hybrid,Tier3_City,5,2,0,4,2,0,5,19.85,Finance,4,4,4,4,3,3,2,5,2,1,1,0,2,1,53.31
Medicine,Counselor,2.631846218330509,4,1,0,0,3,1,1,2,1,2,3,4,3,1,Science,Bachelors,25-30,7,1,35,Office,Tier1_City,2,5,4,5,4,1,3,25.22,Finance,1,2,3,5,4,3,4,4,3,4,1,1,1,4,61.97
Physics,Investment Banker,2.7532678806778224,3,1,0,0,7,0,3,4,3,0,1,2,2,0,Science,Bachelors,31-35,10,1,24,Remote,Tier3_City,3,1,0,2,3,1,4,45.09,Other,5,2,2,5,5,5,2,5,1,3,1,1,5,5,58.92
Business,Psychologist,3.2457756329967222,9,1,1,0,7,0,1,0,3,0,1,3,3,1,Commerce,High School,18-24,13,0,0,Hybrid,Tier2_City,5,4,5,4,1,3,4,4.05,Tech,2,5,1,4,3,5,3,3,1,5,0,1,4,4,46.71
Art,Forensic Psychologist,3.829528629023195,0,1,4,1,5,0,4,3,3,3,4,3,2,1,Arts,Bachelors,18-24,12,0,0,Remote,Tier2_City,1,2,5,2,2,3,2,29.28,Education,1,2,4,3,5,4,2,2,2,5,0,1,5,3,71.27
Education,Architectural Technologist,3.9099143309761,7,2,1,0,8,1,3,4,4,3,4,2,2,1,Arts,Masters,36-40,8,0,0,Office,Any,4,5,2,3,3,0,5,33.2,Finance,2,2,2,1,5,5,1,1,2,2,1,0,1,2,67.22
Architecture,Lawyer,3.421203794701465,3,1,1,1,4,1,3,4,2,1,3,1,1,1,Interdisciplinary,Bachelors,18-24,6,1,16,Remote,Tier3_City,4,2,3,1,2,1,3,17.88,Finance,4,3,4,1,0,4,1,2,4,3,0,1,3,3,56.42
Law,Chemical Engineer,3.254108560957391,1,1,1,1,3,0,1,0,1,0,1,3,1,1,Arts,Bachelors,18-24,12,0,0,Hybrid,Tier2_City,4,1,5,3,4,3,3,16.65,Tech,3,3,1,5,5,0,2,4,3,2,1,0,2,2,50.05
Art,Civil Engineer,3.2894735242259845,2,1,0,0,8,1,3,4,1,1,1,0,3,0,Arts,Masters,31-35,2,0,0,Remote,Tier1_City,3,1,1,4,0,5,1,26.05,Education,3,2,1,1,3,5,1,4,2,3,1,0,2,3,38.16
Chemistry,Marketing Specialist,3.500751169625385,6,1,4,0,3,1,2,2,4,3,2,1,3,0,Science,High School,25-30,11,0,0,Hybrid,Any,4,2,3,2,3,2,3,11.79,Tech,5,3,3,3,3,5,3,1,1,5,0,0,4,5,55.22
Psychology,Biomedical Engineer,3.689646984077077,5,0,2,0,0,0,0,3,2,1,3,2,4,1,Arts,Masters,36-40,5,0,0,Remote,Tier3_City,4,1,0,2,1,4,5,25.0,Tech,1,5,1,1,4,4,4,5,3,2,1,0,2,3,44.61
Music,Special Education Teacher,3.798188916403257,1,1,2,0,8,0,3,3,3,2,1,2,4,1,Arts,Bachelors,25-30,2,0,0,Remote,Tier1_City,2,3,5,5,4,3,3,38.96,Manufacturing,4,2,1,5,2,0,4,5,1,2,0,0,2,2,45.57
Psychology,Artist,2.771405776069717,0,2,4,1,8,0,4,4,2,1,4,3,4,0,Arts,Bachelors,18-24,9,0,0,Remote,Tier1_City,3,1,2,2,3,0,2,42.73,Tech,4,3,1,2,4,0,3,4,3,3,0,1,4,4,65.97
Computer Science,Chemical Engineer,4.720061843327651,2,1,2,0,6,0,2,0,1,2,2,0,0,1,Science,Masters,25-30,3,0,0,Hybrid,Tier1_City,3,4,2,5,1,1,4,21.1,Education,2,4,5,2,3,1,5,1,4,4,0,1,5,2,43.61
Engineering,Advertising Manager,3.2928586739546173,0,0,3,1,9,1,3,2,4,3,0,2,3,0,Science,Masters,25-30,11,1,56,Hybrid,Tier1_City,2,2,3,1,3,0,4,32.01,Finance,5,3,5,5,2,3,5,4,5,2,1,0,5,5,69.76
Marketing,Geneticist,4.288873473332503,3,1,2,0,7,1,4,3,3,4,2,4,4,1,Commerce,Masters,25-30,3,0,0,Office,Tier2_City,1,3,4,4,4,4,3,3.0,Finance,4,3,1,2,5,4,4,2,5,5,0,1,1,2,69.33
Art,Judge,3.741087110594634,0,0,0,1,8,0,0,0,1,2,4,3,4,0,Arts,Masters,25-30,2,0,0,Remote,Tier1_City,4,2,1,5,3,4,3,28.87,Manufacturing,1,4,5,1,0,0,1,5,2,2,1,1,2,1,41.59
Music,Web Developer,4.297556312630254,6,0,4,1,4,0,0,4,4,2,1,0,4,0,Arts,Masters,36-40,9,0,0,Remote,Any,1,1,0,1,2,0,3,48.84,Education,4,5,4,5,4,3,1,2,5,1,0,0,1,2,59.5
Finance,Nuclear Physicist,3.9135035784923295,7,2,2,0,5,1,4,0,4,0,4,2,2,1,Commerce,Bachelors,36-40,5,1,57,Hybrid,Tier3_City,2,3,0,2,4,3,3,17.68,Finance,3,4,2,5,1,5,5,2,1,1,0,1,1,2,52.74
Marketing,Data Scientist,4.791975564343153,2,1,4,0,2,1,3,1,2,3,1,4,0,1,Commerce,Bachelors,25-30,4,0,0,Office,Tier1_City,2,2,3,2,3,3,2,30.95,Tech,5,5,2,5,0,4,4,3,1,4,0,0,1,3,54.05
Art,Biomedical Engineer,3.930942583396668,9,0,1,1,5,0,2,0,3,4,1,1,2,0,Arts,Masters,25-30,10,0,0,Remote,Tier1_City,2,1,2,1,0,1,5,38.83,Healthcare,2,4,5,2,2,5,2,5,3,3,1,0,4,3,55.81
Computer Science,Construction Manager,2.959477277392525,1,0,4,0,6,1,2,4,1,1,0,3,3,0,Science,Masters,25-30,8,0,0,Hybrid,Tier1_City,2,1,2,2,3,5,2,31.62,Healthcare,1,5,2,4,0,3,2,4,4,1,1,0,3,4,54.47
Psychology,Composer,4.235758629958084,1,2,1,0,4,1,4,0,4,4,1,1,4,1,Arts,PhD,36-40,8,0,0,Office,Tier1_City,5,2,4,1,2,1,2,22.67,Healthcare,3,5,5,2,1,0,1,4,2,2,0,0,5,1,60.93
Engineering,Quantum Physicist,4.452144809952501,4,1,1,1,7,1,2,1,1,2,4,1,1,0,Science,Bachelors,40+,2,0,0,Hybrid,Tier1_City,2,2,1,5,1,2,2,10.17,Healthcare,4,1,3,5,1,3,3,2,2,2,1,0,4,4,39.93
Medicine,Entrepreneur,4.924415870603408,8,0,4,0,3,1,4,2,0,0,1,3,3,1,Science,Bachelors,18-24,12,0,0,Hybrid,Tier2_City,1,2,0,5,1,5,4,24.79,Tech,5,1,1,1,4,5,5,1,1,3,1,1,3,1,47.6
Biology,Ecologist,4.651518607148364,8,1,2,1,4,1,1,2,4,3,3,0,2,1,Science,Masters,31-35,8,1,59,Remote,Any,2,3,3,1,1,2,2,16.85,Finance,5,3,2,4,5,2,1,3,1,1,0,0,1,2,51.3
Art,Human Resources Specialist,4.755266736632047,4,0,0,1,9,1,4,2,1,0,4,2,2,1,Arts,Bachelors,25-30,12,0,0,Remote,Any,1,3,4,5,0,1,3,35.71,Manufacturing,1,4,1,5,4,3,3,3,5,5,0,0,4,1,67.36
Marketing,Judge,4.695625312288997,4,2,2,0,4,0,4,2,1,0,4,2,1,1,Commerce,PhD,18-24,11,0,0,Flexible,Tier3_City,2,4,1,5,2,5,2,23.77,Tech,2,5,2,2,3,5,3,2,2,3,0,0,3,5,65.75
Psychology,Mechanical Engineer,3.9555907526836895,7,1,2,1,7,0,1,1,0,0,4,1,2,1,Arts,Masters,18-24,2,0,0,Remote,Tier2_City,2,3,0,5,4,5,3,42.94,Finance,3,1,4,3,3,2,5,3,3,5,1,0,5,2,45.75
Music,Software Developer,4.578350236183754,2,2,3,1,5,1,0,2,4,0,0,0,4,0,Arts,Bachelors,25-30,3,0,0,Remote,Any,5,1,1,3,1,2,5,12.09,Education,2,3,4,5,0,5,3,3,4,2,0,1,3,1,37.06
Art,Interior Designer,3.284032083541533,4,1,0,1,0,0,2,0,4,2,0,4,3,0,Arts,Masters,25-30,0,1,51,Flexible,Tier2_City,2,3,0,4,2,0,4,22.63,Finance,1,3,5,1,1,4,3,2,2,5,0,0,4,1,43.44
Business,Doctor,3.457889740626489,0,2,4,0,7,0,2,4,4,4,3,0,1,1,Commerce,Masters,18-24,4,0,0,Office,Tier1_City,4,2,5,2,3,3,5,29.2,Finance,1,3,1,3,0,5,5,4,3,3,0,0,5,3,60.98
Medicine,Financial Analyst,4.145470152368733,9,2,3,0,1,1,1,1,2,4,2,0,0,1,Science,Bachelors,31-35,11,1,46,Hybrid,Tier2_City,5,2,1,3,0,5,5,8.92,Finance,3,1,5,3,2,0,4,2,1,1,0,0,5,1,46.29
Architecture,Aerospace Engineer,4.989694332175217,9,1,3,1,4,0,1,1,3,4,3,1,4,1,Interdisciplinary,PhD,25-30,8,1,53,Office,Any,5,3,1,5,2,5,4,30.63,Tech,5,2,3,2,2,3,2,2,3,3,0,0,2,4,64.58
Finance,Chemical Engineer,4.287265740593622,9,1,1,1,6,1,0,0,3,3,4,3,2,0,Commerce,Bachelors,25-30,14,0,0,Office,Tier1_City,4,1,5,1,2,2,3,16.67,Finance,5,3,5,2,3,3,4,5,3,4,0,1,3,5,59.81
Finance,Civil Engineer,3.7644730956516814,0,0,1,0,4,1,3,0,3,2,2,4,3,1,Commerce,Masters,25-30,1,1,19,Office,Tier1_City,5,4,3,5,4,5,3,13.79,Finance,3,2,5,4,5,5,2,4,2,4,0,0,3,3,54.47
Chemistry,Biomedical Engineer,3.5948448175327097,3,2,3,1,6,0,0,4,2,3,2,2,4,0,Science,Bachelors,18-24,3,0,0,Remote,Tier1_City,2,2,4,4,2,2,3,9.67,Education,2,2,5,5,0,5,2,2,3,5,0,1,3,2,54.06
Biology,Animator,3.887240268598484,4,1,0,0,1,0,0,0,2,2,1,0,2,1,Science,Masters,25-30,9,0,0,Hybrid,Tier1_City,4,5,2,5,4,0,4,19.44,Education,3,2,2,4,2,3,5,5,2,2,0,0,1,4,48.02
Education,Credit Analyst,4.973407013284396,5,0,3,1,3,1,3,3,1,3,2,2,1,0,Arts,Bachelors,18-24,1,0,0,Remote,Tier1_City,2,4,1,1,0,5,2,46.66,Healthcare,5,3,2,4,3,0,4,3,5,1,0,1,5,2,45.91
Computer Science,Physician Assistant,3.01831354971388,5,0,1,1,9,0,1,2,2,1,0,2,3,0,Science,High School,25-30,13,0,0,Remote,Tier1_City,5,5,3,4,0,4,1,4.46,Other,2,5,3,3,0,5,5,1,5,5,1,0,3,4,52.12
Music,Composer,3.054456988360804,5,0,1,1,3,1,2,1,1,1,4,3,3,1,Arts,PhD,18-24,7,0,0,Hybrid,Any,3,5,5,5,3,1,2,43.05,Tech,4,2,1,2,1,3,4,4,3,3,0,1,4,3,61.18
Engineering,Entrepreneur,3.667634965031096,9,2,1,1,6,1,2,3,1,1,3,4,0,1,Science,Bachelors,25-30,8,0,0,Hybrid,Any,4,5,2,4,4,0,2,21.68,Finance,2,1,4,3,2,4,3,5,3,4,1,0,4,2,60.48
Architecture,Dentist,2.697789278222285,6,2,3,0,8,1,4,0,1,1,0,1,0,0,Interdisciplinary,Bachelors,18-24,2,0,0,Remote,Any,1,2,4,2,4,4,5,29.4,Healthcare,5,1,1,5,5,4,1,4,4,1,1,0,2,4,38.3
Chemistry,School Counselor,4.495426630655409,6,1,0,0,9,0,3,2,0,3,3,1,4,1,Science,PhD,31-35,12,0,0,Hybrid,Tier1_City,5,2,4,2,1,0,1,27.1,Healthcare,1,2,4,4,2,4,4,5,1,4,0,1,5,2,64.57
Finance,Physicist,2.964643481883521,7,2,2,1,9,0,2,3,2,3,3,3,3,1,Commerce,PhD,31-35,14,0,0,Hybrid,Tier1_City,3,5,1,5,1,3,3,46.51,Tech,2,2,2,4,1,4,4,3,5,1,0,0,1,4,68.51
Psychology,Data Scientist,3.4102717499735835,1,0,2,0,0,0,3,4,3,3,0,1,0,1,Arts,Masters,18-24,8,0,0,Hybrid,Tier1_City,5,5,5,4,3,0,2,39.2,Other,2,2,5,5,3,1,3,3,3,1,1,1,2,5,56.88
Physics,Psychologist,3.1529039416134834,5,2,3,1,9,0,3,1,3,0,1,3,2,0,Science,Masters,25-30,5,0,0,Flexible,Any,2,4,5,1,0,0,4,49.29,Healthcare,1,1,3,4,2,1,3,1,3,4,1,1,3,3,55.4
Biology,Musician,2.586443636187632,9,2,3,1,1,1,0,3,2,0,4,3,2,1,Science,Bachelors,18-24,5,0,0,Office,Tier1_City,2,2,0,5,5,3,2,40.34,Healthcare,5,4,3,2,1,4,2,3,3,4,0,1,5,5,55.69
Psychology,Analytical Chemist,4.112264263210518,4,2,3,0,5,0,0,0,2,1,2,4,2,0,Arts,Bachelors,25-30,6,0,0,Flexible,Tier2_City,2,5,4,2,1,5,3,16.91,Tech,4,5,3,2,3,3,1,3,3,3,1,0,1,5,41.71
Biology,Digital Marketing Specialist,3.475354387374594,2,1,1,1,7,0,4,4,4,1,2,1,2,0,Science,Bachelors,25-30,11,0,0,Hybrid,Tier1_City,3,1,3,2,2,1,2,48.26,Manufacturing,4,4,1,4,4,4,1,1,3,3,1,1,5,1,67.29
Music,Physicist,4.906672238638965,8,1,2,1,5,1,0,0,2,0,4,1,2,0,Arts,Masters,25-30,4,0,0,Office,Tier1_City,2,2,1,5,0,4,5,49.23,Healthcare,3,1,2,5,3,1,1,4,4,1,0,0,3,2,40.92
Architecture,AI Researcher,3.3182842695119747,9,1,3,1,9,1,3,4,4,3,1,1,4,1,Interdisciplinary,Masters,25-30,5,0,0,Flexible,Tier1_City,5,2,4,4,5,2,5,8.79,Education,4,1,2,3,2,1,4,3,1,3,1,1,2,5,56.34
Medicine,Teacher,4.673833099842297,4,2,2,1,7,0,1,1,4,1,0,4,4,0,Science,Masters,36-40,10,0,0,Office,Tier3_City,5,1,1,2,2,1,2,45.35,Healthcare,4,3,5,4,3,0,4,4,4,3,0,1,3,4,59.12
Biology,Music Therapist,3.307421856765343,0,2,4,0,7,0,4,2,2,2,3,3,2,1,Science,Masters,25-30,0,1,45,Office,Tier1_City,5,5,0,4,4,0,5,34.22,Tech,2,4,1,1,5,0,5,1,2,3,1,1,4,3,47.09
Medicine,Illustrator,4.964945970150843,5,1,2,1,0,1,2,0,4,4,0,3,1,0,Science,Bachelors,25-30,2,0,0,Hybrid,Tier1_City,4,3,4,2,0,2,4,46.33,Tech,3,2,5,2,2,3,2,2,4,1,1,0,2,1,38.76
Music,Dentist,3.731305671055015,0,2,0,0,8,1,3,0,4,0,0,4,2,1,Arts,Bachelors,25-30,11,0,0,Remote,Tier1_City,5,2,1,2,3,3,1,46.04,Other,4,2,4,1,3,0,3,3,1,2,0,1,4,3,51.48
Finance,Architect,4.59086011388635,0,1,3,1,0,0,2,1,4,0,1,4,1,0,Commerce,Bachelors,36-40,8,0,0,Flexible,Tier2_City,2,5,3,3,4,1,2,44.89,Manufacturing,2,1,2,1,4,2,3,4,1,2,1,1,3,1,45.76
Physics,Digital Marketing Specialist,4.016211713656024,1,2,3,0,5,1,2,0,2,3,3,0,1,1,Science,Bachelors,31-35,11,0,0,Office,Tier2_City,4,1,4,2,4,5,4,44.61,Manufacturing,3,3,3,1,3,2,3,5,2,5,0,0,2,4,58.39
Engineering,Psychologist,4.991004060214154,0,0,4,1,7,1,1,1,4,1,3,2,3,1,Science,Bachelors,25-30,4,0,0,Office,Any,4,1,0,1,2,4,4,8.53,Other,2,4,5,4,4,5,5,5,2,2,1,0,3,5,46.26
Biology,Legal Consultant,3.0234200394827484,5,2,0,0,5,0,3,4,1,3,1,3,3,1,Science,Masters,36-40,4,0,0,Remote,Tier2_City,4,2,2,5,4,1,4,9.75,Other,1,3,4,4,2,0,5,2,1,4,1,1,5,5,57.81
Engineering,Risk Analyst,3.105421111432788,0,1,4,0,0,1,3,1,2,3,0,0,3,1,Science,Bachelors,25-30,7,0,0,Hybrid,Tier1_City,4,1,2,5,1,1,3,8.54,Education,5,5,3,1,3,2,4,3,5,4,0,1,5,1,53.33
Biology,Legal Secretary,3.7378166513282594,7,2,0,0,6,1,4,3,4,2,0,1,3,1,Science,Bachelors,36-40,10,0,0,Hybrid,Tier2_City,3,1,1,4,0,5,2,7.28,Education,5,3,3,4,1,5,5,3,1,3,0,1,1,5,54.87
Psychology,Brand Manager,3.763720177281932,3,2,3,0,8,1,0,0,4,2,0,0,2,1,Arts,Bachelors,36-40,10,1,49,Office,Tier2_City,5,5,4,2,1,2,2,19.6,Healthcare,5,5,5,1,5,1,5,3,2,5,1,1,3,4,45.58
Education,Investment Banker,3.7497331341258415,9,0,0,0,7,0,4,4,4,4,1,0,3,0,Arts,Masters,18-24,12,0,0,Flexible,Tier3_City,3,1,4,1,2,3,2,35.15,Manufacturing,4,4,5,1,4,4,3,5,5,3,1,1,4,5,67.26
Marketing,Digital Marketing Specialist,2.8109224931145764,5,0,0,1,7,0,0,0,0,3,0,2,1,0,Commerce,Masters,31-35,1,0,0,Remote,Any,1,3,0,4,5,5,1,19.67,Education,5,2,5,3,0,4,5,2,2,3,0,0,1,2,39.33
Business,Paralegal,2.52119332216928,6,2,3,0,0,1,0,3,1,2,2,1,3,0,Commerce,Bachelors,25-30,12,1,16,Office,Tier3_City,3,5,2,3,2,3,4,36.85,Healthcare,5,5,2,3,4,2,2,5,4,2,1,0,2,5,52.27
Medicine,Ecologist,3.729258746281384,7,0,4,0,3,0,0,3,3,4,1,2,4,0,Science,Bachelors,25-30,6,0,0,Remote,Tier1_City,4,5,5,4,0,5,2,41.55,Finance,3,2,1,3,3,1,5,3,1,3,0,0,4,1,45.5
Physics,Graphic Designer,2.6318107523714698,0,0,1,0,3,1,0,3,2,1,3,4,4,1,Science,Masters,25-30,8,1,45,Hybrid,Tier1_City,5,2,3,4,4,1,5,34.31,Healthcare,3,3,5,5,4,1,1,2,4,5,1,1,5,1,70.03
Psychology,Forensic Psychologist,3.90083429838357,8,0,3,1,7,1,1,2,0,2,3,3,0,0,Arts,Bachelors,31-35,6,0,0,Hybrid,Any,5,5,5,2,3,3,3,24.86,Education,3,3,2,2,3,0,5,5,3,2,1,1,4,5,45.88
Music,Advertising Manager,3.0451319376376764,7,2,0,0,6,1,4,4,0,2,0,0,4,1,Arts,Masters,18-24,11,0,0,Office,Tier1_City,2,2,2,3,2,2,1,16.89,Healthcare,4,4,1,4,2,5,4,3,4,5,0,0,4,5,67.38
Finance,Musician,3.9598294083720216,0,0,3,1,1,0,3,3,1,1,1,4,1,1,Commerce,Masters,18-24,4,0,0,Flexible,Tier3_City,3,1,4,4,0,2,3,8.85,Finance,5,2,4,3,2,5,2,2,3,3,1,1,1,4,50.99
Law,Web Developer,3.742493616990237,6,1,4,1,3,1,4,0,4,3,0,3,2,0,Arts,Bachelors,31-35,12,1,37,Hybrid,Any,5,4,3,1,3,4,4,26.2,Education,4,4,1,2,5,1,5,2,1,3,1,1,3,2,53.76
Architecture,Education Administrator,4.69762372610807,8,1,1,0,6,0,4,2,2,2,0,2,2,0,Interdisciplinary,Bachelors,18-24,5,0,0,Hybrid,Tier2_City,1,3,3,1,4,3,5,36.82,Healthcare,4,5,2,2,1,1,4,1,2,2,1,0,5,5,44.54
Engineering,Paralegal,4.989461713988794,2,0,1,1,0,1,4,1,2,1,2,0,2,0,Science,PhD,18-24,3,1,14,Hybrid,Tier2_City,1,3,0,5,5,4,4,28.77,Education,4,3,2,4,0,1,2,2,5,1,0,1,2,2,55.13
Medicine,Acoustics Specialist,4.372028314892339,9,0,4,0,8,1,3,0,2,4,2,1,2,1,Science,Bachelors,18-24,13,0,0,Hybrid,Tier2_City,3,1,5,3,2,5,2,36.91,Other,4,3,1,5,5,5,5,1,5,2,0,1,2,1,59.35
Architecture,Chemical Engineer,2.948629819146693,0,2,2,1,9,0,0,4,0,1,0,3,3,0,Interdisciplinary,Bachelors,25-30,11,0,0,Flexible,Tier1_City,2,4,1,3,5,0,3,18.76,Other,4,3,1,1,2,4,2,3,3,1,0,1,5,4,48.95
Architecture,Credit Analyst,2.991737353992792,1,2,0,1,0,0,2,2,3,0,1,2,2,0,Interdisciplinary,Masters,25-30,6,1,10,Flexible,Tier2_City,1,5,1,5,0,2,5,6.14,Healthcare,4,3,2,3,1,2,1,1,2,1,1,1,2,5,44.0
Computer Science,Investment Banker,3.594194849455681,0,2,3,1,8,1,4,3,0,1,0,0,0,0,Science,PhD,18-24,0,0,0,Remote,Tier1_City,2,4,0,4,5,1,3,39.24,Tech,5,3,2,5,0,0,3,3,3,2,1,1,4,3,46.18
Medicine,Cybersecurity Analyst,3.257394945799904,8,0,0,1,6,0,4,3,1,3,4,2,0,0,Science,PhD,40+,3,1,40,Hybrid,Tier1_City,3,5,4,3,5,2,1,13.33,Education,3,5,4,4,1,0,5,3,5,3,0,0,2,3,71.03
Education,Special Education Teacher,2.8437699105233207,1,0,3,1,0,0,3,1,4,0,2,4,3,1,Arts,Masters,31-35,2,0,0,Remote,Tier2_City,5,5,4,1,0,0,5,31.97,Education,2,5,2,5,2,0,2,4,5,5,1,0,4,1,62.45
Education,Digital Marketing Specialist,4.0674261273220935,9,1,0,1,0,0,1,0,4,2,0,4,4,0,Arts,Bachelors,25-30,12,1,17,Hybrid,Tier2_City,2,5,1,1,0,1,1,40.8,Other,2,4,2,2,5,3,4,1,1,3,1,0,5,1,46.91
Finance,Human Resources Specialist,4.973033194065625,7,0,3,0,4,0,0,2,4,1,0,4,4,0,Commerce,Bachelors,25-30,3,0,0,Office,Tier3_City,1,4,2,2,2,3,5,9.54,Other,2,1,3,5,0,2,1,2,3,1,1,0,5,3,39.7
Medicine,Legal Secretary,3.878274676482445,1,0,1,1,2,1,4,3,4,2,2,0,4,1,Science,Masters,25-30,0,0,0,Remote,Any,2,1,0,3,5,3,2,31.13,Education,1,3,3,3,2,4,3,2,3,4,0,1,1,3,54.02
Music,Judge,2.549190965477268,8,1,4,1,0,0,3,3,2,3,4,2,0,0,Arts,Masters,31-35,11,1,53,Flexible,Tier1_City,5,5,2,4,3,2,3,35.4,Education,3,3,3,5,3,5,4,3,5,5,0,0,2,2,81.41
Biology,Market Research Analyst,4.203274296801133,0,2,1,1,9,1,1,4,1,2,4,3,3,1,Science,Bachelors,18-24,12,0,0,Hybrid,Tier3_City,5,1,0,5,0,1,3,38.09,Other,5,1,5,5,5,2,1,1,5,3,0,0,1,1,64.25
Architecture,Special Education Teacher,4.100424781001353,3,2,1,0,8,0,3,4,4,4,1,2,3,0,Interdisciplinary,PhD,18-24,1,0,0,Flexible,Tier1_City,1,5,0,5,4,5,4,9.94,Healthcare,4,4,5,2,0,0,5,5,1,4,0,1,4,3,56.68
Medicine,Ecologist,3.423521369861997,0,2,2,0,7,1,0,2,0,0,0,0,2,1,Science,Bachelors,36-40,11,0,0,Remote,Tier2_City,2,1,1,4,5,1,5,41.78,Manufacturing,2,5,2,5,1,4,4,2,2,4,1,0,2,3,49.92
Music,Nurse,2.731605658845909,7,1,1,1,5,0,2,3,4,2,3,1,4,1,Arts,Bachelors,25-30,10,0,0,Office,Any,2,1,1,2,0,4,5,7.42,Healthcare,3,3,3,2,3,2,2,5,2,5,0,0,1,4,59.31
Education,Conductor,3.8105474506010064,8,1,3,1,3,1,4,3,0,3,1,2,1,1,Arts,High School,25-30,12,1,33,Office,Tier1_City,4,1,5,5,3,0,1,27.42,Finance,5,4,4,3,1,5,1,1,2,1,1,1,5,3,50.9
Psychology,Marketing Manager,2.977883706472654,5,1,4,1,3,1,2,4,4,3,0,4,0,1,Arts,Bachelors,36-40,8,0,0,Remote,Tier2_City,1,2,2,3,2,3,5,23.84,Tech,2,1,4,3,2,1,1,2,4,4,0,0,4,3,67.25
Chemistry,Biologist,4.595496777247114,6,2,0,0,1,0,3,2,4,1,1,3,2,0,Science,Bachelors,31-35,14,0,0,Hybrid,Tier2_City,2,4,4,2,5,2,3,13.42,Healthcare,3,5,4,1,2,2,5,5,2,4,1,1,4,3,59.18
Music,Sound Engineer,3.673286030409447,0,2,1,0,9,0,1,3,1,4,3,2,4,1,Arts,Bachelors,25-30,6,0,0,Flexible,Tier3_City,3,5,3,3,0,1,5,17.19,Healthcare,5,5,2,1,3,5,1,2,1,5,1,1,2,5,50.17
Music,Biologist,3.985100348055428,8,1,3,1,5,0,1,3,0,0,0,1,3,1,Arts,Bachelors,31-35,12,1,34,Hybrid,Tier2_City,4,5,5,1,0,3,4,10.73,Education,3,4,3,2,3,1,3,4,3,2,0,1,2,3,43.17
Law,Composer,2.957325607069248,6,0,0,0,0,0,1,1,4,3,3,1,0,0,Arts,Masters,18-24,5,0,0,Hybrid,Tier3_City,1,2,2,2,4,2,4,23.01,Finance,4,2,2,1,0,0,2,4,3,5,1,1,5,1,61.86
Engineering,Entrepreneur,4.354508115901249,4,1,2,0,1,0,1,0,2,4,4,2,0,1,Science,Masters,31-35,1,0,0,Flexible,Tier1_City,5,1,0,5,4,3,3,4.67,Education,3,2,2,1,1,1,5,3,2,1,1,0,3,5,41.69
Music,Music Therapist,4.043280257855933,3,2,3,0,3,0,1,3,2,4,0,4,3,1,Arts,Masters,25-30,0,0,0,Remote,Tier3_City,1,1,3,2,5,2,3,44.78,Other,3,2,4,4,4,3,3,1,4,3,0,1,2,5,50.47
Education,Manager,2.770268118370485,4,0,3,0,6,1,3,1,3,3,1,2,1,0,Arts,PhD,36-40,1,0,0,Hybrid,Tier2_City,3,5,3,2,0,3,3,10.68,Education,1,1,3,1,2,4,5,2,3,3,0,1,3,4,45.9
Business,Brand Manager,3.951430501860522,3,1,0,1,4,0,2,3,1,2,4,3,1,1,Commerce,Bachelors,40+,6,1,14,Office,Tier2_City,3,3,5,2,5,5,5,44.64,Manufacturing,4,2,5,5,4,1,5,5,4,4,1,0,2,5,63.31
Biology,Manager,4.206011378414323,4,1,4,0,9,0,4,3,1,0,3,1,2,1,Science,Bachelors,36-40,1,0,0,Hybrid,Tier1_City,5,5,3,2,0,4,5,43.59,Tech,3,4,1,3,4,4,2,2,2,4,0,0,4,3,40.25
Chemistry,Clinical Psychologist,3.636007000974248,9,0,4,0,0,0,1,3,4,4,4,4,3,1,Science,Masters,36-40,2,0,0,Remote,Tier1_City,5,5,5,3,4,0,2,24.23,Manufacturing,4,5,2,1,3,5,1,2,4,4,0,0,3,4,63.18
Education,Pharmacist,2.620309739988657,3,2,0,0,5,1,3,2,4,0,2,0,2,0,Arts,Bachelors,25-30,7,0,0,Hybrid,Tier1_City,5,2,3,1,3,3,1,26.39,Education,3,4,3,2,1,1,5,5,5,3,0,0,1,4,58.89
Music,Physical Chemist,3.770938438597892,4,1,0,0,1,0,3,2,1,4,0,1,1,0,Arts,PhD,25-30,6,1,8,Office,Tier1_City,4,1,5,4,1,0,5,17.19,Tech,4,4,1,4,4,5,4,5,5,3,1,1,2,2,58.81
Art,Web Developer,3.8698566634250455,1,2,2,0,6,1,4,2,3,3,3,4,1,0,Arts,High School,25-30,11,0,0,Hybrid,Tier1_City,3,4,5,2,1,3,2,49.85,Healthcare,5,3,1,4,1,0,2,4,5,1,1,0,4,5,64.16
Chemistry,Nuclear Physicist,4.530645824580938,0,0,0,0,3,1,0,3,0,3,1,4,0,0,Science,PhD,31-35,10,0,0,Office,Tier3_City,5,5,3,5,0,1,2,34.53,Finance,2,1,5,3,3,2,2,3,1,2,1,0,1,4,56.03
Architecture,Pharmacist,2.73397860019418,4,2,3,1,5,1,2,3,2,3,2,2,4,0,Interdisciplinary,High School,36-40,10,0,0,Remote,Any,3,5,2,2,4,4,4,47.73,Manufacturing,1,5,5,3,5,5,4,5,1,2,1,1,2,2,51.03
Psychology,Judge,4.09589367867884,7,0,1,0,4,1,2,4,4,1,2,4,3,0,Arts,Masters,18-24,13,1,22,Office,Tier3_City,4,4,1,5,2,5,5,22.5,Finance,2,3,2,2,5,1,2,2,2,4,1,1,2,4,65.12
Art,Electrical Engineer,4.879308270243303,5,0,2,1,8,0,4,2,2,1,4,1,2,0,Arts,Bachelors,36-40,10,0,0,Hybrid,Tier3_City,4,2,1,3,2,4,2,44.5,Education,3,1,2,2,5,0,5,4,4,1,1,1,3,5,60.85
Architecture,Financial Analyst,4.678210521787442,8,2,1,1,6,1,4,3,1,3,4,3,3,0,Interdisciplinary,PhD,36-40,8,0,0,Flexible,Tier1_City,3,3,0,5,1,0,4,24.07,Tech,3,5,3,2,5,1,3,1,4,2,0,0,3,5,68.73
Medicine,Construction Manager,3.777415212769204,9,0,1,1,9,1,2,3,3,4,4,4,2,1,Science,Bachelors,40+,11,0,0,Remote,Tier2_City,5,2,4,4,3,1,1,43.74,Other,5,3,5,4,4,3,1,4,5,4,1,0,3,1,73.58
Finance,Biomedical Engineer,2.619965657204572,3,2,0,1,1,1,0,3,1,4,1,0,2,1,Commerce,Masters,36-40,3,0,0,Hybrid,Any,1,5,2,1,1,2,4,9.15,Healthcare,3,2,5,4,4,4,3,4,5,2,0,1,4,3,44.61
Architecture,Chemical Engineer,3.1062619933194746,6,0,3,0,4,0,4,3,1,1,0,2,4,1,Interdisciplinary,PhD,25-30,6,1,58,Remote,Tier3_City,2,2,3,5,0,4,1,32.93,Tech,4,4,3,2,2,1,2,4,5,2,1,1,5,3,56.32
Psychology,Entrepreneur,3.703410732097345,3,2,3,1,3,0,0,0,3,2,3,1,0,1,Arts,Bachelors,18-24,0,0,0,Hybrid,Tier1_City,3,4,1,5,3,5,3,34.9,Other,2,2,5,1,4,0,4,2,4,3,0,1,3,3,39.15
Computer Science,Market Research Analyst,4.45678638784435,9,1,3,0,1,0,1,3,3,3,4,2,1,1,Science,Masters,18-24,10,1,14,Remote,Tier2_City,4,2,0,1,2,1,3,33.84,Finance,3,5,4,1,0,0,2,5,4,1,0,1,1,1,62.27
Engineering,Architect,3.386612341634514,1,1,4,1,3,1,1,0,1,4,1,2,0,0,Science,Masters,25-30,10,0,0,Office,Tier1_City,5,5,3,4,4,1,4,24.01,Finance,5,3,1,2,3,2,2,3,5,3,0,0,3,1,61.03
Physics,Special Education Teacher,3.174976801156145,2,0,2,0,7,1,2,0,4,2,3,3,0,1,Science,Bachelors,31-35,1,0,0,Flexible,Tier1_City,2,4,0,2,4,0,3,35.14,Healthcare,1,3,4,2,0,4,2,1,4,4,0,1,4,2,51.43
Education,Industrial-Organizational Psychologist,4.729066673268039,6,0,3,0,8,1,4,3,4,4,3,2,2,0,Arts,Masters,36-40,6,0,0,Remote,Tier2_City,3,4,3,5,0,5,5,14.25,Other,2,3,1,4,5,5,1,3,1,2,0,0,1,3,61.84
Business,Cybersecurity Analyst,4.170469629363114,7,2,3,0,3,1,4,2,0,4,1,0,3,0,Commerce,Masters,36-40,14,1,51,Remote,Any,1,5,5,1,1,1,4,31.0,Other,5,4,3,1,4,2,2,2,2,3,0,0,4,2,56.76
Business,Teacher,2.989705047255093,3,1,3,0,1,1,1,4,2,4,0,0,4,1,Commerce,PhD,31-35,1,0,0,Flexible,Tier2_City,1,5,3,3,0,1,2,29.05,Healthcare,5,3,3,3,4,4,2,3,5,3,1,0,3,2,49.39
Psychology,Aerospace Engineer,3.667685154662608,7,1,4,1,8,0,0,3,3,4,0,2,2,0,Arts,High School,18-24,5,1,8,Hybrid,Tier1_City,4,5,1,1,4,2,5,17.96,Tech,2,1,1,3,0,4,2,3,3,3,1,1,5,4,47.57
Law,School Psychologist,4.755858160323944,0,2,4,1,5,1,4,3,3,2,4,2,3,1,Arts,Bachelors,18-24,12,0,0,Hybrid,Tier2_City,4,3,1,3,2,0,4,39.61,Manufacturing,5,1,1,5,2,1,4,1,1,2,1,0,1,3,61.86
Engineering,Financial Analyst,4.983848135872612,1,2,4,0,5,0,0,1,2,4,3,4,0,0,Science,PhD,18-24,9,0,0,Remote,Tier3_City,4,5,3,4,4,0,1,6.8,Tech,1,1,1,3,2,2,5,4,5,2,1,0,2,1,67.02
Engineering,Human Resources Specialist,2.8991748250353355,1,2,0,0,6,1,0,3,3,1,0,3,3,0,Science,Masters,25-30,11,1,23,Hybrid,Tier1_City,3,2,1,2,3,5,3,11.06,Finance,1,2,1,1,0,2,2,5,5,4,0,0,1,2,60.26
Law,School Psychologist,4.722621417592396,7,1,3,1,9,0,0,0,2,3,0,3,3,1,Arts,Bachelors,25-30,8,1,41,Remote,Tier2_City,1,1,2,1,5,1,3,25.14,Tech,3,5,2,4,0,2,2,5,4,3,1,1,4,3,51.79
Business,Psychologist,3.5949424050787746,8,1,2,0,8,0,0,0,2,2,0,3,2,0,Commerce,Masters,18-24,10,0,0,Office,Tier1_City,1,3,3,5,4,2,3,44.91,Education,4,2,5,1,3,0,2,3,1,2,1,0,3,5,46.79
Music,Construction Manager,3.842084743216347,0,2,0,1,2,1,1,3,1,0,2,3,3,0,Arts,Bachelors,25-30,4,0,0,Hybrid,Tier2_City,4,3,1,4,4,3,4,30.03,Tech,3,2,5,1,2,3,1,1,2,4,1,1,5,3,43.24
Music,Electrical Engineer,3.3308766511863963,3,2,3,0,4,0,1,1,0,1,2,4,0,0,Arts,Bachelors,18-24,9,0,0,Office,Tier1_City,4,1,0,1,5,4,5,42.58,Tech,4,4,3,3,5,1,4,5,3,4,0,0,1,2,55.59
Education,Education Administrator,3.558810765762391,4,2,0,1,2,0,3,0,4,1,0,0,2,0,Arts,Bachelors,31-35,6,0,0,Hybrid,Any,5,2,0,5,3,0,1,27.33,Other,2,2,2,2,1,5,3,5,5,3,1,1,1,5,47.42
Chemistry,Analytical Chemist,4.427229660677368,9,0,3,0,8,0,2,0,4,2,0,1,0,1,Science,Bachelors,25-30,12,0,0,Hybrid,Tier1_City,1,3,0,1,1,2,3,39.92,Education,5,4,1,5,5,2,5,5,2,4,1,0,1,3,53.12
Computer Science,AI Researcher,3.451905150345362,8,2,4,0,2,1,1,1,2,1,4,1,3,1,Science,Masters,25-30,0,0,0,Remote,Tier1_City,4,3,4,3,4,5,5,18.31,Finance,3,1,2,3,4,4,2,3,3,5,0,0,2,5,49.01
Music,Physicist,4.316468283771305,6,0,0,0,4,1,4,3,3,0,3,0,1,0,Arts,Bachelors,25-30,7,0,0,Flexible,Tier1_City,4,5,0,1,0,2,2,41.31,Healthcare,5,1,1,3,4,5,3,2,2,1,1,1,3,2,48.15
Engineering,Urban Planner,3.946512333564581,4,0,1,1,3,1,2,1,0,0,1,4,0,1,Science,PhD,40+,8,0,0,Hybrid,Tier2_City,4,4,5,1,4,1,2,21.88,Tech,3,2,5,3,0,5,3,3,4,4,1,1,5,4,58.53
Biology,Doctor,3.738218269397783,6,1,0,1,6,0,3,2,2,0,1,2,1,0,Science,PhD,18-24,14,1,53,Remote,Tier3_City,5,3,0,1,0,4,1,29.27,Manufacturing,3,2,1,5,5,4,1,3,1,1,0,0,1,3,56.54
Architecture,Financial Controller,2.964601838448427,1,1,3,0,0,1,2,2,2,4,1,1,3,1,Interdisciplinary,Masters,25-30,12,0,0,Remote,Tier1_City,1,2,2,4,3,0,3,11.27,Other,1,1,5,4,1,1,1,2,5,4,0,1,4,4,67.2
Chemistry,Zoologist,3.186656297631006,0,2,2,0,2,1,1,4,3,3,2,3,0,0,Science,Bachelors,31-35,4,0,0,Remote,Tier1_City,1,4,2,1,4,3,2,46.26,Other,4,3,1,3,2,0,3,5,3,3,0,0,4,5,54.97
Business,Acoustics Specialist,3.823964042320559,3,1,4,1,8,0,0,3,3,0,0,4,1,1,Commerce,Bachelors,25-30,5,1,57,Remote,Tier3_City,1,1,4,5,3,1,5,35.97,Healthcare,2,1,3,4,2,2,2,3,5,1,1,1,4,3,48.92
Finance,Dentist,3.112462052236884,3,2,1,1,3,1,2,2,4,2,0,4,3,0,Commerce,Masters,36-40,12,0,0,Hybrid,Tier3_City,5,3,2,3,3,0,5,43.37,Manufacturing,5,3,5,4,2,3,5,4,3,1,0,1,2,1,60.46
Law,Clinical Psychologist,3.791244012151496,0,1,1,1,9,1,4,2,3,0,0,0,3,1,Arts,Masters,25-30,10,0,0,Hybrid,Tier3_City,3,2,1,3,1,5,2,12.77,Tech,3,1,3,1,5,0,2,5,2,1,1,0,5,4,49.2
Architecture,Art Therapist,3.675740408902676,9,2,4,0,2,0,0,4,2,2,0,3,1,1,Interdisciplinary,Bachelors,25-30,7,0,0,Flexible,Tier2_City,5,1,0,1,4,0,3,6.18,Manufacturing,5,5,2,2,0,1,4,5,5,1,1,1,4,4,50.54
Medicine,Organic Chemist,2.8357865591819347,4,2,3,1,8,0,0,0,3,0,1,2,4,1,Science,PhD,18-24,3,0,0,Remote,Tier3_City,2,5,1,4,0,2,1,18.85,Other,1,4,1,5,0,2,4,5,1,4,0,0,2,5,43.51
Law,Graphic Designer,2.876927201091916,3,1,3,0,0,1,0,2,0,3,0,0,4,1,Arts,Masters,31-35,1,1,55,Office,Tier1_City,5,5,4,4,0,4,3,27.28,Healthcare,2,4,2,2,4,1,4,3,3,1,1,1,5,2,27.1
Computer Science,Nurse,3.5848722465860465,1,1,4,1,4,1,0,2,4,3,4,3,4,1,Science,PhD,25-30,14,0,0,Hybrid,Tier2_City,2,4,1,5,4,3,4,40.71,Manufacturing,4,5,1,4,5,1,2,1,4,3,0,1,1,1,74.69
Business,AI Researcher,4.210981204169502,7,0,2,0,4,0,4,0,2,1,0,1,3,0,Commerce,Masters,18-24,9,0,0,Remote,Tier3_City,4,1,5,1,5,4,2,21.69,Manufacturing,4,3,5,4,4,1,1,1,2,3,0,0,5,2,54.49
Music,Biologist,4.86998141561401,3,2,0,1,5,0,4,0,0,0,0,4,3,1,Arts,Masters,25-30,7,0,0,Flexible,Tier1_City,2,4,1,3,1,2,4,15.69,Healthcare,3,2,1,5,2,1,3,2,4,5,1,0,5,3,59.16
Architecture,Risk Analyst,4.821776900502753,4,0,0,1,8,1,2,4,2,0,0,2,4,1,Interdisciplinary,Bachelors,25-30,1,1,56,Office,Tier2_City,5,1,1,4,1,3,2,20.51,Healthcare,2,2,4,2,4,3,3,1,2,3,0,0,5,2,33.96
Finance,Judge,4.556017842413667,3,1,1,1,7,1,1,3,1,2,4,2,0,1,Commerce,PhD,18-24,4,0,0,Hybrid,Tier3_City,3,1,5,1,1,3,1,36.07,Healthcare,4,4,4,1,4,1,2,5,1,4,0,1,5,4,49.01
Finance,Marketing Manager,3.676650893887704,7,2,3,1,8,0,4,2,3,4,3,1,1,0,Commerce,Masters,31-35,14,0,0,Office,Tier2_City,1,5,2,4,0,1,3,18.8,Other,2,2,4,2,2,4,2,4,4,3,1,0,5,1,67.03
Law,Physical Chemist,4.424788113513467,0,0,1,1,3,0,3,2,1,0,1,2,0,1,Arts,High School,31-35,12,0,0,Flexible,Tier2_City,5,4,0,4,3,3,3,49.02,Healthcare,5,3,3,3,0,1,5,4,2,2,0,0,5,3,43.18
Music,Counselor,2.861502054617953,8,0,0,1,2,1,2,2,2,3,0,1,1,0,Arts,High School,18-24,5,0,0,Hybrid,Tier1_City,1,5,5,3,5,0,2,11.22,Education,1,2,4,2,4,3,4,5,4,1,0,0,1,3,41.56
Computer Science,Physician Assistant,3.981998818113134,1,2,1,1,4,1,1,0,4,2,2,2,2,1,Science,Bachelors,25-30,4,0,0,Remote,Tier1_City,2,1,1,2,1,4,5,38.4,Tech,2,1,1,4,0,1,2,3,2,3,1,1,4,4,46.85
Education,Biologist,3.513441349692001,3,1,3,0,4,1,3,0,1,3,4,1,3,0,Arts,Masters,31-35,5,0,0,Remote,Tier1_City,4,5,3,5,0,5,4,30.69,Other,2,5,2,5,1,2,5,3,1,4,1,1,2,2,53.88
Marketing,Industrial-Organizational Psychologist,4.204041317655255,7,2,1,0,8,1,3,0,1,1,3,1,0,0,Commerce,PhD,25-30,5,0,0,Office,Any,4,4,0,5,0,5,3,13.96,Healthcare,4,4,3,3,0,0,5,5,5,3,1,0,5,3,54.94
Art,Software Developer,2.80517949216687,7,0,3,0,7,0,4,1,3,1,2,0,0,1,Arts,Bachelors,25-30,2,0,0,Office,Any,5,4,0,3,3,4,3,38.42,Finance,3,2,5,4,3,3,1,5,2,4,0,0,1,3,47.72
Chemistry,Electrical Engineer,3.5574103380453748,2,1,2,0,0,0,4,4,0,0,1,1,0,0,Science,Masters,25-30,10,0,0,Office,Tier1_City,2,2,3,4,4,1,2,24.03,Manufacturing,3,3,3,2,3,5,4,2,3,2,0,1,1,3,57.56
Chemistry,Mechanical Engineer,4.294704227100094,9,1,3,0,0,1,2,0,4,4,1,3,0,1,Science,Bachelors,31-35,10,0,0,Remote,Tier1_City,2,5,4,1,4,3,5,35.07,Healthcare,5,2,2,5,2,5,3,3,5,1,1,1,1,1,63.52
Law,AI Researcher,2.5327031625738803,3,0,3,1,9,0,3,3,3,1,4,1,0,1,Arts,PhD,36-40,2,1,21,Flexible,Tier1_City,1,2,4,4,1,2,4,34.13,Healthcare,4,5,4,3,3,2,2,1,4,2,1,1,2,4,57.16
Finance,Social Media Manager,2.8508752285858154,8,1,0,0,7,1,0,0,4,0,3,4,4,1,Commerce,Masters,31-35,8,0,0,Hybrid,Tier1_City,2,1,0,3,1,0,5,8.2,Tech,4,1,2,2,1,3,1,1,4,2,0,1,2,3,55.66
Engineering,Landscape Architect,2.6223893628387582,9,0,3,1,2,0,4,1,4,3,4,4,0,1,Science,Masters,18-24,2,0,0,Hybrid,Tier1_City,3,5,2,5,5,1,5,42.48,Healthcare,1,4,3,3,0,0,1,3,4,5,1,0,4,1,69.89
Art,Special Education Teacher,2.563114960736377,1,1,2,1,1,0,2,0,0,2,2,2,3,1,Arts,Bachelors,25-30,2,0,0,Remote,Tier1_City,4,3,5,4,3,3,2,35.03,Other,3,4,3,1,0,4,5,4,3,1,1,0,3,1,36.84
Computer Science,Counselor,4.053285719414198,3,1,1,0,3,1,0,4,1,2,4,1,4,0,Science,Bachelors,36-40,10,0,0,Flexible,Tier3_City,3,2,4,5,1,5,5,39.69,Education,4,3,3,1,5,0,3,5,3,2,1,0,4,5,53.77
Architecture,Composer,2.766079572543405,4,2,0,0,6,0,0,2,0,2,4,4,0,0,Interdisciplinary,Bachelors,18-24,13,0,0,Hybrid,Tier3_City,3,4,4,1,3,2,4,24.04,Finance,5,1,2,5,4,4,1,2,3,2,0,1,5,3,58.38
Business,School Psychologist,3.7205629370551,4,1,0,1,5,1,4,1,4,4,0,4,3,1,Commerce,Bachelors,40+,1,1,25,Hybrid,Tier1_City,1,2,1,5,0,3,1,12.17,Finance,1,2,1,1,4,1,4,2,3,1,0,0,5,5,42.97
Chemistry,Zoologist,4.423366483414892,4,2,0,1,1,0,0,0,0,0,4,0,1,0,Science,Masters,36-40,6,0,0,Flexible,Tier2_City,2,5,1,5,1,1,1,18.33,Healthcare,3,2,1,4,4,2,1,2,3,2,1,0,2,5,43.07
Marketing,Credit Analyst,4.502780640278038,6,1,4,0,1,0,1,1,0,2,1,1,3,0,Commerce,Masters,18-24,9,1,16,Flexible,Tier2_City,1,2,4,2,0,2,4,45.37,Tech,3,3,4,2,0,3,5,1,3,3,1,1,4,1,49.06
Music,Geneticist,4.836418786935649,1,2,3,1,4,0,1,1,2,2,0,0,1,0,Arts,PhD,36-40,9,1,35,Remote,Tier1_City,4,4,2,2,2,2,2,47.09,Other,3,1,5,3,0,4,1,4,5,3,0,1,1,3,55.95
Biology,Urban Planner,2.515117991722528,8,1,3,0,9,0,3,1,3,2,0,0,3,0,Science,PhD,25-30,3,0,0,Flexible,Tier3_City,1,2,1,2,3,2,3,25.65,Other,1,3,2,3,5,5,5,4,5,3,0,0,1,1,52.92
Medicine,Industrial-Organizational Psychologist,2.554074224440204,1,1,3,1,3,0,2,4,4,3,3,2,1,1,Science,Masters,36-40,0,1,7,Office,Tier1_City,3,2,5,5,2,2,2,17.04,Healthcare,5,5,1,1,4,3,1,2,4,1,1,1,4,2,49.77
Computer Science,Physician Assistant,4.245862295657437,1,2,4,1,5,0,0,2,4,1,1,3,3,0,Science,Masters,25-30,5,0,0,Remote,Tier1_City,1,3,2,3,1,3,4,37.32,Manufacturing,5,5,4,3,5,0,4,5,3,3,1,1,5,3,53.25
Finance,Judge,4.866482836944779,8,2,3,1,9,1,2,2,1,3,1,4,4,1,Commerce,PhD,25-30,4,0,0,Remote,Tier1_City,2,1,5,5,0,2,5,39.0,Other,4,2,5,3,0,1,2,5,1,2,0,1,1,2,45.73
Medicine,Industrial-Organizational Psychologist,3.5061522679523645,7,1,3,1,6,0,4,1,1,2,3,1,1,1,Science,Masters,31-35,13,0,0,Hybrid,Any,1,4,5,3,1,3,1,41.33,Other,4,5,4,2,1,0,2,5,4,3,0,1,5,2,61.66
Chemistry,Entrepreneur,3.300943726008631,8,2,3,0,6,0,2,0,2,2,2,0,2,0,Science,Bachelors,31-35,10,0,0,Hybrid,Tier2_City,2,1,0,3,2,2,5,4.46,Other,3,3,4,5,4,4,1,2,4,5,0,0,4,4,58.35
Medicine,Landscape Architect,4.053205517839612,8,2,2,1,9,0,4,3,4,0,3,1,3,0,Science,Bachelors,18-24,1,1,49,Office,Tier2_City,3,3,5,2,1,2,2,3.46,Finance,2,4,5,3,3,2,3,5,2,1,0,1,1,2,40.25
Physics,Inorganic Chemist,4.802182100295582,7,0,4,0,8,0,3,0,4,4,0,4,3,0,Science,Bachelors,25-30,5,1,51,Remote,Tier3_City,2,5,5,4,5,1,4,19.79,Other,4,5,3,1,4,4,2,3,4,4,0,1,5,2,60.92
Education,Graphic Designer,3.931778186905453,3,1,1,0,8,1,3,1,2,2,4,4,1,1,Arts,PhD,18-24,0,1,11,Office,Tier1_City,2,5,2,1,4,3,1,10.17,Manufacturing,5,3,1,1,3,4,1,2,4,3,1,0,3,5,58.91
Education,School Counselor,2.876314206845984,4,1,3,0,8,0,2,4,2,1,2,0,2,0,Arts,Masters,25-30,2,0,0,Office,Any,2,3,1,2,2,5,4,40.83,Education,3,4,1,5,2,5,2,4,4,5,1,1,1,3,56.37
Architecture,Cybersecurity Analyst,3.905836951674198,0,0,4,1,2,1,0,0,4,1,2,2,4,0,Interdisciplinary,Bachelors,25-30,3,0,0,Hybrid,Tier2_City,2,5,5,2,1,3,1,28.04,Finance,5,4,5,3,3,0,5,1,2,3,1,0,2,2,40.18
Art,School Counselor,4.784521456353767,3,1,1,1,3,0,1,4,4,4,2,0,4,0,Arts,Masters,25-30,12,0,0,Flexible,Tier2_City,4,5,3,4,0,4,1,41.79,Finance,3,5,1,3,5,4,1,3,1,4,0,1,3,5,62.23
Education,Social Media Manager,4.050123384582957,2,2,0,0,7,0,4,3,0,2,4,4,3,1,Arts,Masters,25-30,2,0,0,Office,Tier3_City,5,2,2,1,1,5,1,11.31,Education,1,1,2,3,1,2,1,1,3,4,0,0,4,1,58.41
Biology,Brand Manager,2.7910254649487984,2,0,0,1,3,1,2,3,2,1,1,0,4,1,Science,Bachelors,18-24,14,0,0,Remote,Tier2_City,4,2,4,5,0,1,2,32.48,Manufacturing,4,5,2,5,0,1,2,3,2,5,1,1,5,1,54.06
Finance,Dentist,4.912964167403755,8,2,4,0,0,1,0,4,0,2,3,2,1,0,Commerce,Bachelors,18-24,12,0,0,Office,Any,1,2,5,5,4,3,4,30.27,Healthcare,1,5,2,1,5,0,4,2,3,4,0,1,1,3,55.86
Biology,Financial Analyst,4.175904114963241,4,0,2,0,8,0,0,0,3,4,1,4,3,0,Science,Masters,18-24,5,0,0,Flexible,Tier3_City,4,3,5,2,1,1,3,19.0,Tech,4,1,5,3,5,4,1,4,5,3,1,1,2,2,53.6
Medicine,Risk Analyst,4.196537414888087,5,2,1,0,8,1,2,0,3,2,4,4,2,1,Science,Bachelors,25-30,10,0,0,Remote,Tier1_City,4,5,2,1,4,5,3,27.3,Manufacturing,5,5,4,3,1,3,1,3,4,5,0,0,1,4,72.18
Biology,Accountant,4.629321978258657,2,0,0,1,3,0,2,2,2,4,2,1,0,1,Science,Masters,40+,3,0,0,Flexible,Tier1_City,2,1,2,2,2,1,3,30.68,Education,5,3,4,4,2,1,4,2,4,5,1,0,3,4,56.31
Architecture,Special Education Teacher,3.086573705326807,5,2,4,0,3,0,3,0,3,1,1,3,4,1,Interdisciplinary,Bachelors,18-24,13,0,0,Remote,Tier1_City,1,4,2,3,0,1,4,44.81,Other,2,1,3,2,5,0,4,4,4,2,1,0,5,2,53.46
Medicine,Inorganic Chemist,2.6286856520792288,3,0,3,0,4,0,1,3,1,4,1,1,1,1,Science,Masters,36-40,0,1,44,Hybrid,Tier1_City,1,5,4,2,5,0,5,5.62,Other,5,3,3,5,1,2,4,1,4,1,1,0,5,1,43.43
Art,Biotechnologist,3.240976453010461,0,2,0,0,9,0,1,4,1,2,4,3,0,0,Arts,Masters,31-35,4,0,0,Office,Tier1_City,3,3,5,2,2,3,4,41.7,Education,3,4,2,2,1,2,3,3,1,4,0,1,2,1,52.55
Music,Market Research Analyst,3.636251605998875,3,0,2,0,4,0,4,3,0,2,0,1,4,0,Arts,Masters,31-35,4,0,0,Office,Tier1_City,2,2,2,5,0,1,1,49.07,Other,2,1,2,5,2,1,3,2,3,2,1,0,5,5,48.57
Music,Social Media Manager,3.9339907576973,8,0,2,1,7,1,1,0,4,3,1,2,3,0,Arts,Masters,31-35,8,1,50,Office,Tier1_City,4,4,3,5,4,0,5,37.39,Education,3,4,5,2,1,2,4,3,2,3,1,0,2,5,58.06
Biology,Art Director,2.6339012936863657,3,2,2,0,3,1,2,2,2,2,4,4,0,0,Science,Bachelors,36-40,7,1,56,Hybrid,Tier3_City,3,4,4,5,3,0,1,37.66,Finance,2,2,2,4,2,0,3,5,2,1,1,0,3,4,56.39
Law,Human Resources Specialist,4.960790343496456,6,0,2,0,7,0,4,2,2,2,3,0,1,1,Arts,Bachelors,18-24,14,1,38,Office,Tier3_City,3,4,3,3,1,2,1,13.24,Healthcare,3,2,2,2,0,0,4,3,1,3,0,1,2,5,55.08
Chemistry,Financial Advisor,4.748608889122586,9,2,2,1,7,1,3,0,4,0,1,3,3,0,Science,High School,25-30,7,0,0,Office,Tier1_City,4,1,3,5,4,2,4,27.58,Finance,2,3,2,3,4,5,5,4,1,2,0,0,4,2,42.28
Education,Electrical Engineer,2.821056800466672,9,2,0,1,1,1,1,2,0,0,3,4,2,0,Arts,Masters,31-35,4,0,0,Hybrid,Tier1_City,1,2,3,1,0,5,3,36.18,Finance,4,4,1,2,0,0,5,5,5,2,0,1,4,5,48.0
Education,Investment Banker,3.386366086322661,4,2,1,0,2,0,2,2,3,1,1,3,2,0,Arts,Masters,25-30,7,1,59,Hybrid,Tier1_City,2,2,4,4,0,3,5,31.31,Finance,4,4,4,2,0,5,1,4,3,2,0,1,5,3,48.98
Physics,Music Teacher,2.584353235526571,0,2,4,1,4,1,1,0,4,1,4,0,3,0,Science,Masters,36-40,13,1,32,Office,Any,2,2,1,1,0,2,2,21.1,Education,2,1,1,1,0,4,1,1,4,1,1,1,2,4,50.98
Biology,Physical Chemist,3.1271105985551126,8,2,1,0,3,1,4,0,4,0,4,3,3,1,Science,Bachelors,18-24,9,0,0,Hybrid,Tier2_City,4,2,4,1,0,5,3,47.19,Manufacturing,1,2,2,5,1,2,4,5,4,1,1,0,2,1,56.82
Biology,Risk Analyst,4.5644426219120895,0,1,4,0,4,1,1,1,0,4,0,0,4,0,Science,Bachelors,31-35,6,0,0,Hybrid,Any,2,5,2,5,1,3,2,27.16,Tech,2,3,2,2,0,4,4,5,1,2,1,0,1,5,31.77
Education,Investment Banker,4.220351756122299,9,0,1,1,3,0,4,2,4,1,4,1,3,0,Arts,High School,25-30,0,0,0,Remote,Any,5,4,5,4,2,5,4,48.58,Tech,1,3,1,3,2,2,3,4,1,4,1,1,2,3,45.21
Computer Science,Urban Planner,3.340118267595602,3,1,3,1,9,1,0,4,0,1,0,3,0,1,Science,Bachelors,25-30,11,0,0,Office,Any,3,4,3,4,5,0,5,29.5,Healthcare,3,1,1,3,2,5,1,2,2,5,1,1,1,1,54.38
Computer Science,Aerospace Engineer,3.2007119263771475,3,1,4,1,6,1,3,2,4,2,3,1,2,0,Science,Masters,25-30,6,0,0,Remote,Tier1_City,3,4,2,4,3,0,4,40.29,Healthcare,2,1,5,5,5,2,3,3,2,4,1,1,3,5,61.16
Medicine,Marketing Specialist,3.5248391101869365,2,0,1,1,8,0,3,2,3,1,0,0,0,1,Science,Bachelors,31-35,10,0,0,Hybrid,Tier2_City,5,3,3,3,1,3,2,37.88,Education,1,3,5,4,5,2,2,1,1,2,0,0,1,2,45.74
Biology,Market Research Analyst,4.182769085036258,0,2,1,0,6,1,2,3,1,1,4,2,3,1,Science,Bachelors,36-40,7,1,41,Remote,Any,2,2,3,5,0,5,1,34.06,Tech,2,1,2,5,2,3,4,1,5,4,1,0,5,4,58.77
Biology,Nurse,4.093504986197294,9,1,1,0,0,1,0,2,2,3,4,1,2,0,Science,PhD,25-30,2,0,0,Remote,Tier1_City,1,5,5,4,1,5,4,3.68,Manufacturing,4,4,1,3,5,4,1,2,5,2,1,1,4,1,55.44
Engineering,Physician Assistant,3.142490667893161,0,0,2,1,2,0,4,2,1,3,4,4,0,1,Science,Bachelors,36-40,8,1,44,Hybrid,Tier2_City,5,5,2,3,4,2,5,6.64,Education,4,3,5,4,2,1,1,4,4,2,0,1,5,1,64.43
Music,Architect,3.8718510066023777,2,0,2,1,0,1,1,2,3,0,1,0,4,1,Arts,Bachelors,25-30,7,0,0,Hybrid,Tier1_City,5,3,0,2,5,2,4,30.33,Healthcare,2,5,3,4,5,4,3,1,5,2,0,0,1,3,50.1
Physics,Analytical Chemist,4.597050306272982,6,1,3,1,9,1,4,3,2,1,4,1,3,1,Science,Masters,18-24,1,0,0,Hybrid,Tier1_City,3,3,3,2,0,3,3,45.85,Education,2,2,1,1,0,5,5,3,4,3,0,0,1,4,50.21
Education,Social Media Manager,3.7295454002825,0,1,4,0,6,0,2,4,1,4,2,0,1,0,Arts,Bachelors,18-24,5,0,0,Remote,Any,1,4,5,3,3,4,4,31.25,Healthcare,5,2,4,2,3,2,4,2,5,4,0,1,1,4,58.64
Architecture,Architectural Technologist,2.559447412736545,7,0,4,0,6,0,0,0,2,3,0,3,4,0,Interdisciplinary,Masters,18-24,3,1,52,Flexible,Tier2_City,1,4,0,3,0,2,2,14.09,Tech,4,5,3,1,5,1,4,5,5,2,0,1,5,3,43.06
Computer Science,Physical Chemist,4.20974111051704,5,1,3,1,8,1,3,3,0,2,2,4,2,1,Science,Masters,25-30,2,0,0,Remote,Tier3_City,2,4,4,5,5,1,4,18.05,Education,3,5,3,2,4,1,4,3,1,3,1,0,2,5,49.85
Medicine,Architectural Technologist,2.9589609071218232,7,0,4,0,5,1,0,0,0,3,1,3,2,0,Science,PhD,25-30,10,0,0,Flexible,Tier2_City,1,4,3,5,3,2,5,32.29,Finance,2,4,1,1,3,1,5,4,5,2,0,0,3,3,59.68
Engineering,Artist,2.9715836040118746,7,0,3,1,2,1,4,4,2,2,4,2,3,0,Science,Bachelors,31-35,5,1,28,Office,Tier2_City,2,4,3,2,5,4,4,31.06,Other,5,3,2,4,1,3,4,4,4,4,1,0,5,1,68.45
Marketing,Art Therapist,4.671129215283781,6,2,1,1,9,0,4,0,1,4,2,1,0,0,Commerce,PhD,31-35,9,0,0,Remote,Tier3_City,4,2,5,4,3,5,4,47.92,Healthcare,2,1,4,2,0,0,5,2,3,2,1,0,1,1,60.44
Computer Science,School Counselor,4.3672723946961405,8,0,4,1,1,1,0,4,3,1,2,1,2,0,Science,Bachelors,18-24,12,1,12,Hybrid,Any,5,5,4,2,2,0,5,27.87,Finance,4,2,5,3,3,2,5,5,3,3,0,0,2,2,52.66
Law,Ecologist,3.2565821724440767,9,2,1,1,5,1,3,4,3,3,4,1,0,0,Arts,Bachelors,18-24,14,1,36,Flexible,Any,5,2,2,4,2,0,4,19.69,Healthcare,1,5,5,4,0,2,3,5,2,4,1,0,5,4,64.75
Finance,Chemist,4.551631690419487,2,1,0,0,4,0,1,4,3,1,3,3,3,1,Commerce,Bachelors,25-30,8,1,56,Hybrid,Tier3_City,2,5,2,4,1,5,5,27.67,Finance,1,3,2,5,2,4,4,2,4,5,1,1,5,1,64.45
Medicine,Graphic Designer,4.812802922441478,6,0,1,1,8,0,4,3,4,3,0,0,3,0,Science,PhD,25-30,1,0,0,Remote,Tier2_City,2,1,0,5,1,0,2,39.95,Tech,4,1,4,4,1,1,5,2,1,3,0,1,5,1,49.47
Medicine,Special Education Teacher,4.075280520068191,4,1,0,0,9,1,0,2,4,0,2,2,1,1,Science,Bachelors,18-24,9,0,0,Hybrid,Tier1_City,2,1,4,1,3,2,5,28.4,Tech,3,2,4,3,3,3,5,2,1,2,1,0,1,4,50.06
Physics,Marketing Manager,3.1302050524130065,7,0,0,0,1,0,4,0,0,2,3,2,3,0,Science,Bachelors,18-24,9,1,22,Hybrid,Tier1_City,5,1,3,1,0,0,2,18.32,Manufacturing,5,3,3,1,4,1,3,5,2,4,0,0,2,5,53.56
Engineering,Inorganic Chemist,4.707441743489423,9,1,2,1,9,1,3,3,1,2,1,0,4,1,Science,Masters,36-40,9,0,0,Office,Tier1_City,2,5,0,3,4,4,2,18.92,Manufacturing,2,2,3,2,2,4,4,4,3,5,1,0,5,4,64.08
Medicine,Illustrator,4.2155201632573,1,2,2,0,1,1,4,0,3,0,1,4,4,0,Science,Bachelors,36-40,4,0,0,Flexible,Tier1_City,5,3,2,5,4,4,5,38.57,Manufacturing,2,4,4,1,5,0,2,4,4,2,0,1,4,1,49.78
Physics,Nuclear Physicist,2.9757553674105384,7,0,0,1,1,0,2,4,0,4,4,4,4,1,Science,Bachelors,18-24,5,1,41,Remote,Tier1_City,5,2,3,4,0,2,4,6.12,Education,2,2,1,1,2,2,5,3,5,1,0,0,3,4,52.43
Education,Legal Analyst,3.2842987932940884,6,2,4,0,0,1,0,0,1,2,4,2,3,1,Arts,Bachelors,25-30,3,0,0,Hybrid,Tier1_City,3,3,5,1,0,5,3,15.91,Healthcare,5,4,1,2,5,1,1,4,2,2,1,1,5,5,34.56
Chemistry,Ecologist,4.545237203083996,2,2,1,1,3,0,2,3,2,3,2,2,3,0,Science,Bachelors,25-30,6,1,59,Remote,Tier1_City,3,5,2,4,2,1,5,10.19,Education,5,4,1,1,5,2,3,2,4,5,0,1,1,1,54.65
Music,Organic Chemist,2.897807789054597,2,0,1,1,4,0,2,1,1,3,1,1,0,0,Arts,Bachelors,31-35,1,1,36,Flexible,Tier2_City,4,4,0,1,4,2,4,47.4,Manufacturing,4,4,4,3,1,4,3,3,5,3,1,0,2,5,47.13
Art,Electrical Engineer,3.59754196634824,9,1,3,1,9,0,3,2,1,2,2,3,0,1,Arts,Bachelors,25-30,6,1,54,Hybrid,Tier1_City,4,3,2,1,3,0,2,7.23,Healthcare,5,1,5,5,5,5,3,1,5,5,1,1,3,2,65.66
Chemistry,Urban Planner,3.889513855905742,8,0,3,1,9,0,4,0,4,4,1,3,4,1,Science,Masters,18-24,1,0,0,Flexible,Tier3_City,1,5,5,1,5,2,1,38.63,Education,2,1,1,2,2,0,4,5,4,2,1,1,4,5,53.73
Architecture,Biologist,4.878236282425384,2,0,2,1,6,1,4,2,2,2,3,4,2,0,Interdisciplinary,Bachelors,31-35,0,0,0,Hybrid,Tier1_City,2,1,2,5,1,4,3,32.63,Tech,2,4,5,1,2,3,2,3,1,3,1,0,1,1,41.61
Music,Music Therapist,4.574374375769121,7,0,4,1,7,1,2,1,1,2,4,3,3,0,Arts,Bachelors,25-30,10,0,0,Office,Tier2_City,5,4,4,2,5,2,4,32.74,Healthcare,5,3,1,2,5,0,1,1,4,4,1,0,4,4,65.38
Psychology,Ecologist,3.1364525249775177,5,1,3,1,1,0,1,3,4,2,2,2,0,0,Arts,Masters,25-30,4,0,0,Remote,Any,1,1,5,4,2,2,3,38.88,Manufacturing,5,4,4,1,3,5,3,2,4,3,1,0,3,5,53.43
Psychology,Animator,3.050677500802707,5,0,3,1,7,1,3,4,1,1,4,3,4,0,Arts,Bachelors,25-30,1,0,0,Flexible,Tier1_City,3,3,0,5,4,1,1,21.82,Tech,4,3,1,3,2,3,5,4,1,2,0,1,1,4,44.46
Marketing,Chemical Engineer,4.089751499234384,8,2,2,0,2,1,0,4,3,3,4,0,0,0,Commerce,Masters,25-30,7,0,0,Hybrid,Any,5,3,3,5,0,4,1,21.83,Healthcare,1,2,5,4,1,1,2,4,2,2,0,1,5,1,53.93
Architecture,Digital Marketing Specialist,2.7086181847286896,9,2,3,1,6,1,4,1,1,2,3,4,3,1,Interdisciplinary,Bachelors,25-30,11,0,0,Office,Tier2_City,1,2,2,5,4,3,1,16.57,Education,5,1,2,5,5,5,2,3,1,3,1,0,5,4,60.76
Law,Lawyer,4.969875892100463,4,0,1,0,2,0,1,4,4,2,3,1,3,0,Arts,Bachelors,18-24,11,0,0,Remote,Tier1_City,3,2,2,5,3,3,5,31.09,Other,1,3,5,5,0,0,3,1,5,3,0,1,2,1,66.24
Marketing,Music Therapist,4.944770273770092,2,0,2,0,5,1,2,1,2,1,4,1,3,1,Commerce,High School,25-30,11,1,52,Office,Tier1_City,4,5,1,5,2,4,3,46.7,Other,3,3,2,2,1,1,1,4,3,3,1,0,4,1,53.2
Medicine,Forensic Psychologist,2.5009241673046816,7,0,0,0,3,1,1,1,4,4,0,0,0,1,Science,Bachelors,18-24,7,0,0,Hybrid,Any,2,3,0,3,0,3,5,46.43,Manufacturing,1,3,5,5,1,0,3,2,2,2,1,1,2,5,43.54
Biology,Surgeon,3.769274446324265,0,2,4,0,7,0,0,1,1,3,0,1,2,0,Science,Bachelors,31-35,0,0,0,Remote,Tier2_City,2,1,0,4,5,0,1,36.04,Education,5,5,1,1,0,1,1,1,4,1,0,0,1,2,33.56
Architecture,Conductor,3.2242337416818945,7,0,3,1,5,0,3,4,3,4,1,2,1,0,Interdisciplinary,Bachelors,18-24,3,0,0,Hybrid,Tier1_City,1,2,3,5,3,3,4,45.59,Tech,2,1,1,3,3,4,3,1,4,3,1,1,1,3,55.11
Chemistry,Biochemist,4.453461443141359,3,2,3,0,6,1,2,2,0,1,4,3,3,0,Science,Bachelors,18-24,13,1,17,Hybrid,Any,3,1,4,4,5,0,1,48.29,Tech,2,5,5,3,4,4,3,4,5,3,0,0,4,5,62.53
Law,Music Therapist,4.784483449078121,0,1,3,1,9,0,2,4,3,2,1,0,0,0,Arts,Bachelors,31-35,8,0,0,Remote,Tier3_City,1,5,3,3,1,4,5,40.37,Tech,5,2,1,2,5,3,3,3,5,4,0,0,1,2,59.26
Engineering,Urban Planner,4.239598931654722,1,2,1,1,2,1,2,2,4,0,1,2,1,1,Science,Bachelors,31-35,4,0,0,Remote,Tier3_City,3,1,5,3,2,3,1,22.17,Healthcare,4,3,1,1,5,0,4,3,2,5,0,0,4,5,48.8
Chemistry,Acoustics Specialist,2.907714540672664,6,0,4,0,9,1,0,0,4,3,2,1,1,1,Science,Bachelors,36-40,11,0,0,Hybrid,Any,3,1,0,4,3,3,1,25.71,Manufacturing,5,1,4,5,4,5,3,3,2,4,1,1,5,5,56.37
Architecture,Art Therapist,2.7371913015427056,6,0,1,1,1,0,4,0,3,1,4,3,0,0,Interdisciplinary,Bachelors,25-30,10,0,0,Hybrid,Tier3_City,2,4,2,1,3,5,5,46.77,Other,5,1,3,1,1,0,2,4,2,1,1,1,1,1,58.24
Law,Urban Planner,4.486932158903226,0,1,0,1,6,0,0,4,4,3,2,1,3,0,Arts,Bachelors,18-24,9,1,58,Hybrid,Tier1_City,4,5,4,2,5,0,5,34.49,Tech,4,1,3,5,3,5,5,5,5,3,0,1,3,2,67.98
Education,Art Director,3.4344974538458706,1,0,3,0,7,0,3,4,3,2,3,0,3,0,Arts,Masters,31-35,12,1,12,Hybrid,Tier2_City,4,2,4,1,0,0,4,41.57,Education,4,3,5,1,3,3,5,2,3,2,1,1,4,3,57.52
Architecture,Art Director,3.528577949694326,1,1,4,0,0,1,0,2,1,0,1,0,2,0,Interdisciplinary,High School,31-35,5,0,0,Remote,Tier3_City,5,4,0,1,1,2,5,8.46,Manufacturing,3,4,3,5,3,5,3,2,1,1,1,1,4,4,24.95
Marketing,Education Administrator,3.001268302422709,3,1,3,0,5,1,2,2,2,2,3,3,1,0,Commerce,Masters,18-24,2,1,25,Remote,Tier1_City,3,3,0,1,5,1,4,12.11,Other,3,4,2,5,3,1,4,3,5,2,1,0,1,1,57.02
Education,Marketing Specialist,3.619464405202741,5,1,0,0,2,1,3,3,2,0,1,1,2,1,Arts,Masters,36-40,4,1,10,Office,Tier1_City,2,3,3,5,3,3,2,19.17,Education,3,4,5,3,1,0,3,3,3,3,0,1,4,5,51.94
Education,Investment Banker,4.88492104572896,4,0,2,0,2,0,2,1,0,1,2,2,3,0,Arts,Bachelors,18-24,13,1,8,Remote,Tier1_City,3,2,1,3,2,5,2,11.85,Education,4,5,5,4,5,3,3,2,5,5,0,0,2,4,62.78
Education,Legal Consultant,2.8123400169455053,5,2,2,0,6,1,3,2,2,0,2,3,3,1,Arts,Masters,40+,11,0,0,Office,Tier1_City,5,5,0,1,3,1,5,45.6,Tech,1,3,2,4,2,3,1,4,1,2,1,0,3,5,58.81
Education,Ecologist,2.881182668771596,8,2,0,1,0,0,3,0,4,0,4,4,2,1,Arts,PhD,36-40,12,0,0,Hybrid,Tier1_City,2,3,0,3,4,5,1,13.19,Manufacturing,5,2,3,2,5,0,2,1,2,4,0,1,2,1,68.48
Marketing,Urban Planner,3.482830605614363,4,2,3,0,5,1,1,2,3,0,3,4,1,1,Commerce,Bachelors,31-35,12,0,0,Flexible,Tier3_City,3,3,3,4,2,1,3,29.19,Finance,3,5,2,4,4,2,1,2,3,4,1,0,3,5,59.56
Psychology,Astronomer,2.6555423694750773,3,2,1,1,4,0,2,1,2,0,4,3,3,0,Arts,Bachelors,36-40,12,0,0,Remote,Tier3_City,4,3,0,2,2,3,1,7.02,Healthcare,1,1,1,2,4,5,5,2,2,2,1,1,5,1,53.02
Medicine,Animator,4.283704902411229,6,1,4,1,3,1,4,2,1,0,2,0,2,1,Science,Masters,31-35,0,0,0,Office,Tier1_City,4,5,5,4,3,5,5,10.28,Finance,5,4,5,3,5,1,4,1,1,4,1,1,5,5,41.88
Computer Science,Architect,4.040699421644401,2,2,1,0,5,1,0,4,4,0,2,2,3,0,Science,Masters,18-24,7,1,38,Hybrid,Tier3_City,5,3,3,4,0,0,4,14.63,Healthcare,1,1,4,2,0,2,1,1,5,1,0,0,1,4,55.28
Medicine,Entrepreneur,3.510900963701431,7,0,2,0,3,1,1,0,1,3,1,0,3,0,Science,Bachelors,25-30,10,1,7,Remote,Tier2_City,4,2,5,5,2,2,1,49.2,Manufacturing,2,5,2,4,1,2,2,5,4,1,0,1,4,1,46.42
Psychology,Mechanical Engineer,4.684152615321764,2,1,4,1,3,1,1,4,1,3,1,1,0,1,Arts,Bachelors,18-24,14,1,41,Remote,Tier1_City,3,2,0,2,4,5,2,40.46,Other,2,4,5,5,4,5,2,2,1,3,0,1,3,2,56.67
Medicine,Landscape Architect,4.502450589831076,0,1,4,0,1,1,1,1,2,3,2,4,3,0,Science,Bachelors,25-30,5,0,0,Hybrid,Tier1_City,5,2,2,4,5,4,5,34.66,Tech,5,3,5,2,1,1,2,1,1,2,0,0,5,4,44.29
Law,Construction Manager,3.999422220999058,3,1,4,1,7,1,0,2,1,0,4,4,1,1,Arts,Bachelors,31-35,11,0,0,Hybrid,Tier1_City,1,4,0,4,0,3,1,46.06,Manufacturing,1,4,2,4,5,4,5,2,3,1,0,1,1,1,48.5
Music,Musician,4.458565436979116,9,1,2,0,8,1,3,3,2,1,2,4,0,0,Arts,Masters,25-30,1,0,0,Hybrid,Tier3_City,5,2,1,2,0,3,1,47.94,Finance,1,4,4,4,1,0,1,1,4,3,0,1,5,1,51.13
Engineering,Financial Controller,2.9813191598179665,7,0,0,1,4,1,2,3,0,1,0,2,3,1,Science,Bachelors,25-30,3,0,0,Flexible,Tier1_City,4,1,4,2,0,4,4,24.32,Education,4,4,5,5,5,5,2,3,3,1,0,1,3,2,34.3
Psychology,Forensic Psychologist,2.7243215743213094,9,2,3,0,6,1,2,3,1,0,1,1,1,1,Arts,Bachelors,25-30,3,1,16,Hybrid,Tier1_City,2,3,3,4,2,1,4,18.4,Healthcare,3,5,1,1,3,3,5,3,3,4,1,1,4,5,42.37
Business,Aerospace Engineer,4.876193359201672,6,2,1,1,9,0,4,4,0,0,3,4,0,0,Commerce,Masters,36-40,8,0,0,Hybrid,Tier1_City,5,2,1,2,0,2,4,17.82,Healthcare,5,4,1,4,0,0,4,3,2,2,0,1,3,3,55.96
Physics,Digital Marketing Specialist,4.312553973018509,4,1,0,1,1,1,3,0,3,2,2,2,3,0,Science,High School,18-24,8,1,52,Office,Any,3,5,5,4,3,1,3,4.68,Finance,1,5,1,3,1,2,3,2,1,3,0,0,2,1,45.76
Computer Science,Accountant,4.111724252615959,6,1,2,1,1,1,1,1,3,4,3,1,4,1,Science,Bachelors,25-30,4,0,0,Office,Tier3_City,5,5,3,4,0,4,5,16.14,Tech,3,1,4,5,5,5,4,2,1,4,0,0,5,4,47.77
Architecture,Actuary,3.728370678120018,1,1,3,0,3,1,3,4,2,4,2,4,3,1,Interdisciplinary,Masters,18-24,11,0,0,Remote,Tier2_City,4,5,1,5,4,4,5,19.69,Manufacturing,5,3,3,1,4,4,1,2,1,1,1,0,5,5,59.68
Law,Legal Analyst,3.901001965688284,3,0,2,0,2,1,3,0,1,2,4,0,3,1,Arts,Masters,31-35,2,0,0,Office,Any,5,4,3,1,1,2,2,4.73,Finance,1,4,1,5,4,4,4,4,4,5,0,1,3,4,56.02
Architecture,Physician Assistant,4.549314291263062,1,1,3,1,9,0,3,1,4,4,3,3,3,1,Interdisciplinary,Bachelors,18-24,0,0,0,Hybrid,Tier1_City,3,5,5,4,4,4,2,44.48,Manufacturing,2,5,2,2,0,0,5,3,2,5,0,0,3,1,53.16
Medicine,Market Research Analyst,2.923834185857303,4,0,2,1,8,1,3,4,0,0,4,4,4,0,Science,Bachelors,31-35,5,0,0,Remote,Tier2_City,3,4,3,3,2,4,5,42.85,Tech,1,4,3,4,1,5,1,1,4,5,1,0,5,2,60.63
Chemistry,Zoologist,3.41783877360496,3,0,0,0,7,0,2,4,4,0,0,1,1,1,Science,Bachelors,25-30,7,0,0,Remote,Tier1_City,4,3,5,1,0,5,1,14.82,Education,2,4,2,4,3,2,2,5,5,3,1,0,1,2,56.55
Biology,Civil Engineer,2.750821690905436,9,2,4,1,5,0,4,2,2,3,0,4,3,0,Science,Bachelors,18-24,0,0,0,Remote,Tier1_City,3,1,4,1,0,2,5,40.72,Manufacturing,2,4,4,5,0,1,5,4,3,2,1,1,3,2,43.16
Architecture,Education Administrator,4.303915262580855,8,0,1,1,1,1,1,2,0,0,1,1,3,0,Interdisciplinary,Bachelors,36-40,10,1,50,Hybrid,Tier3_City,4,5,0,1,3,3,3,40.42,Tech,4,2,1,2,1,3,1,2,3,4,0,0,3,5,46.16
Business,Physicist,2.9046540319589105,3,1,3,0,2,1,3,4,4,1,0,0,4,1,Commerce,Bachelors,18-24,0,1,13,Remote,Tier3_City,5,5,3,5,5,1,2,18.75,Finance,4,3,5,5,0,4,1,3,4,3,1,0,1,2,51.61
Art,Sound Engineer,2.696437445604361,5,0,3,1,9,1,2,4,0,3,3,0,4,1,Arts,Bachelors,25-30,14,1,50,Hybrid,Tier1_City,5,4,3,4,0,3,2,35.76,Other,3,3,1,3,3,3,5,4,4,5,0,1,2,5,58.41
Medicine,Dentist,3.990724520905462,3,1,1,0,2,1,0,0,4,0,4,0,4,0,Science,Bachelors,18-24,10,1,25,Hybrid,Tier1_City,1,4,5,5,4,3,2,16.62,Education,5,5,4,4,2,2,4,3,3,2,1,0,1,1,55.34
Education,Musician,3.2236450603838573,9,2,3,1,9,1,0,2,3,4,4,4,3,1,Arts,High School,25-30,6,1,26,Office,Tier1_City,4,1,4,4,2,5,5,6.3,Education,3,1,1,4,2,0,4,1,2,2,1,0,3,1,50.56
Computer Science,Data Scientist,4.120270335797541,7,1,0,0,8,0,2,2,1,0,1,4,2,0,Science,Bachelors,25-30,6,0,0,Hybrid,Tier3_City,2,2,5,5,1,1,2,26.73,Education,4,1,1,3,2,2,2,5,2,3,1,0,4,3,46.29
Computer Science,Social Media Manager,2.569095581687109,0,2,2,1,4,0,0,2,4,4,2,2,4,1,Science,Bachelors,25-30,1,0,0,Office,Tier1_City,4,4,5,5,0,3,2,23.6,Healthcare,3,1,1,1,3,4,1,4,3,2,0,0,5,4,37.62
Physics,Interior Designer,2.8017737605430453,8,1,1,0,8,1,4,1,3,3,4,3,4,0,Science,Bachelors,18-24,2,0,0,Flexible,Tier2_City,5,1,3,3,1,2,5,9.49,Other,5,4,4,4,3,0,4,5,5,5,1,1,3,1,64.04
Medicine,Aerospace Engineer,4.2122245819270505,1,0,4,0,7,1,3,0,0,3,2,1,4,0,Science,Bachelors,25-30,1,1,10,Flexible,Any,5,3,3,5,0,1,1,26.06,Tech,5,5,1,5,0,3,1,4,4,3,0,0,3,5,41.98
Marketing,Fluid Mechanics Engineer,2.7594616638883416,0,1,2,0,1,1,3,0,4,3,4,1,4,0,Commerce,Masters,31-35,5,0,0,Flexible,Tier1_City,3,5,2,2,2,0,2,47.62,Manufacturing,1,4,5,1,5,4,4,3,1,4,1,1,4,5,53.43
Marketing,Accountant,2.7295760382254706,3,0,0,0,9,1,1,4,3,0,4,4,1,1,Commerce,Masters,31-35,12,0,0,Remote,Any,1,5,2,3,5,5,2,37.38,Finance,3,2,5,1,4,0,5,2,5,3,0,1,4,5,71.19
Education,Nuclear Physicist,3.9261265016561295,5,1,0,0,9,1,0,2,0,2,4,0,4,1,Arts,Masters,25-30,12,1,28,Remote,Tier1_City,2,1,5,5,4,3,2,37.73,Education,4,5,3,5,3,0,5,3,2,1,1,0,2,2,55.07
Computer Science,Astronomer,4.814747867153072,8,0,4,0,3,1,3,0,0,2,0,1,2,1,Science,Masters,25-30,7,0,0,Hybrid,Tier2_City,1,1,2,1,2,4,3,38.6,Education,1,5,3,3,3,3,4,2,1,1,0,1,1,4,39.73
Chemistry,Music Teacher,4.550342823955244,4,1,3,1,3,1,3,2,2,0,0,4,1,1,Science,Bachelors,18-24,7,1,15,Hybrid,Tier3_City,4,5,4,2,1,1,5,38.0,Education,3,5,3,1,2,5,5,2,1,5,1,0,5,3,45.63
Psychology,Market Research Analyst,4.332794574229434,6,0,2,0,2,0,0,1,3,4,2,2,0,1,Arts,Bachelors,25-30,14,1,32,Remote,Tier2_City,4,4,5,2,0,0,2,3.94,Tech,5,2,3,4,2,2,1,2,5,4,1,0,4,4,63.12
Education,Risk Analyst,4.7264678128400055,0,0,3,1,6,0,0,4,0,2,2,4,0,1,Arts,Bachelors,18-24,0,0,0,Remote,Tier1_City,5,2,3,2,1,4,3,46.46,Finance,4,5,5,2,5,5,5,3,5,1,0,1,1,4,36.08
Marketing,Paralegal,2.5097808714477905,9,1,0,0,0,1,0,0,4,4,0,2,4,0,Commerce,Masters,18-24,10,0,0,Flexible,Any,3,3,4,3,4,0,1,42.02,Tech,3,2,3,1,2,5,2,3,4,5,1,0,2,1,62.53
Chemistry,Nurse,3.704566347550201,7,2,2,1,3,0,1,2,3,3,1,4,0,1,Science,Masters,18-24,8,1,14,Hybrid,Tier1_City,2,2,5,5,2,3,1,15.91,Finance,5,1,2,3,4,5,4,5,5,4,0,0,4,2,63.46
Biology,Physician Assistant,3.726022316187425,8,0,3,0,5,1,2,3,2,1,0,2,3,0,Science,Bachelors,25-30,10,0,0,Hybrid,Tier2_City,3,2,4,5,1,4,3,28.98,Manufacturing,5,5,4,5,2,5,2,4,3,1,1,1,1,1,50.04
Psychology,Inorganic Chemist,4.2551806794938365,7,0,4,1,8,1,3,2,1,1,3,3,0,0,Arts,Bachelors,25-30,7,1,36,Remote,Tier1_City,2,2,1,1,1,3,1,31.91,Healthcare,3,4,4,4,2,2,5,2,2,4,1,1,2,2,56.31
Education,Biologist,4.053121036015207,7,2,1,1,7,1,0,1,3,2,1,3,0,1,Arts,Bachelors,36-40,8,1,47,Office,Tier2_City,1,5,0,1,4,4,4,9.2,Finance,3,3,5,2,5,5,4,1,4,2,1,0,5,3,53.34
Chemistry,Composer,3.889601984063591,6,1,0,0,2,0,4,2,4,2,0,1,1,0,Science,Bachelors,18-24,12,0,0,Hybrid,Tier2_City,5,2,1,2,0,1,1,14.94,Other,4,2,4,1,4,2,4,1,4,3,1,1,1,1,59.54
Chemistry,Counselor,3.38371846752211,8,1,3,0,6,1,2,2,4,4,4,2,0,0,Science,Masters,31-35,13,0,0,Remote,Tier2_City,3,4,5,1,1,2,4,4.09,Tech,1,1,4,3,2,4,1,2,3,3,0,0,1,2,69.16
Psychology,Composer,4.4460133010746805,1,1,4,0,6,0,3,0,4,2,4,0,0,0,Arts,Masters,36-40,12,0,0,Flexible,Tier1_City,4,4,5,3,4,2,3,43.61,Tech,5,1,1,2,0,0,1,4,1,5,0,0,4,2,66.02
Marketing,Physicist,3.7629743834630833,0,2,4,0,3,0,0,1,0,3,1,3,4,1,Commerce,Bachelors,25-30,8,0,0,Office,Tier2_City,5,4,5,5,0,0,4,4.17,Tech,1,3,3,2,0,1,5,3,5,4,0,0,2,5,50.71
Architecture,Teacher,4.5661219925917855,3,1,1,0,4,1,3,0,2,1,3,3,3,1,Interdisciplinary,PhD,25-30,10,0,0,Office,Tier1_City,2,1,0,2,5,5,1,17.98,Healthcare,1,5,3,4,1,1,1,5,1,4,1,0,3,1,64.63
Art,Sound Engineer,3.02049245800667,2,2,2,0,6,0,2,4,3,0,2,0,4,1,Arts,Masters,25-30,11,1,58,Flexible,Tier1_City,5,3,1,1,0,4,2,6.68,Finance,5,4,1,4,0,3,1,1,2,2,1,0,4,2,55.55
Marketing,Civil Engineer,4.278023608605247,5,2,0,1,5,1,3,0,0,3,3,2,2,1,Commerce,Bachelors,18-24,5,0,0,Hybrid,Tier2_City,4,4,3,3,5,3,4,39.73,Finance,3,3,5,1,4,0,2,4,2,4,0,1,3,5,49.08
Engineering,Manager,3.544777439112828,3,0,2,1,8,0,2,2,1,4,3,0,0,1,Science,Bachelors,25-30,2,1,54,Office,Tier2_City,4,2,4,3,2,5,1,46.47,Finance,5,5,2,1,2,4,2,3,4,4,1,0,1,5,46.16
Finance,Lawyer,4.11323761143541,5,2,1,1,1,1,2,1,3,1,3,0,0,0,Commerce,Bachelors,31-35,0,0,0,Remote,Tier1_City,2,1,1,1,4,1,2,29.45,Finance,1,5,5,2,1,0,2,2,5,4,1,1,2,5,45.29
Art,Illustrator,4.832419407470128,5,0,2,1,7,0,3,4,3,4,0,1,0,0,Arts,Bachelors,18-24,10,0,0,Office,Tier2_City,5,5,1,5,0,1,3,9.56,Education,4,2,2,3,3,3,5,3,1,2,1,1,3,1,50.5
Art,Lawyer,3.927354759530623,8,1,4,1,0,0,0,1,4,2,3,2,0,0,Arts,Bachelors,18-24,7,0,0,Remote,Tier2_City,3,4,3,1,5,1,3,29.23,Education,5,4,2,2,5,1,4,3,5,2,1,0,1,3,56.96
Art,Web Developer,2.821409317594503,3,0,4,1,8,1,3,0,4,3,1,3,2,0,Arts,Bachelors,31-35,9,1,42,Remote,Tier1_City,5,2,4,2,5,2,5,39.21,Other,4,4,1,3,5,4,3,3,4,2,0,1,1,4,59.84
Art,Lawyer,4.898130412438209,9,0,4,0,3,1,3,0,0,0,4,0,4,0,Arts,Bachelors,31-35,2,0,0,Hybrid,Tier2_City,4,2,0,1,2,3,3,36.77,Tech,3,2,5,4,3,5,5,5,4,4,0,1,3,5,45.66
Architecture,Credit Analyst,3.4820340629522875,5,1,3,1,3,1,3,4,1,4,0,1,4,0,Interdisciplinary,Bachelors,25-30,12,0,0,Remote,Any,2,5,1,3,3,1,5,37.86,Education,3,5,3,3,0,5,4,1,1,4,0,0,2,1,58.05
Chemistry,Risk Analyst,2.6567175913733205,6,1,2,1,4,1,2,3,4,4,3,4,0,1,Science,Masters,31-35,6,1,30,Hybrid,Tier2_City,1,1,0,1,4,1,3,16.12,Finance,4,5,5,3,1,1,1,1,5,3,1,0,5,2,70.73
Law,Advertising Manager,4.258933401733513,9,0,4,0,6,1,1,4,2,1,4,3,0,0,Arts,Bachelors,25-30,12,0,0,Hybrid,Tier3_City,1,2,2,5,3,0,3,6.47,Finance,4,4,5,4,3,2,5,5,3,4,1,0,1,2,65.87
Education,Organic Chemist,3.78061564204541,6,0,4,1,0,1,4,3,0,2,2,1,1,0,Arts,Bachelors,18-24,9,0,0,Hybrid,Tier1_City,5,3,5,4,0,4,3,10.0,Education,5,4,2,5,3,3,4,4,2,5,0,1,5,4,54.87
Finance,Graphic Designer,3.04191825996302,9,0,4,0,3,0,1,3,1,4,0,3,4,1,Commerce,Bachelors,25-30,5,0,0,Remote,Tier3_City,4,4,1,1,4,4,5,47.91,Manufacturing,3,4,2,2,3,1,5,3,2,2,0,1,1,1,47.28
Medicine,Organic Chemist,4.661956909978268,3,2,1,1,5,0,2,0,0,4,3,0,1,1,Science,PhD,25-30,2,1,38,Remote,Tier2_City,5,1,4,5,2,4,5,31.84,Other,4,4,3,1,0,4,1,2,2,4,1,1,5,2,47.09
Education,Principal,2.858811471133502,9,1,4,1,0,1,1,3,3,4,1,4,1,1,Arts,Bachelors,36-40,5,0,0,Hybrid,Tier2_City,2,4,2,5,0,5,4,37.21,Tech,2,5,3,3,0,0,1,5,4,2,1,0,1,4,51.21
Psychology,Biomedical Engineer,4.703831171022582,8,0,4,0,3,1,0,4,0,2,3,1,3,1,Arts,Bachelors,18-24,11,0,0,Office,Any,3,4,2,3,4,0,1,45.26,Healthcare,5,4,2,1,1,3,5,3,3,2,0,1,5,5,51.56
Physics,Art Director,4.659672860085589,1,0,0,0,1,1,0,1,4,2,2,2,0,1,Science,PhD,25-30,2,0,0,Remote,Tier1_City,1,5,1,5,4,2,1,43.08,Other,5,5,5,1,0,1,5,3,4,5,1,0,1,4,56.35
Computer Science,Risk Analyst,3.1367621902393217,9,1,3,0,2,1,2,3,1,1,4,1,1,0,Science,Masters,25-30,12,1,30,Hybrid,Tier1_City,5,3,1,5,3,5,1,13.26,Tech,2,2,2,2,0,2,3,1,1,2,1,0,2,3,52.65
Marketing,Financial Controller,4.383883899093736,1,2,3,0,0,0,4,0,1,1,3,2,2,0,Commerce,Masters,25-30,14,0,0,Office,Tier1_City,4,3,5,5,0,0,3,5.73,Tech,3,1,4,5,4,1,2,5,5,2,1,1,3,5,60.91
Business,Manager,3.636539389424093,7,1,1,0,2,1,1,3,2,0,3,3,1,1,Commerce,Bachelors,18-24,12,0,0,Remote,Tier3_City,1,5,2,5,2,1,1,46.48,Tech,4,2,4,5,0,5,4,2,5,2,1,0,1,2,58.06
Chemistry,Civil Engineer,3.0094383402361906,7,0,1,1,5,0,2,4,1,4,4,1,3,1,Science,Bachelors,25-30,13,0,0,Hybrid,Tier3_City,1,4,1,2,2,3,5,49.14,Other,4,2,2,5,1,4,1,5,5,3,1,1,1,4,70.05
Business,Art Therapist,2.6128711760718266,3,1,3,0,9,0,1,4,4,4,4,3,3,1,Commerce,Masters,36-40,8,0,0,Hybrid,Tier2_City,3,3,5,2,0,5,4,29.67,Other,3,3,3,5,0,2,1,2,5,3,1,0,2,1,75.8
Finance,Aerospace Engineer,4.303222827160549,3,2,4,1,5,0,2,2,0,2,0,0,0,0,Commerce,PhD,25-30,12,1,57,Flexible,Tier1_City,5,4,4,3,0,5,2,44.75,Education,2,2,2,4,5,5,4,3,4,4,0,0,5,1,57.17
Computer Science,Game Developer,2.935429510861595,6,2,2,0,8,0,3,3,1,4,0,2,2,0,Science,Masters,25-30,0,0,0,Remote,Tier2_City,3,1,4,1,5,1,4,13.9,Tech,2,3,5,1,5,2,5,2,5,3,0,1,1,2,52.47
Music,Human Resources Specialist,3.036155359514432,8,0,4,1,9,0,1,0,3,0,2,4,1,0,Arts,Masters,25-30,12,1,53,Hybrid,Tier1_City,4,5,2,5,1,1,1,8.22,Finance,2,3,4,1,0,3,3,3,1,4,1,0,4,5,53.39
Law,Physicist,2.63553675788436,3,2,2,0,4,0,1,3,4,0,3,2,2,1,Arts,Bachelors,25-30,7,1,56,Flexible,Tier1_City,4,5,1,1,3,3,1,26.49,Tech,5,3,1,4,4,4,4,2,3,3,0,0,5,4,53.71
Medicine,Digital Marketing Specialist,3.756079027909154,2,1,2,1,0,1,4,2,3,4,1,0,3,1,Science,Masters,25-30,4,1,35,Hybrid,Tier1_City,5,3,5,1,0,4,5,41.13,Finance,4,2,3,2,5,4,5,1,4,5,1,1,3,3,60.93
Biology,Fluid Mechanics Engineer,3.5646846759650312,6,1,4,0,8,1,2,0,3,0,1,4,3,1,Science,Bachelors,36-40,14,0,0,Hybrid,Tier2_City,1,1,5,3,0,5,4,33.77,Education,1,1,1,3,1,2,1,5,1,2,0,1,3,5,49.27
Biology,Organic Chemist,4.949076154311455,0,2,0,0,7,1,3,3,4,4,4,3,4,0,Science,Bachelors,40+,3,1,51,Remote,Tier2_City,2,4,2,5,1,0,5,32.95,Education,5,3,3,5,5,0,5,1,1,5,0,1,1,3,63.17
Finance,Psychologist,3.602737814241679,6,0,1,1,9,1,2,2,4,2,2,1,4,1,Commerce,Bachelors,25-30,0,0,0,Flexible,Tier1_City,3,3,4,5,1,2,5,3.82,Tech,5,4,1,5,3,0,2,4,2,4,0,1,2,4,43.97
Engineering,Biotechnologist,2.7521199937096466,4,2,3,0,2,1,1,3,1,4,2,3,1,0,Science,Bachelors,25-30,8,1,39,Office,Tier2_City,1,4,1,4,4,1,2,17.92,Other,4,4,1,4,4,3,3,5,3,4,0,1,5,1,58.47
Music,Psychologist,4.470734888060257,7,0,4,1,0,1,4,3,4,2,4,2,0,1,Arts,Bachelors,36-40,12,0,0,Hybrid,Any,4,1,5,1,2,1,5,47.16,Finance,3,5,2,5,0,3,2,5,2,1,0,1,3,1,63.14
Education,Judge,4.867952896202841,4,1,0,1,6,0,0,0,3,3,4,4,0,1,Arts,Bachelors,25-30,8,1,15,Remote,Tier1_City,4,2,4,1,3,2,5,9.31,Finance,4,4,3,4,2,3,2,2,5,3,0,1,3,1,64.34
Computer Science,Inorganic Chemist,4.880684360421215,3,0,0,0,5,0,2,1,1,0,0,2,3,1,Science,Masters,25-30,12,0,0,Remote,Tier2_City,1,3,5,2,4,0,2,37.14,Finance,3,4,4,3,4,3,5,3,1,3,0,0,1,1,49.87
Art,Legal Consultant,3.464832613516851,7,0,2,0,3,1,3,4,1,3,4,1,1,0,Arts,Bachelors,18-24,4,1,38,Hybrid,Tier2_City,1,3,1,4,0,1,3,38.69,Finance,4,3,1,1,4,2,5,2,2,5,1,1,1,2,54.34
Marketing,Analytical Chemist,3.104755037254735,8,0,2,0,4,1,4,3,0,4,1,4,1,1,Commerce,Masters,31-35,13,1,22,Remote,Any,4,5,3,2,1,2,3,37.44,Healthcare,5,2,2,5,1,3,4,5,1,3,0,0,3,5,59.45
Art,Landscape Architect,2.985643285764896,3,0,1,0,9,0,2,2,4,4,0,0,4,1,Arts,Bachelors,25-30,10,1,16,Hybrid,Tier2_City,3,2,4,2,5,1,2,49.5,Education,2,4,5,2,3,5,1,1,5,5,1,1,4,4,69.77
Architecture,Forensic Psychologist,3.533396779719322,8,0,1,0,1,0,4,4,1,3,0,0,3,1,Interdisciplinary,Bachelors,36-40,8,1,12,Hybrid,Tier2_City,3,3,0,2,2,4,5,22.23,Finance,5,2,3,4,3,0,3,3,5,3,0,1,4,5,61.33
Law,Judge,4.387866791836164,8,2,1,0,1,0,4,1,2,4,4,1,2,1,Arts,Bachelors,31-35,14,0,0,Office,Tier3_City,1,4,5,3,4,4,1,35.06,Healthcare,5,1,3,3,3,1,2,2,3,2,0,0,2,2,65.37
Finance,Graphic Designer,3.635564013342996,2,2,3,1,1,1,0,2,3,1,1,3,3,1,Commerce,Bachelors,18-24,9,0,0,Remote,Tier1_City,5,1,5,3,5,1,4,12.1,Healthcare,1,4,4,2,4,5,5,1,5,4,1,0,2,1,60.21
Architecture,Doctor,4.136443212245553,3,2,0,1,9,0,1,0,2,0,0,1,3,1,Interdisciplinary,Bachelors,31-35,13,1,22,Hybrid,Tier2_City,4,2,1,2,2,1,1,21.79,Education,5,1,1,1,2,5,1,2,3,3,1,0,2,5,42.9
Medicine,Analytical Chemist,3.863452635610951,0,2,0,1,0,1,2,4,2,2,2,4,4,1,Science,Bachelors,36-40,8,0,0,Office,Tier2_City,2,5,3,4,5,4,1,26.1,Manufacturing,5,1,2,2,1,0,4,5,5,2,1,1,1,2,65.73
Finance,Artist,2.5782288019687885,7,0,2,0,9,1,1,1,4,2,1,2,2,1,Commerce,Bachelors,25-30,6,0,0,Hybrid,Tier2_City,4,5,3,1,1,1,5,13.1,Tech,5,5,1,4,2,3,5,2,5,1,1,1,2,4,50.88
Psychology,Legal Consultant,4.014995045627999,9,0,1,1,2,1,3,1,2,2,1,0,2,0,Arts,PhD,18-24,7,0,0,Office,Tier1_City,3,4,3,4,4,0,4,45.62,Education,1,2,2,5,3,2,4,1,3,1,0,0,3,5,57.84
Medicine,Architect,4.845220246281717,3,2,0,1,8,0,3,4,4,2,0,2,4,0,Science,Bachelors,18-24,0,0,0,Remote,Tier1_City,3,1,4,5,4,0,4,36.66,Manufacturing,3,2,4,1,4,4,5,1,2,5,1,1,2,3,50.02
Art,Advertising Manager,3.2939186821712845,8,1,1,0,9,1,4,1,4,0,0,3,4,1,Arts,Masters,25-30,3,0,0,Office,Tier1_City,2,5,5,3,2,3,3,16.34,Other,1,5,1,4,3,1,3,1,4,2,1,1,3,5,54.25
Engineering,Landscape Architect,3.8781593196612856,9,1,4,1,7,0,2,2,4,4,4,4,4,1,Science,Bachelors,25-30,9,0,0,Flexible,Tier3_City,3,5,0,1,5,0,2,9.34,Tech,2,3,5,3,2,1,2,2,2,1,1,1,1,2,64.18
Biology,Social Media Manager,2.864957093811437,9,1,3,0,1,0,1,4,4,4,3,1,3,1,Science,Masters,25-30,9,0,0,Hybrid,Any,2,1,3,1,1,5,5,16.53,Tech,3,5,4,2,3,5,4,5,5,5,0,1,1,3,75.07
Architecture,Architect,4.409610320509218,1,0,3,0,3,1,0,2,1,4,1,4,0,1,Interdisciplinary,Masters,18-24,14,0,0,Hybrid,Tier1_City,3,2,5,5,0,5,4,32.28,Tech,1,5,4,2,0,3,4,4,1,5,1,0,4,1,54.85
Biology,Fluid Mechanics Engineer,4.982905664661132,8,0,0,0,6,1,1,4,2,0,4,3,4,1,Science,Masters,36-40,3,0,0,Remote,Tier1_City,2,3,2,5,4,5,5,41.84,Healthcare,2,5,3,1,1,3,4,4,4,1,1,1,3,3,52.91
Computer Science,Counselor,2.8884603739481536,6,0,1,0,6,0,1,4,2,3,0,4,0,1,Science,Bachelors,25-30,11,0,0,Hybrid,Any,5,3,1,2,0,1,3,26.65,Finance,2,1,2,1,2,1,5,4,5,1,0,0,4,1,52.01
Computer Science,Pharmacist,3.790845918101419,8,0,2,1,6,0,4,4,2,1,0,4,1,1,Science,Bachelors,18-24,8,0,0,Hybrid,Tier2_City,4,1,1,3,1,1,1,7.82,Tech,4,2,1,3,0,5,4,3,3,3,1,0,5,1,55.96
Architecture,Biomedical Engineer,4.442196225629857,2,2,1,1,7,1,0,3,2,1,4,2,1,0,Interdisciplinary,Bachelors,25-30,2,0,0,Remote,Any,3,1,5,3,4,2,4,14.72,Finance,4,3,2,3,3,2,5,5,1,4,1,1,5,1,44.66
Marketing,Curriculum Developer,2.5343970328412087,1,0,1,0,8,0,2,1,0,3,0,4,3,0,Commerce,PhD,25-30,14,1,46,Office,Tier1_City,1,1,0,4,4,5,3,19.22,Tech,5,4,4,1,1,1,5,5,4,1,0,0,3,2,58.66
Biology,Physician Assistant,3.757958831044723,0,0,3,0,9,1,2,4,3,4,1,4,2,0,Science,Masters,18-24,11,0,0,Office,Tier3_City,2,4,5,2,5,5,5,32.9,Healthcare,3,4,1,4,1,5,3,3,4,3,1,1,4,5,71.7
Medicine,Nurse,3.835051109231777,4,1,0,1,2,0,4,4,4,0,0,4,4,1,Science,PhD,25-30,9,1,28,Flexible,Tier3_City,2,4,0,2,0,0,3,14.59,Other,1,4,5,4,1,2,5,4,4,5,0,1,1,1,73.21
Chemistry,Counselor,2.689826828767468,4,0,1,1,9,0,4,4,0,1,0,0,0,1,Science,Bachelors,18-24,14,1,38,Hybrid,Tier1_City,2,1,4,2,5,4,3,13.99,Tech,5,3,2,1,4,0,1,4,1,5,1,1,1,2,52.29
Finance,Entrepreneur,4.400509522023073,7,0,2,1,7,1,0,2,3,3,0,4,3,0,Commerce,Masters,31-35,9,0,0,Hybrid,Tier1_City,3,4,2,2,3,4,3,16.45,Education,3,4,2,2,1,3,4,3,1,2,1,0,3,5,51.77
Engineering,Market Research Analyst,4.219835936088578,2,0,2,1,5,0,3,4,2,2,3,3,0,0,Science,PhD,31-35,0,0,0,Flexible,Tier1_City,4,3,1,3,0,3,3,30.85,Manufacturing,4,3,5,5,0,5,2,1,3,2,1,0,1,1,55.96
Engineering,Construction Manager,2.9880288247970226,3,1,4,0,6,0,1,1,4,4,4,3,0,0,Science,Bachelors,25-30,14,0,0,Hybrid,Tier1_City,1,1,3,3,0,2,3,26.15,Tech,1,4,4,3,2,2,4,5,1,3,0,1,4,1,56.41
Chemistry,Marketing Specialist,4.733839774683025,8,1,1,0,9,1,4,2,1,3,3,1,1,1,Science,Bachelors,31-35,10,0,0,Office,Any,2,3,3,2,3,4,3,42.56,Manufacturing,2,4,2,4,0,1,1,4,1,1,1,0,4,1,55.43
Biology,Teacher,4.398110353486562,7,2,3,0,2,1,2,1,2,1,1,2,1,1,Science,Masters,31-35,4,0,0,Hybrid,Tier1_City,2,3,1,4,1,3,2,35.8,Manufacturing,2,3,3,5,3,0,5,4,2,5,0,1,2,3,49.73
Business,Game Developer,3.2887237666599303,7,2,3,1,7,1,1,2,3,2,0,2,2,1,Commerce,Masters,18-24,6,0,0,Hybrid,Tier3_City,2,4,2,1,1,0,5,34.34,Healthcare,5,2,3,2,4,1,3,3,3,5,0,1,2,2,52.26
Law,Human Resources Specialist,2.7060964430136263,5,1,0,0,1,1,1,1,1,3,2,1,3,0,Arts,Masters,40+,11,0,0,Remote,Tier3_City,2,5,2,1,4,2,1,10.27,Other,5,3,1,3,4,5,5,2,3,2,0,1,1,1,55.58
Engineering,Artist,4.165745628291949,3,2,2,1,9,1,2,2,2,4,2,0,1,1,Science,Bachelors,36-40,3,0,0,Remote,Tier1_City,1,5,5,4,2,2,5,5.6,Manufacturing,1,3,5,4,3,0,3,5,4,3,1,1,2,4,51.64
Law,Risk Analyst,2.796956186563227,4,2,3,1,7,1,2,4,4,2,3,3,1,0,Arts,Masters,18-24,8,1,52,Hybrid,Tier2_City,2,2,3,2,5,5,4,26.97,Healthcare,2,5,4,4,2,4,2,5,5,1,0,1,2,5,67.9
Psychology,Education Administrator,3.832949726387216,7,0,4,0,5,0,2,2,1,2,0,3,0,1,Arts,Bachelors,18-24,5,0,0,Hybrid,Tier1_City,1,2,1,3,2,1,4,6.37,Other,5,1,3,2,4,0,4,5,4,1,0,0,3,1,43.2
Chemistry,Inorganic Chemist,2.854123077070265,4,2,2,0,2,1,0,2,4,0,1,1,3,0,Science,Bachelors,18-24,5,1,35,Office,Tier1_City,1,5,3,1,4,5,5,20.11,Tech,2,1,1,2,3,5,5,1,3,2,0,1,5,4,44.49
Computer Science,Advertising Manager,3.666864719299365,7,1,3,0,7,1,3,0,2,4,2,4,0,1,Science,Bachelors,18-24,2,0,0,Hybrid,Any,2,1,4,5,2,0,3,4.23,Finance,4,2,1,4,3,2,3,2,3,1,1,1,1,5,46.91
Business,Game Developer,3.651754391547588,0,1,4,0,4,0,4,3,1,1,4,4,0,1,Commerce,Masters,31-35,9,0,0,Remote,Tier1_City,5,5,1,5,0,5,2,11.31,Healthcare,5,2,2,4,3,4,3,5,5,3,0,1,2,1,69.96
Engineering,Marketing Manager,3.343821993602308,6,0,0,1,2,0,4,1,2,3,1,3,3,1,Science,Masters,25-30,9,0,0,Hybrid,Tier1_City,1,4,2,4,0,2,1,8.19,Manufacturing,3,2,4,5,3,5,1,1,5,5,1,1,5,1,70.9
Education,Legal Consultant,4.85358232486526,3,0,0,0,6,0,3,0,3,1,4,0,3,1,Arts,Bachelors,31-35,4,1,36,Remote,Tier3_City,5,5,3,2,3,5,3,40.65,Manufacturing,5,1,3,2,1,0,1,1,5,2,1,0,3,5,49.54
Finance,Aerospace Engineer,3.82627159871217,0,2,1,0,3,1,3,4,0,1,0,1,3,1,Commerce,Bachelors,31-35,9,0,0,Remote,Tier2_City,1,1,0,1,3,3,5,19.27,Tech,4,2,5,2,2,0,4,1,5,1,1,0,5,1,50.05
Architecture,Composer,3.0789572605430537,9,1,3,1,7,1,3,3,3,3,2,3,4,1,Interdisciplinary,Masters,31-35,5,0,0,Remote,Tier2_City,3,1,0,2,4,5,5,6.71,Healthcare,1,2,2,5,5,2,3,5,4,5,1,1,1,4,69.66
Engineering,Marketing Manager,2.5398021705663734,3,1,0,0,8,0,2,2,3,1,0,0,0,0,Science,Bachelors,31-35,13,1,48,Hybrid,Any,2,2,4,1,4,4,2,15.48,Tech,2,3,3,2,3,3,2,5,1,4,1,1,2,5,51.06
Architecture,Landscape Architect,4.692305352104069,8,1,3,0,2,1,2,3,0,3,3,1,2,1,Interdisciplinary,Masters,18-24,3,0,0,Remote,Tier1_City,3,2,0,4,4,0,2,35.09,Healthcare,1,3,1,1,1,3,3,3,4,2,0,0,2,2,52.14
Engineering,AI Researcher,4.319921760150759,6,0,3,0,0,1,2,4,0,0,0,0,1,1,Science,Bachelors,25-30,12,0,0,Remote,Tier3_City,1,1,4,4,0,0,5,38.04,Finance,5,1,5,3,1,5,3,3,5,2,0,1,3,1,47.67
Architecture,School Counselor,3.811125861008252,6,0,1,0,9,1,2,4,1,2,4,2,1,1,Interdisciplinary,Bachelors,31-35,2,1,24,Office,Any,3,3,4,5,2,2,3,8.63,Education,3,3,1,1,0,5,5,2,4,4,0,0,5,4,50.6
Music,Pharmacist,2.8719530077638966,7,1,0,1,3,1,1,2,0,1,0,2,3,1,Arts,Bachelors,18-24,4,1,29,Remote,Tier1_City,2,2,2,2,5,5,3,39.59,Tech,1,2,2,2,5,3,5,3,4,3,0,1,4,5,43.48
Business,Chemical Engineer,4.900558894379435,1,2,3,0,5,0,4,1,3,1,2,3,2,0,Commerce,Bachelors,18-24,6,0,0,Remote,Tier2_City,2,4,2,5,4,2,3,20.42,Manufacturing,3,3,5,5,3,4,1,5,4,2,0,1,2,2,56.94
Finance,Artist,4.101965615016599,4,0,4,1,6,0,4,3,1,1,3,2,2,1,Commerce,Masters,36-40,10,0,0,Flexible,Tier1_City,1,3,1,2,4,2,1,34.93,Tech,5,5,5,4,1,5,5,3,5,5,0,0,4,4,77.44
Physics,Human Resources Specialist,2.759852886544434,7,0,3,0,1,1,4,0,0,1,0,0,4,0,Science,Bachelors,31-35,5,1,58,Hybrid,Tier1_City,1,4,3,5,0,3,1,34.56,Healthcare,3,3,2,2,5,3,3,2,5,5,1,1,4,4,46.46
Business,Microbiologist,3.3216359300604825,9,2,4,0,6,1,3,3,1,2,3,3,4,0,Commerce,Bachelors,25-30,1,1,53,Remote,Tier2_City,5,4,5,3,5,1,3,40.3,Tech,3,1,1,4,0,4,5,5,5,2,1,1,2,3,52.77
Law,Acoustics Specialist,2.615767922294603,2,1,3,0,1,0,2,2,3,3,1,2,1,1,Arts,Masters,31-35,0,0,0,Remote,Tier2_City,4,1,0,3,0,2,5,35.77,Finance,4,2,5,3,0,3,1,4,2,3,1,0,4,2,41.25
Finance,Doctor,3.1756426979517665,5,0,0,1,4,1,3,0,4,2,0,4,4,1,Commerce,Bachelors,31-35,4,1,14,Hybrid,Any,3,3,3,3,5,1,2,4.83,Healthcare,1,2,4,1,3,2,4,4,1,4,0,1,5,5,49.5
Marketing,Dentist,2.728315205594253,7,1,2,1,7,1,2,2,0,0,3,0,2,0,Commerce,Bachelors,25-30,4,0,0,Hybrid,Tier2_City,5,2,3,3,0,1,4,27.42,Other,5,1,4,3,4,4,2,4,3,2,1,0,2,5,40.09
Psychology,Surgeon,4.347600817127862,2,2,4,1,8,1,0,2,4,4,1,1,1,1,Arts,PhD,18-24,11,0,0,Remote,Any,3,1,4,1,2,0,2,10.81,Manufacturing,4,3,1,4,1,3,3,2,2,2,1,0,4,1,63.33
Psychology,Risk Analyst,4.446076730775079,6,0,0,1,0,0,4,0,2,3,4,0,2,1,Arts,Masters,36-40,11,0,0,Remote,Tier1_City,2,5,0,3,4,4,2,48.59,Manufacturing,3,2,5,3,4,1,2,2,2,3,0,1,1,1,61.13
Engineering,Biochemist,3.0581658068122164,9,0,4,0,6,0,4,0,3,2,4,0,4,0,Science,Bachelors,25-30,5,0,0,Flexible,Tier1_City,1,2,2,4,1,4,4,15.02,Healthcare,4,2,1,4,0,3,4,5,2,3,1,0,1,5,49.5
Psychology,Artist,2.546127645843318,1,1,3,1,4,1,1,2,1,0,4,3,1,0,Arts,PhD,18-24,2,0,0,Hybrid,Any,3,5,3,4,1,5,3,22.75,Other,4,5,4,1,4,1,3,4,2,5,0,0,1,5,51.37
Engineering,Psychologist,4.784708877681717,5,2,3,0,2,0,3,2,2,1,3,4,3,0,Science,Masters,25-30,0,0,0,Hybrid,Any,4,1,4,1,4,3,2,12.25,Finance,3,1,5,4,4,1,2,1,4,3,0,0,5,2,55.59
Architecture,Aerospace Engineer,2.7406679522670085,1,0,0,0,0,0,1,3,1,1,1,3,1,0,Interdisciplinary,Bachelors,31-35,14,0,0,Remote,Tier1_City,2,4,2,3,4,3,4,9.33,Tech,5,3,5,1,3,0,4,3,2,5,0,1,5,5,53.42
Business,Pharmacist,4.394372416719255,2,0,4,0,0,1,0,0,3,2,3,2,2,0,Commerce,Bachelors,18-24,3,0,0,Remote,Tier2_City,2,4,4,3,4,4,5,31.24,Education,2,3,1,2,0,5,3,4,1,2,0,0,4,4,41.2
Education,Sound Engineer,3.396519030124625,0,2,1,1,6,0,2,2,2,1,1,1,3,0,Arts,Masters,25-30,3,0,0,Hybrid,Tier1_City,5,3,3,3,4,5,5,26.18,Manufacturing,4,2,5,4,2,3,4,4,5,3,1,0,4,4,55.88
Law,Marketing Manager,3.5179042676286483,5,1,0,1,0,1,1,2,3,1,2,2,3,0,Arts,Masters,18-24,9,1,20,Flexible,Tier2_City,4,2,5,5,5,4,5,20.61,Finance,1,4,1,3,1,0,3,4,3,3,0,1,3,4,60.33
Architecture,Pharmacist,2.5456323940296723,7,2,0,0,3,0,4,2,3,3,1,0,2,1,Interdisciplinary,Bachelors,40+,1,1,8,Remote,Any,2,5,3,2,2,5,3,7.01,Finance,3,5,3,5,3,0,3,4,1,4,1,0,4,3,46.15
Business,Art Director,3.717840821273768,8,2,1,1,4,1,2,2,2,0,1,4,0,1,Commerce,Masters,18-24,13,0,0,Flexible,Tier3_City,4,5,3,5,1,5,2,37.59,Finance,2,5,3,3,3,4,4,5,2,5,1,0,2,2,59.21
Computer Science,Biomedical Engineer,2.77996215677878,8,0,0,1,1,0,3,2,1,1,2,4,0,0,Science,Masters,25-30,7,1,33,Remote,Tier1_City,1,3,0,2,3,5,2,3.28,Tech,4,5,4,5,2,1,1,3,5,5,1,0,2,5,66.74
Architecture,Social Media Manager,2.5133521774574747,0,0,1,0,7,0,4,3,2,2,3,1,0,1,Interdisciplinary,Bachelors,36-40,5,0,0,Hybrid,Tier1_City,4,2,0,3,1,5,1,24.51,Finance,3,2,4,3,3,0,2,4,2,3,0,1,5,1,53.89
Psychology,Illustrator,3.047350391087656,8,1,1,0,6,1,0,4,1,4,4,0,3,1,Arts,Bachelors,18-24,11,0,0,Remote,Tier1_City,5,4,5,3,1,0,5,32.73,Finance,3,1,2,4,0,3,1,5,3,2,0,1,5,3,55.36
Biology,Graphic Designer,2.784161090546929,4,1,0,0,4,0,2,3,4,3,2,0,2,1,Science,Bachelors,40+,2,1,30,Hybrid,Tier3_City,5,1,3,5,0,0,3,23.24,Healthcare,4,1,3,2,3,2,5,4,2,3,0,0,5,2,40.5
Law,Composer,4.276524351489596,2,2,4,0,0,1,1,2,1,4,3,3,2,0,Arts,Masters,36-40,14,0,0,Hybrid,Tier2_City,3,3,0,5,4,4,4,8.93,Healthcare,1,5,3,4,3,3,2,1,4,5,1,1,5,1,70.77
Computer Science,Counselor,3.3714029259199583,2,2,1,0,2,1,3,0,2,3,3,3,1,1,Science,High School,36-40,0,0,0,Office,Any,1,1,4,2,4,5,3,39.58,Finance,3,4,2,1,2,1,3,5,4,4,0,1,1,4,44.96
Art,Art Director,4.78957004407228,2,2,4,0,6,1,0,4,2,4,0,3,3,0,Arts,Masters,18-24,11,0,0,Hybrid,Tier3_City,1,1,4,4,4,2,2,18.23,Finance,3,4,1,2,1,4,2,1,2,5,1,1,1,3,61.35
Medicine,Interior Designer,3.0891601830226305,5,0,4,0,4,0,3,4,1,0,3,1,0,0,Science,Masters,31-35,10,0,0,Hybrid,Tier1_City,4,3,5,2,0,5,5,9.33,Healthcare,4,3,3,4,5,3,2,4,5,2,0,0,4,2,63.58
Law,Nurse,3.8163197025456994,0,2,0,1,2,1,3,1,1,1,2,0,2,1,Arts,Masters,31-35,2,0,0,Office,Tier3_City,5,5,5,5,2,2,1,28.86,Tech,2,4,3,2,1,3,5,3,3,2,0,1,1,4,38.81
Medicine,Investment Banker,2.5438455951956604,0,0,3,0,1,0,2,1,4,4,1,3,0,0,Science,Bachelors,40+,7,1,30,Remote,Tier2_City,5,2,1,5,2,0,3,3.9,Healthcare,3,5,4,1,4,5,1,5,2,4,0,1,3,2,56.87
Engineering,Geneticist,3.813945085061188,5,1,4,1,0,0,4,4,2,0,2,3,4,1,Science,Masters,18-24,3,0,0,Hybrid,Tier1_City,5,5,2,1,3,5,1,18.23,Healthcare,3,3,2,5,0,0,3,1,3,2,0,0,1,1,56.48
Finance,Architectural Technologist,3.409742755350331,8,2,4,0,4,0,4,0,1,1,3,4,1,1,Commerce,Bachelors,31-35,2,1,44,Remote,Tier1_City,1,4,4,5,2,1,2,38.28,Healthcare,4,5,2,2,2,5,2,1,2,2,0,0,5,4,43.84
Music,Curriculum Developer,3.864506167833811,2,2,0,1,4,0,3,0,0,0,4,0,0,0,Arts,Masters,25-30,12,1,16,Hybrid,Any,5,2,2,1,2,4,4,45.9,Healthcare,3,1,4,2,1,3,1,3,3,1,1,0,4,5,51.0
Architecture,Doctor,2.815118111603676,6,2,1,0,0,1,3,0,1,2,1,2,4,0,Interdisciplinary,Bachelors,18-24,10,0,0,Office,Tier2_City,3,3,1,4,4,5,3,30.81,Education,4,5,3,1,2,1,5,5,2,5,0,0,2,5,56.41
Engineering,Artist,4.274628221453069,2,0,4,0,7,0,1,4,0,3,1,0,4,1,Science,Bachelors,25-30,3,0,0,Remote,Tier3_City,2,3,1,2,5,3,2,13.23,Manufacturing,1,3,5,4,5,2,1,2,4,2,1,1,3,5,44.59
Physics,Aerospace Engineer,3.2978725179328494,1,2,3,0,9,1,4,0,3,1,0,1,1,1,Science,Masters,31-35,10,0,0,Flexible,Tier2_City,5,3,5,2,1,2,5,13.34,Tech,4,5,2,5,4,0,5,1,2,1,1,0,3,4,52.98
Education,Legal Secretary,3.048666665888166,7,2,0,1,2,0,3,2,4,0,0,1,0,0,Arts,Bachelors,25-30,14,0,0,Flexible,Tier1_City,3,1,2,1,2,5,3,31.38,Other,2,2,3,2,1,3,2,5,4,5,0,0,2,2,59.21
Marketing,Biologist,3.986317204732825,2,0,4,1,4,0,0,1,1,4,3,4,3,1,Commerce,Bachelors,25-30,3,0,0,Hybrid,Tier3_City,3,3,3,2,2,1,1,22.12,Tech,3,3,1,2,2,2,3,2,5,1,0,0,2,5,47.24
Psychology,Financial Controller,4.623242799605808,7,2,0,0,3,1,3,1,4,0,0,2,0,1,Arts,Masters,40+,1,1,26,Remote,Tier3_City,2,4,2,5,0,2,3,11.33,Finance,1,4,2,2,5,3,1,5,2,1,0,1,5,5,35.03
Business,Construction Manager,3.850798148652397,7,2,2,1,2,1,2,2,1,3,2,0,4,0,Commerce,Masters,25-30,3,1,50,Office,Tier1_City,1,4,4,3,3,1,2,40.01,Education,3,1,4,2,0,4,5,4,3,3,0,0,1,3,46.34
Finance,Music Therapist,4.301729675603273,9,0,4,1,1,1,1,4,3,2,2,1,0,1,Commerce,Masters,31-35,10,0,0,Flexible,Tier1_City,5,3,2,1,5,4,2,12.41,Finance,3,4,2,1,0,1,3,1,5,4,1,1,1,4,70.97
Art,Nurse,4.172398392396939,4,1,1,1,9,0,4,2,4,4,3,2,4,0,Arts,Masters,25-30,11,0,0,Remote,Tier2_City,3,2,4,2,0,4,1,18.12,Tech,4,5,4,2,4,4,2,2,4,1,1,1,3,3,64.66
Education,Microbiologist,4.67385770681943,0,2,0,1,9,0,1,3,2,0,1,4,3,0,Arts,Bachelors,25-30,8,0,0,Flexible,Tier1_City,3,4,4,1,4,4,2,5.89,Tech,3,4,1,5,1,0,1,3,5,2,1,0,1,1,57.31
Physics,Legal Analyst,3.114591680279833,1,2,0,1,1,1,4,2,2,1,3,1,3,0,Science,Bachelors,31-35,3,0,0,Flexible,Tier3_City,2,2,4,1,1,0,3,35.96,Other,1,3,3,1,1,2,4,3,2,4,0,0,1,3,46.44
Music,Manager,4.113289061977318,6,0,4,0,7,1,1,2,3,0,0,4,4,0,Arts,Bachelors,36-40,11,1,52,Hybrid,Tier1_City,3,2,3,3,3,1,1,15.94,Other,5,2,4,2,0,4,3,4,1,1,0,1,2,4,43.47
Business,Physician Assistant,3.4589564664566854,1,1,0,1,2,1,3,1,4,3,3,0,1,1,Commerce,Bachelors,25-30,0,1,24,Office,Tier3_City,5,2,3,5,0,5,2,13.94,Finance,3,4,4,5,5,3,1,4,2,2,0,0,2,3,42.84
Finance,Education Administrator,4.973333098811585,2,2,4,0,9,1,3,1,0,4,2,1,4,1,Commerce,PhD,31-35,0,0,0,Hybrid,Tier2_City,1,3,1,1,2,3,2,17.26,Manufacturing,4,5,1,3,4,4,5,2,4,2,1,1,2,5,47.08
Architecture,Market Research Analyst,3.3682658865508426,7,0,0,0,1,0,0,3,3,1,2,0,3,0,Interdisciplinary,Masters,18-24,0,0,0,Hybrid,Tier1_City,3,1,0,2,2,3,3,44.08,Finance,2,4,5,3,3,5,4,1,5,1,1,1,2,3,39.87
Education,Lawyer,3.9661167378701054,8,2,2,1,9,0,0,2,4,0,0,2,1,0,Arts,Bachelors,18-24,13,0,0,Hybrid,Tier1_City,1,3,3,4,3,4,2,27.35,Manufacturing,3,4,2,5,0,2,3,1,1,1,1,0,1,5,43.51
Computer Science,Urban Planner,4.459336283927709,3,0,4,1,6,1,3,0,0,0,0,1,0,1,Science,Bachelors,25-30,4,0,0,Remote,Tier1_City,3,4,3,1,2,3,3,10.42,Manufacturing,4,3,5,2,0,3,4,3,3,1,1,0,2,1,32.13
Music,Architectural Technologist,4.5422358661484274,8,1,0,0,0,1,0,2,1,4,0,0,1,0,Arts,PhD,18-24,5,0,0,Office,Tier1_City,3,4,1,1,0,2,5,39.4,Healthcare,3,5,2,2,2,0,3,4,5,5,0,1,2,3,56.49
Education,Chemical Engineer,4.041994113959097,3,1,1,1,9,1,4,3,1,4,3,1,4,0,Arts,Bachelors,25-30,11,0,0,Remote,Tier3_City,5,4,1,3,0,1,3,12.8,Tech,5,5,1,1,4,4,2,3,5,1,1,0,4,4,60.47
Finance,Civil Engineer,4.229732283325283,4,1,0,0,8,1,4,4,2,0,2,1,2,1,Commerce,Masters,25-30,5,0,0,Hybrid,Tier1_City,1,4,1,5,2,1,4,22.39,Healthcare,5,2,1,2,3,1,5,2,2,4,1,0,5,3,53.71
Art,Market Research Analyst,4.491055850306398,7,1,4,0,9,0,1,1,2,2,0,0,4,0,Arts,Bachelors,18-24,5,0,0,Flexible,Tier2_City,4,1,2,4,2,1,2,29.7,Tech,1,3,5,1,5,2,5,3,3,3,1,0,4,1,36.89
Art,Fluid Mechanics Engineer,4.499669472851546,9,1,0,1,3,1,1,1,1,0,4,3,0,0,Arts,Masters,25-30,8,0,0,Remote,Tier2_City,5,2,4,2,4,2,5,30.47,Healthcare,5,3,1,2,4,1,2,3,1,1,1,1,1,3,49.75
Finance,Landscape Architect,2.741656013449901,3,1,4,0,6,0,1,1,1,0,3,2,2,1,Commerce,High School,25-30,0,0,0,Hybrid,Tier1_City,1,3,3,4,1,5,1,6.24,Manufacturing,4,1,3,4,4,5,3,4,5,1,1,0,2,5,35.02
Finance,Artist,3.738759101268218,6,0,4,1,2,1,1,1,4,2,2,3,4,0,Commerce,Masters,25-30,9,0,0,Hybrid,Tier2_City,1,4,5,2,3,0,4,42.33,Healthcare,5,2,5,4,0,3,3,4,2,5,1,1,1,2,63.99
Biology,Judge,2.914948170990316,5,2,2,0,4,0,0,0,2,4,2,0,4,1,Science,PhD,36-40,5,0,0,Remote,Tier3_City,1,2,4,5,0,2,1,25.53,Education,4,2,4,5,0,1,5,1,2,4,1,1,3,4,48.54
Art,Pharmacist,4.379578535267432,4,2,3,1,7,1,4,0,2,1,3,0,4,0,Arts,Masters,31-35,12,0,0,Office,Tier1_City,4,3,0,2,3,1,4,49.5,Healthcare,3,5,4,4,0,2,1,1,1,2,1,0,1,1,56.22
Education,Social Media Manager,4.1856552135574665,5,1,3,0,6,1,0,0,2,2,0,2,1,1,Arts,Masters,25-30,7,0,0,Hybrid,Tier2_City,5,1,1,3,4,1,5,36.72,Other,1,5,1,3,2,2,3,1,3,1,1,0,4,4,42.63
Computer Science,Counselor,3.1479659528764263,1,2,1,1,0,1,0,0,3,3,1,1,0,0,Science,PhD,36-40,7,1,44,Hybrid,Tier1_City,4,5,0,3,0,1,5,49.65,Other,1,2,1,3,3,1,2,3,3,2,1,0,4,3,48.21
Engineering,Inorganic Chemist,4.112884147978967,7,2,4,0,8,0,4,1,3,0,3,1,2,1,Science,Masters,31-35,11,0,0,Remote,Tier1_City,3,1,5,3,4,5,5,24.31,Healthcare,5,3,2,1,5,1,5,3,2,3,1,1,5,5,57.44
Psychology,Animator,3.49026669631501,3,2,2,1,5,1,3,0,4,0,3,0,2,1,Arts,Bachelors,18-24,14,0,0,Remote,Tier1_City,2,5,5,3,4,3,4,9.62,Healthcare,2,1,5,3,5,3,2,5,3,1,0,1,2,2,52.73
Education,Illustrator,2.559323482947058,9,2,2,0,7,1,1,2,1,3,0,3,4,0,Arts,Masters,18-24,14,1,53,Remote,Tier1_City,4,4,5,4,5,0,3,37.18,Education,5,5,5,2,3,1,2,2,3,3,0,1,4,2,60.15
Chemistry,Analytical Chemist,4.093155465369939,9,0,1,0,1,0,3,1,3,4,2,0,3,0,Science,Masters,31-35,2,0,0,Remote,Tier3_City,3,2,1,5,2,2,1,39.55,Tech,2,1,3,1,4,2,3,5,2,2,1,1,4,5,46.76
Finance,Architectural Technologist,4.737465052161689,9,0,2,1,8,1,2,3,0,3,3,3,1,0,Commerce,Bachelors,25-30,12,1,36,Hybrid,Tier2_City,4,2,1,2,5,1,3,43.08,Healthcare,5,2,4,4,5,5,2,2,5,1,0,0,1,3,65.77
Engineering,Graphic Designer,3.198373913640955,0,0,2,0,3,0,2,3,2,1,2,2,0,0,Science,Masters,31-35,4,0,0,Hybrid,Tier1_City,1,3,0,2,3,4,3,17.17,Tech,4,3,4,4,5,5,5,4,5,1,0,1,3,5,55.69
Music,Architect,3.7909913109007407,4,0,2,1,2,1,3,4,1,1,1,4,4,0,Arts,PhD,31-35,9,0,0,Remote,Tier2_City,2,5,4,3,3,0,2,27.0,Other,4,1,3,3,5,1,1,3,3,4,0,1,2,4,66.35
Architecture,Inorganic Chemist,3.701481824788301,8,2,3,0,4,1,0,4,4,4,4,4,2,1,Interdisciplinary,PhD,31-35,3,0,0,Remote,Tier2_City,2,5,5,3,2,4,1,43.3,Finance,2,4,2,3,0,0,5,5,2,4,1,0,5,4,64.97
Education,Dentist,3.820904405897955,2,1,2,0,9,0,2,2,1,2,1,0,1,1,Arts,Bachelors,40+,11,0,0,Hybrid,Tier1_City,3,3,0,1,5,0,4,43.64,Manufacturing,1,2,3,2,5,2,4,3,5,1,1,1,5,3,53.69
Medicine,Legal Consultant,4.347496048573282,9,0,2,1,1,0,0,4,0,3,0,2,0,0,Science,Bachelors,25-30,0,0,0,Office,Tier3_City,4,2,2,5,3,1,2,4.21,Finance,2,3,2,4,4,2,5,5,5,3,0,0,3,5,39.52
Architecture,Quantum Physicist,3.494390792706835,7,2,3,1,4,1,3,0,2,3,4,0,3,1,Interdisciplinary,PhD,18-24,8,0,0,Hybrid,Tier1_City,4,2,3,4,5,0,2,34.53,Education,3,2,2,3,0,3,4,1,2,5,1,1,3,5,67.36
Physics,Analytical Chemist,2.840091284565516,7,2,0,0,2,0,3,1,0,3,4,4,4,1,Science,Masters,36-40,4,1,19,Remote,Any,4,3,3,2,2,0,5,31.28,Education,1,2,2,4,4,3,3,2,1,3,1,1,5,1,51.75
Medicine,Chemical Engineer,4.372833847011562,9,0,1,0,7,1,0,1,4,1,1,0,2,0,Science,Bachelors,25-30,1,0,0,Flexible,Tier1_City,3,5,4,1,0,1,4,6.92,Tech,2,1,1,4,4,4,4,1,3,4,1,0,3,2,39.35
Business,Pharmacist,3.722214682810115,1,2,4,0,0,0,2,0,1,0,1,4,3,0,Commerce,PhD,31-35,11,0,0,Flexible,Tier2_City,4,4,4,1,4,5,3,46.72,Tech,3,1,1,3,2,3,1,3,3,4,1,0,4,1,60.14
Biology,Electrical Engineer,3.328567927291484,5,2,4,0,7,0,2,1,4,1,1,0,0,0,Science,Masters,40+,1,0,0,Hybrid,Any,2,3,4,2,4,4,3,23.93,Healthcare,3,4,2,4,5,0,3,4,5,5,1,1,4,3,53.57
Music,Nuclear Physicist,4.380696736841681,9,1,4,0,1,1,0,3,2,2,1,1,3,1,Arts,Bachelors,31-35,10,1,13,Hybrid,Tier3_City,2,2,0,4,5,5,3,34.69,Finance,5,5,3,3,2,3,1,4,2,4,0,1,1,2,52.62
Education,Mechanical Engineer,2.539843972772004,9,1,4,0,0,1,4,1,4,1,3,4,2,0,Arts,Masters,25-30,6,1,14,Hybrid,Tier1_City,5,4,0,1,3,4,5,44.49,Tech,2,4,3,5,5,4,4,1,4,4,1,0,1,3,69.86
Physics,Paralegal,3.838381675669544,2,1,4,0,2,1,2,0,4,3,4,1,3,1,Science,Bachelors,25-30,3,1,39,Flexible,Tier2_City,4,4,5,1,5,3,3,9.12,Other,4,3,3,3,4,2,3,5,4,2,0,0,1,5,51.8
Biology,Software Developer,3.2234632655362554,9,0,2,1,1,1,4,0,3,3,1,2,4,0,Science,Bachelors,25-30,0,0,0,Hybrid,Tier1_City,4,5,0,5,5,4,1,43.22,Tech,5,3,1,4,0,3,4,1,2,5,0,0,3,1,47.71
Biology,Ecologist,3.572467302967164,7,0,2,0,2,1,4,1,0,2,3,4,1,0,Science,Bachelors,25-30,4,0,0,Flexible,Tier2_City,2,3,1,4,1,4,3,37.04,Other,1,2,2,5,4,4,2,4,2,4,1,0,5,3,52.87
Law,Physicist,4.6140743759419625,1,2,2,1,4,1,4,4,4,2,1,3,4,1,Arts,Masters,31-35,1,0,0,Remote,Tier3_City,2,4,0,1,4,0,3,42.46,Tech,4,1,4,4,0,3,1,1,1,3,0,1,2,1,57.07
Medicine,Architect,4.135999821709918,7,0,4,0,5,1,0,4,4,4,1,0,4,1,Science,High School,31-35,14,0,0,Hybrid,Tier2_City,1,1,3,4,2,3,1,26.26,Manufacturing,3,2,3,4,1,3,2,2,4,4,0,0,4,5,57.29
Finance,Interior Designer,2.5859347225368685,7,1,4,1,7,1,2,1,3,0,1,3,3,0,Commerce,Bachelors,31-35,6,1,12,Office,Tier1_City,1,4,3,2,5,1,5,4.57,Tech,1,5,1,5,3,2,1,1,2,1,1,1,5,3,45.23
Art,Web Developer,3.887331851562666,2,1,0,0,5,1,4,4,4,4,1,2,1,1,Arts,Bachelors,18-24,14,1,23,Office,Tier2_City,5,4,1,3,1,1,2,34.51,Manufacturing,5,2,5,2,4,4,1,5,2,5,1,0,5,5,67.96
Physics,Quantum Physicist,4.574907239275964,3,2,4,0,4,1,3,3,1,2,0,4,2,0,Science,Bachelors,25-30,8,0,0,Office,Tier1_City,2,4,0,1,1,2,4,20.6,Education,3,3,2,5,1,3,3,3,3,3,1,0,5,3,52.68
Physics,Judge,3.280865216916971,2,2,0,1,3,1,1,1,4,4,0,0,3,1,Science,PhD,31-35,12,0,0,Flexible,Tier1_City,5,3,0,5,4,3,5,21.91,Healthcare,3,3,3,4,4,2,2,1,4,1,0,1,5,5,61.01
Finance,Clinical Psychologist,4.146884803214843,3,1,2,1,0,1,3,0,2,4,3,3,4,1,Commerce,Bachelors,25-30,0,0,0,Office,Tier2_City,4,5,2,2,4,0,3,23.74,Finance,3,4,1,4,2,5,4,2,2,1,0,1,3,2,42.41
Biology,Biologist,3.164510467412724,1,0,2,1,0,0,3,1,2,0,1,0,1,1,Science,Bachelors,25-30,11,0,0,Hybrid,Tier2_City,4,5,2,4,4,2,2,26.17,Tech,4,2,5,2,3,4,3,5,4,2,0,1,4,2,54.27
Architecture,Geneticist,4.675076889041688,6,0,3,1,5,0,3,2,2,2,1,4,1,1,Interdisciplinary,Masters,31-35,1,0,0,Hybrid,Tier2_City,2,1,3,2,2,2,4,34.11,Manufacturing,5,1,2,5,4,1,1,2,2,2,1,1,5,3,46.86
Business,Pharmacist,3.4870380178752334,1,0,3,1,4,0,0,1,0,1,4,2,1,1,Commerce,Bachelors,31-35,10,0,0,Hybrid,Tier1_City,3,1,4,1,1,1,4,37.16,Tech,5,5,4,3,5,4,4,5,4,3,0,0,2,3,52.36
Marketing,Accountant,4.281143345169475,5,0,0,0,1,0,3,2,2,2,2,1,3,1,Commerce,Bachelors,25-30,5,1,42,Hybrid,Any,5,4,5,4,3,4,4,39.51,Tech,4,5,2,4,2,3,1,4,1,5,1,0,5,2,53.55
Psychology,Surgeon,2.8296370081547915,7,0,3,0,4,0,0,0,1,4,1,3,3,0,Arts,Bachelors,36-40,7,0,0,Hybrid,Tier2_City,3,4,3,3,2,0,1,34.57,Manufacturing,5,1,2,5,2,3,1,4,1,3,0,1,3,3,47.15
Medicine,AI Researcher,2.739422097329889,6,0,0,1,2,1,2,1,4,0,4,3,3,0,Science,Bachelors,18-24,6,1,24,Hybrid,Tier1_City,4,4,5,2,0,3,1,40.76,Tech,3,5,3,1,1,4,4,3,1,1,1,1,3,1,40.74
Physics,Psychologist,3.1445947375358148,0,1,2,0,8,1,1,1,1,4,0,4,1,0,Science,Bachelors,40+,8,0,0,Remote,Any,5,1,1,1,5,2,2,8.74,Finance,3,1,2,4,5,2,5,3,5,2,0,0,2,4,58.61
Education,Financial Analyst,4.500555646509408,2,2,0,1,1,0,0,3,4,4,0,4,1,0,Arts,Bachelors,18-24,13,0,0,Remote,Any,4,5,0,5,4,0,3,42.33,Other,3,1,5,3,2,4,4,5,2,1,1,0,2,4,57.44
Medicine,Pharmacist,4.51715192389716,7,0,0,0,2,0,3,3,2,0,0,3,2,0,Science,Bachelors,18-24,1,0,0,Flexible,Tier1_City,1,1,2,4,1,1,2,21.2,Other,5,4,5,4,5,3,3,2,3,1,0,1,1,2,40.1
Finance,Biochemist,4.255915711942563,5,2,1,0,1,0,2,3,4,3,0,4,0,0,Commerce,PhD,36-40,11,0,0,Remote,Tier2_City,2,5,5,2,5,2,3,27.85,Other,2,2,2,5,1,3,4,2,5,2,1,0,1,1,78.09
Chemistry,Actuary,3.224097188740207,9,0,0,1,0,1,1,2,0,4,2,2,2,1,Science,Bachelors,18-24,8,0,0,Remote,Tier2_City,1,1,3,2,2,2,5,23.39,Other,1,3,2,2,0,0,3,1,4,2,0,1,1,4,48.28
Law,AI Researcher,3.8015775705078014,2,0,1,1,0,1,2,1,4,2,0,4,1,1,Arts,Masters,31-35,3,0,0,Hybrid,Tier1_City,5,5,5,3,0,5,4,25.36,Education,2,3,5,1,0,2,2,4,2,5,0,0,4,5,48.3
Chemistry,Legal Analyst,4.297297716708608,0,1,1,0,3,1,4,0,3,0,3,3,4,1,Science,Masters,36-40,10,0,0,Remote,Tier1_City,1,1,1,3,2,1,4,16.42,Healthcare,4,2,5,3,0,0,4,1,2,1,1,0,1,1,57.21
Chemistry,Acoustics Specialist,4.239002980637721,0,0,2,0,9,0,0,2,2,1,2,0,2,0,Science,High School,36-40,14,1,12,Hybrid,Tier2_City,5,5,4,5,2,5,1,10.99,Tech,2,5,3,4,0,5,2,3,5,2,1,1,5,1,46.85
Psychology,Counselor,4.83085546515799,4,0,0,1,3,0,1,3,1,4,2,1,2,1,Arts,Masters,40+,2,0,0,Remote,Tier1_City,3,3,3,5,3,1,5,7.93,Manufacturing,2,1,4,3,4,3,4,4,2,3,1,1,1,2,44.64
Medicine,Web Developer,4.257067342594226,5,2,4,0,2,1,4,0,1,4,3,4,0,0,Science,Bachelors,25-30,6,1,47,Remote,Tier3_City,2,3,0,1,5,1,5,24.22,Finance,4,3,5,2,5,2,3,2,2,1,1,0,3,4,54.56
Education,Market Research Analyst,3.898706106261313,6,0,2,0,5,0,2,2,3,4,4,2,1,0,Arts,PhD,31-35,4,0,0,Office,Tier1_City,3,2,0,1,3,5,3,8.89,Tech,2,4,4,1,1,2,2,4,4,5,1,1,2,5,66.02
Music,Illustrator,3.8637262509981,6,0,2,0,2,1,1,2,4,1,0,2,4,1,Arts,Bachelors,18-24,12,0,0,Office,Any,4,5,2,5,2,0,5,14.51,Education,1,5,4,3,0,2,5,3,3,5,0,1,3,3,60.51
Biology,Teacher,4.501254460807823,5,2,3,0,7,1,2,4,1,0,4,0,1,1,Science,Bachelors,25-30,4,0,0,Remote,Tier3_City,2,5,1,5,0,0,1,9.28,Education,5,4,5,5,2,5,4,4,4,1,1,0,2,3,43.44
Architecture,Market Research Analyst,3.0298922667057693,4,1,4,1,0,1,4,2,2,2,2,1,2,1,Interdisciplinary,Bachelors,36-40,11,1,13,Office,Tier3_City,1,5,4,4,1,0,3,8.13,Manufacturing,4,3,3,5,5,4,3,3,5,4,1,1,3,2,66.03
Physics,Legal Analyst,4.948803800335134,2,2,3,1,0,0,4,2,1,0,4,1,3,1,Science,PhD,25-30,12,0,0,Hybrid,Tier1_City,5,2,4,3,1,4,2,44.48,Tech,2,2,2,3,1,4,3,2,2,1,0,1,5,1,57.02
Computer Science,Urban Planner,4.292694249233172,3,1,3,1,0,0,1,3,3,2,1,0,4,0,Science,Bachelors,25-30,1,0,0,Office,Tier3_City,2,1,1,1,5,2,3,34.68,Other,3,2,1,1,5,3,1,5,2,3,0,0,3,5,42.23
Medicine,Biologist,3.0630585117684856,8,1,0,1,3,0,3,3,4,2,2,4,2,0,Science,Masters,25-30,5,0,0,Hybrid,Tier2_City,4,3,2,3,4,0,2,46.42,Tech,3,4,2,4,5,5,3,4,3,5,1,1,2,3,69.25
Architecture,Inorganic Chemist,2.9160076100677443,9,2,2,0,4,1,2,1,2,0,0,3,4,0,Interdisciplinary,Bachelors,31-35,5,0,0,Remote,Tier2_City,3,2,0,3,4,4,3,33.27,Tech,4,5,1,5,5,2,3,5,3,2,1,0,4,3,46.02
Finance,Industrial-Organizational Psychologist,4.51062439961483,2,2,3,1,9,1,0,1,3,0,1,0,1,0,Commerce,Masters,40+,11,1,27,Office,Tier1_City,4,3,4,5,1,2,4,42.67,Education,3,3,5,4,4,2,4,3,1,2,1,0,2,2,47.39
Chemistry,Credit Analyst,4.015526907349506,8,0,0,1,0,1,3,4,0,2,0,2,1,0,Science,Bachelors,18-24,3,0,0,Hybrid,Tier3_City,1,4,1,4,2,0,2,29.1,Tech,1,1,2,4,0,2,2,4,3,1,1,1,2,1,38.9
Physics,Paralegal,3.9557334074381343,5,0,1,1,4,0,4,0,0,0,2,2,0,1,Science,Masters,25-30,4,0,0,Remote,Tier1_City,5,2,2,2,2,1,1,24.74,Other,2,2,2,3,1,4,4,2,4,2,0,0,2,3,44.27
Computer Science,Quantum Physicist,2.510383273786693,6,2,2,1,4,1,0,1,3,1,1,0,1,1,Science,Bachelors,36-40,6,1,50,Hybrid,Tier2_City,5,2,0,4,3,3,2,27.84,Tech,1,4,1,5,3,3,4,4,2,1,1,0,2,5,42.51
Finance,Biologist,2.887558018330043,8,1,3,1,4,1,4,4,1,1,0,0,1,0,Commerce,Bachelors,25-30,13,0,0,Office,Tier3_City,1,3,1,4,5,0,2,18.05,Tech,1,3,3,3,0,2,5,2,4,4,0,1,3,3,63.59
Architecture,Illustrator,3.817085675588293,2,0,3,1,2,1,2,3,0,0,1,0,2,1,Interdisciplinary,High School,18-24,7,0,0,Hybrid,Tier2_City,5,5,2,3,3,3,3,33.92,Tech,5,5,5,2,1,2,5,3,4,2,1,0,1,2,38.52
Chemistry,Architect,4.147030919744518,8,1,4,0,6,1,2,2,2,1,4,4,0,1,Science,Bachelors,25-30,5,0,0,Remote,Tier1_City,2,4,3,4,4,0,4,45.17,Other,2,1,5,4,0,1,4,5,4,3,0,1,4,4,59.64
Chemistry,Nurse,4.193634570046534,9,0,1,0,0,1,3,2,4,0,4,4,3,0,Science,Masters,25-30,4,1,33,Office,Tier1_City,2,3,1,1,1,1,3,39.77,Other,4,1,5,1,3,5,5,1,4,3,0,1,1,3,60.24
Medicine,Digital Marketing Specialist,3.926706877891907,9,1,0,0,0,1,3,4,1,0,1,4,2,0,Science,Bachelors,18-24,11,1,44,Flexible,Tier2_City,1,2,4,3,2,3,3,24.71,Manufacturing,3,2,2,4,2,0,1,1,4,5,0,0,3,2,67.39
Education,Surgeon,4.365274440685903,4,2,2,1,1,0,4,4,1,1,0,0,4,1,Arts,Masters,36-40,2,0,0,Hybrid,Tier1_City,1,5,1,1,1,4,4,47.83,Education,5,1,4,1,2,5,3,4,4,2,0,0,4,3,41.09
Physics,Marketing Specialist,4.942794177165699,1,0,3,1,2,0,1,1,1,4,3,4,0,1,Science,Bachelors,25-30,6,1,32,Hybrid,Tier1_City,4,4,0,2,0,1,3,49.31,Healthcare,1,3,1,3,3,5,4,5,2,1,0,0,2,1,46.81
Finance,Analytical Chemist,4.530792754409594,4,1,0,1,6,1,2,3,4,4,0,2,0,1,Commerce,Bachelors,36-40,7,0,0,Hybrid,Tier1_City,5,5,1,3,1,3,4,26.18,Manufacturing,3,2,2,5,1,5,2,2,4,4,1,0,3,2,59.32
Art,Biomedical Engineer,4.66465745851227,8,1,4,1,1,0,3,4,3,1,2,0,1,0,Arts,Bachelors,36-40,2,0,0,Remote,Tier3_City,3,3,5,2,0,3,1,43.64,Other,2,2,3,4,4,4,5,1,5,3,1,1,1,4,50.44
Architecture,Financial Advisor,3.710971406533706,4,2,2,0,9,1,4,1,3,3,3,2,4,0,Interdisciplinary,Bachelors,31-35,4,0,0,Office,Tier1_City,1,5,0,3,3,5,4,3.22,Tech,1,2,3,2,0,1,1,5,4,5,1,0,1,3,58.87
Engineering,Musician,4.781670933673396,5,1,0,0,7,0,2,2,2,4,4,3,4,1,Science,Masters,18-24,10,0,0,Office,Any,4,2,2,5,3,5,5,6.13,Healthcare,1,3,2,4,4,3,5,5,1,1,1,1,4,3,60.62
Chemistry,Curriculum Developer,2.897350854432399,2,2,1,1,5,0,2,2,2,3,1,1,2,0,Science,Bachelors,25-30,1,0,0,Hybrid,Tier2_City,1,2,3,4,4,1,4,4.05,Finance,2,4,1,1,0,0,1,3,4,3,1,1,2,1,44.02
Engineering,Manager,4.982948596871262,9,1,1,1,7,0,2,2,4,2,0,4,0,1,Science,Bachelors,18-24,9,1,57,Remote,Tier3_City,1,1,0,5,1,1,4,39.34,Healthcare,4,1,5,1,4,3,1,1,1,2,0,0,4,2,47.92
Finance,Industrial-Organizational Psychologist,2.7057208161760853,2,2,0,0,2,0,3,1,1,0,1,3,3,1,Commerce,Masters,36-40,9,0,0,Remote,Tier1_City,2,4,2,2,1,1,5,6.75,Manufacturing,5,1,5,1,0,4,1,3,2,5,1,0,4,2,57.07
Psychology,Brand Manager,4.720817418669567,0,1,3,0,0,0,1,1,0,4,0,0,2,0,Arts,PhD,18-24,11,1,59,Hybrid,Any,5,3,2,4,0,2,4,3.8,Education,2,4,4,5,2,5,4,5,5,5,0,0,1,3,63.78
Marketing,Interior Designer,3.9208854283447687,7,2,1,0,9,0,1,3,0,2,2,0,2,0,Commerce,Bachelors,25-30,3,0,0,Remote,Tier1_City,1,5,3,3,3,4,2,9.93,Manufacturing,3,2,2,2,0,3,3,1,2,1,0,0,2,3,36.27
Engineering,Organic Chemist,4.033759958756091,0,0,4,1,4,1,3,0,2,2,0,3,1,0,Science,Bachelors,25-30,11,0,0,Hybrid,Tier1_City,5,2,4,4,0,0,3,17.4,Education,3,5,4,2,0,2,4,2,2,5,0,1,5,4,51.26
Medicine,Physicist,4.109278420456201,1,2,2,0,7,1,3,4,2,3,1,1,4,1,Science,Masters,25-30,3,0,0,Hybrid,Tier1_City,4,1,4,1,3,5,3,24.84,Education,1,3,3,1,3,2,3,4,4,3,1,0,2,3,51.53
Law,Physicist,3.887306059088067,9,2,4,1,1,0,1,3,3,3,4,1,4,0,Arts,Bachelors,18-24,11,0,0,Remote,Tier1_City,1,3,1,4,0,3,1,6.07,Other,5,2,5,2,3,5,2,5,1,1,0,1,2,2,49.26
Law,Chemist,4.200995174570847,2,1,2,0,7,1,1,3,2,0,3,0,1,1,Arts,High School,25-30,12,1,28,Hybrid,Tier2_City,3,2,4,1,3,5,1,26.45,Education,4,2,5,2,0,3,5,2,5,3,1,0,1,2,55.39
Architecture,Credit Analyst,2.586102909076552,2,2,3,0,0,1,4,2,0,0,0,3,2,0,Interdisciplinary,Bachelors,18-24,7,0,0,Hybrid,Tier3_City,2,3,1,4,0,0,5,14.66,Finance,4,2,4,3,0,3,4,4,4,3,0,1,2,4,46.11
Finance,Civil Engineer,4.571190835688208,3,2,2,0,9,0,3,0,1,2,4,3,1,0,Commerce,Masters,18-24,2,1,6,Hybrid,Tier1_City,3,2,0,1,3,1,2,15.9,Healthcare,3,1,2,2,1,3,5,1,1,2,0,0,1,3,43.31
Engineering,Software Developer,3.853322991316309,7,2,1,1,3,0,3,4,3,1,1,3,4,0,Science,Masters,25-30,4,1,58,Remote,Tier3_City,2,3,5,2,5,5,1,41.63,Manufacturing,4,1,4,1,2,3,5,2,4,5,0,0,4,5,64.38
Chemistry,Microbiologist,3.3186580627405458,4,0,1,0,1,0,1,2,0,1,4,4,0,1,Science,High School,31-35,10,0,0,Remote,Tier3_City,1,2,5,5,0,4,3,49.39,Manufacturing,3,5,3,5,0,2,2,2,2,2,1,0,3,1,50.64
Business,Doctor,4.751152572274634,0,1,4,0,8,0,2,4,1,4,0,3,4,1,Commerce,Bachelors,25-30,4,0,0,Office,Any,1,5,5,3,1,4,1,24.8,Education,5,3,2,3,0,5,5,4,1,4,0,1,2,5,46.53
Education,Architectural Technologist,4.479853474167487,8,1,1,0,7,0,4,1,3,1,3,0,4,1,Arts,Bachelors,25-30,1,0,0,Office,Tier1_City,5,4,5,4,4,2,1,18.12,Other,1,2,3,2,2,1,3,2,3,4,0,1,5,2,46.03
Business,Ecologist,4.047484199620543,6,0,1,0,8,1,3,4,3,2,2,2,2,1,Commerce,Masters,25-30,8,0,0,Office,Tier1_City,2,2,0,5,5,5,4,46.78,Finance,3,1,2,3,1,1,4,1,4,2,1,0,1,3,68.59
Music,Clinical Psychologist,4.605887997776887,4,0,4,0,0,1,3,4,2,0,4,0,0,1,Arts,High School,25-30,3,0,0,Remote,Tier1_City,4,3,1,3,5,1,1,26.52,Finance,5,4,4,4,5,3,2,1,2,4,0,0,1,4,49.74
Law,Electrical Engineer,4.750073034889394,2,1,3,1,3,1,4,0,1,0,3,3,0,0,Arts,Bachelors,36-40,8,0,0,Remote,Tier1_City,3,2,3,3,0,3,5,37.33,Tech,3,1,1,3,3,3,3,5,1,4,0,1,5,3,52.18
Engineering,Artist,4.334747330331393,5,2,4,1,8,1,4,1,1,3,1,3,0,1,Science,Masters,18-24,8,0,0,Hybrid,Tier2_City,4,1,3,1,4,2,3,22.45,Finance,2,2,4,3,3,0,3,4,2,2,1,0,4,4,55.24
Music,Marketing Specialist,3.513504142923165,5,1,1,1,2,0,4,3,3,1,3,2,3,1,Arts,Bachelors,31-35,1,1,52,Flexible,Tier2_City,2,5,4,2,1,1,5,12.52,Education,3,2,2,3,2,3,2,3,4,2,1,1,3,4,47.04
Music,Biologist,4.183595796155268,7,2,4,0,7,0,3,0,0,2,1,1,2,0,Arts,Masters,36-40,8,0,0,Flexible,Tier1_City,4,1,0,2,5,2,5,33.78,Education,5,1,3,2,0,1,2,1,4,2,0,1,3,4,51.02
Engineering,Investment Banker,3.28353086558512,2,0,1,0,0,1,4,1,3,0,0,4,3,0,Science,Bachelors,36-40,8,0,0,Office,Tier2_City,2,3,0,5,1,5,2,34.25,Healthcare,4,4,4,3,5,4,5,3,4,4,1,0,2,2,55.56
Business,Electrical Engineer,3.169009640984558,8,0,1,0,2,1,2,1,0,0,3,0,1,0,Commerce,Bachelors,18-24,1,0,0,Remote,Tier1_City,5,2,5,2,3,0,4,24.63,Education,3,4,2,5,3,4,1,2,5,5,1,1,4,3,48.42
Biology,Risk Analyst,4.1731199352386605,1,2,2,1,5,0,2,1,4,4,2,0,3,1,Science,Bachelors,25-30,10,1,44,Office,Tier1_City,5,2,3,4,4,5,5,15.69,Healthcare,1,2,3,2,0,3,3,4,5,3,1,1,4,4,61.65
Biology,Fluid Mechanics Engineer,2.8762706611493365,8,1,1,0,9,0,2,1,0,3,1,1,0,0,Science,Masters,31-35,12,0,0,Flexible,Tier1_City,4,1,2,2,2,1,2,42.1,Finance,5,1,3,1,4,5,3,4,4,3,1,0,1,2,56.37
Business,Nuclear Physicist,2.779696449360392,3,1,4,1,0,1,4,2,3,2,3,1,2,1,Commerce,Masters,18-24,5,0,0,Remote,Tier2_City,4,4,3,5,3,3,3,15.94,Tech,4,3,3,4,0,3,1,1,5,5,1,0,2,3,69.54
Marketing,Physical Chemist,2.771854774037205,9,1,2,1,5,0,3,4,2,4,3,3,4,1,Commerce,Masters,36-40,8,1,35,Hybrid,Tier2_City,2,5,3,2,4,3,3,33.97,Other,5,3,2,1,3,4,3,1,2,2,1,1,5,3,65.83
Marketing,Legal Analyst,2.606059154975556,3,0,3,1,0,0,3,3,3,2,1,4,4,1,Commerce,Bachelors,31-35,3,1,50,Hybrid,Tier3_City,5,2,2,4,0,1,2,21.05,Manufacturing,3,2,3,2,0,0,4,4,1,1,0,1,4,2,40.71
Psychology,Geneticist,4.042358040709551,6,1,2,0,3,1,3,0,1,4,4,3,1,0,Arts,Masters,31-35,1,1,7,Remote,Any,4,2,4,1,0,2,5,25.21,Education,2,4,3,1,5,1,5,3,5,1,0,0,3,1,46.45
Marketing,Acoustics Specialist,3.118450545611421,1,0,4,1,8,1,1,1,0,4,4,0,3,1,Commerce,Bachelors,18-24,6,0,0,Hybrid,Tier3_City,2,3,1,5,1,4,5,12.94,Finance,2,3,4,4,0,5,5,4,5,2,0,0,4,2,52.5
Education,Market Research Analyst,2.5485871676139875,8,1,0,1,5,1,4,4,0,2,4,0,0,1,Arts,Bachelors,31-35,14,1,18,Flexible,Tier1_City,2,1,4,1,5,1,4,33.53,Education,1,1,3,3,5,3,4,5,5,3,1,1,1,2,64.38
Finance,Market Research Analyst,3.398113121081794,8,0,3,0,5,1,1,2,0,1,1,3,4,0,Commerce,Masters,31-35,8,0,0,Flexible,Tier1_City,4,3,5,1,2,5,4,13.61,Healthcare,1,5,1,1,1,3,1,4,5,1,1,1,4,5,51.59
Chemistry,Chemical Engineer,3.998403058382943,4,2,2,1,0,0,3,2,2,0,3,1,4,0,Science,High School,36-40,5,1,48,Flexible,Any,3,5,2,1,0,3,3,25.83,Finance,4,5,2,2,1,0,2,3,3,5,1,1,5,4,47.08
Marketing,School Psychologist,3.762590443319237,3,1,4,1,3,1,2,1,4,1,0,2,1,1,Commerce,Bachelors,18-24,10,0,0,Hybrid,Tier3_City,1,2,2,3,4,0,4,18.44,Manufacturing,2,4,3,5,5,1,3,2,1,1,1,0,3,4,48.47
Computer Science,Art Director,3.716848931003202,8,2,2,0,3,1,3,0,0,2,2,1,1,1,Science,Bachelors,18-24,10,1,48,Hybrid,Tier3_City,2,1,4,3,5,3,2,48.29,Healthcare,3,5,3,4,0,3,3,3,2,5,1,0,2,2,56.34
Art,Inorganic Chemist,4.772240446419863,2,0,1,0,5,1,0,1,2,3,2,4,2,1,Arts,High School,25-30,13,1,23,Office,Tier3_City,5,1,5,1,5,4,3,49.16,Finance,5,1,5,1,2,5,2,4,5,1,0,0,2,4,53.96
Education,Quantum Physicist,2.553907691468761,6,1,0,1,1,1,1,3,1,3,1,3,3,1,Arts,Bachelors,18-24,3,0,0,Hybrid,Tier1_City,1,1,5,5,4,3,5,38.41,Other,5,2,4,5,2,1,2,4,3,3,0,0,4,2,46.83
Law,Nurse,4.687014384975555,5,1,4,1,5,1,0,4,4,3,2,0,3,0,Arts,Masters,25-30,0,1,49,Remote,Tier3_City,2,5,1,4,5,4,3,49.24,Other,2,2,3,4,2,1,1,2,4,2,0,1,1,2,48.34
Education,Principal,4.308719218739887,3,0,2,0,8,0,2,2,1,0,0,0,1,0,Arts,Bachelors,36-40,3,0,0,Office,Tier1_City,3,4,4,4,0,1,1,8.34,Manufacturing,2,1,4,1,2,5,3,5,4,1,0,0,2,3,30.61
Business,Industrial-Organizational Psychologist,2.873356164859434,9,2,2,0,7,0,2,4,2,3,3,1,0,0,Commerce,Masters,25-30,2,0,0,Remote,Tier1_City,1,4,0,2,4,3,3,49.64,Other,5,2,4,2,3,4,2,1,3,1,1,0,3,1,47.12
Physics,Analytical Chemist,4.960262844434224,1,2,4,1,5,0,0,1,1,2,1,2,2,0,Science,Masters,36-40,6,0,0,Remote,Tier1_City,5,4,0,5,4,2,4,7.87,Healthcare,4,1,1,5,2,3,3,3,2,2,1,0,1,3,48.46
Marketing,Industrial-Organizational Psychologist,2.7045496149226227,3,1,0,1,0,1,1,3,4,1,1,0,2,1,Commerce,Bachelors,18-24,10,1,32,Remote,Tier2_City,1,3,0,3,1,5,2,22.53,Manufacturing,5,1,2,5,3,4,4,3,3,5,0,1,1,1,60.68
Chemistry,Credit Analyst,3.883334984633262,2,0,1,0,4,0,2,0,1,2,4,4,2,1,Science,Bachelors,18-24,12,0,0,Flexible,Tier2_City,4,3,1,1,2,2,5,14.23,Finance,1,5,1,1,2,1,2,4,4,1,1,1,4,2,57.23
Marketing,Actuary,4.496645793640591,3,0,0,0,3,1,3,4,2,0,3,4,4,1,Commerce,Bachelors,18-24,10,0,0,Remote,Tier2_City,2,5,1,2,1,5,5,47.83,Healthcare,3,5,2,1,5,3,1,3,5,4,0,1,1,2,67.79
Marketing,Credit Analyst,3.705620114778968,7,2,0,1,4,0,0,4,0,3,0,2,0,0,Commerce,Masters,25-30,9,0,0,Hybrid,Tier2_City,4,1,2,4,2,3,4,32.88,Other,2,4,5,2,0,2,1,2,4,5,1,1,5,4,55.38
Medicine,Art Director,4.501931129408156,9,0,3,0,3,0,3,2,4,3,1,2,0,0,Science,Bachelors,36-40,4,1,24,Flexible,Tier2_City,3,4,3,3,4,3,4,31.06,Tech,2,5,1,2,5,2,3,5,1,5,0,0,5,4,51.8
Engineering,Sound Engineer,3.269254386923845,9,1,0,1,2,1,2,4,1,3,1,2,1,1,Science,Masters,18-24,11,1,43,Hybrid,Tier1_City,1,2,1,3,5,5,4,49.88,Education,4,2,4,3,2,0,3,4,1,5,1,1,1,3,62.37
Finance,Principal,3.2853958066204934,8,0,2,0,6,0,1,1,1,2,0,4,1,0,Commerce,Bachelors,31-35,2,0,0,Remote,Tier2_City,4,4,5,1,2,0,1,31.78,Other,1,5,3,1,0,5,1,1,4,4,0,1,4,2,41.24
Medicine,Astronomer,2.559329338817184,8,0,2,0,2,0,1,4,2,4,4,2,4,0,Science,Masters,25-30,13,0,0,Hybrid,Tier3_City,3,5,3,4,4,3,2,33.37,Tech,5,1,5,2,5,4,3,2,4,4,0,0,3,3,72.7
Biology,Biochemist,4.089511303719412,5,1,4,1,1,0,2,2,4,3,0,4,2,0,Science,Bachelors,36-40,1,0,0,Remote,Tier2_City,4,4,0,5,4,0,1,5.1,Manufacturing,1,5,2,1,0,5,1,1,5,3,1,1,5,1,51.03
Education,Architect,3.9481318318302856,8,1,2,1,6,1,3,0,4,1,4,1,1,1,Arts,Bachelors,18-24,12,0,0,Remote,Tier2_City,5,2,0,3,1,0,4,43.38,Finance,1,2,1,2,5,1,5,3,5,3,1,0,2,2,60.7
Psychology,Urban Planner,3.850394126156524,3,2,4,1,2,1,2,4,0,3,4,1,1,0,Arts,PhD,18-24,1,0,0,Flexible,Tier2_City,4,2,3,1,1,5,2,48.59,Education,4,4,5,4,1,2,1,3,1,3,1,1,3,4,51.99
Psychology,Risk Analyst,3.6762296044162297,4,2,0,1,2,0,0,2,4,1,2,0,3,1,Arts,Masters,18-24,4,0,0,Remote,Tier1_City,2,2,4,5,5,0,4,48.13,Finance,4,3,1,2,5,3,5,5,2,2,0,1,1,5,43.22
Psychology,Civil Engineer,2.6264530016966274,1,0,3,1,6,0,0,3,0,4,2,3,1,0,Arts,Bachelors,25-30,12,1,44,Office,Tier2_City,4,5,2,4,3,0,2,13.39,Manufacturing,5,1,4,2,5,5,4,1,4,4,1,1,1,2,56.51
Music,Financial Advisor,4.138881164360887,2,0,4,1,9,0,3,1,1,3,3,1,2,0,Arts,Masters,25-30,12,0,0,Hybrid,Tier1_City,4,4,2,3,0,1,5,13.62,Finance,5,2,1,4,4,5,4,2,5,2,1,1,5,3,63.72
Finance,Artist,3.225717729637252,6,2,3,0,5,1,1,2,2,4,0,0,2,1,Commerce,Bachelors,36-40,7,0,0,Remote,Tier2_City,4,5,4,5,3,2,1,20.2,Healthcare,3,2,2,4,5,1,4,1,4,2,0,1,4,4,48.21
Physics,Physical Chemist,2.783779285244042,6,1,1,1,4,0,0,3,1,0,0,2,1,0,Science,Masters,31-35,7,0,0,Hybrid,Tier2_City,4,2,5,5,3,0,4,17.58,Healthcare,1,3,2,3,4,5,2,1,1,4,0,0,4,1,47.13
Chemistry,Chemist,3.762901657880381,1,2,0,1,8,0,3,0,0,3,1,0,2,0,Science,Masters,31-35,13,0,0,Remote,Tier1_City,4,4,3,5,5,2,4,17.36,Other,5,4,3,2,5,0,1,1,5,4,1,1,3,1,60.46
Psychology,Nuclear Physicist,4.321223480693961,3,1,0,1,9,0,4,0,2,0,2,3,0,0,Arts,Bachelors,25-30,11,0,0,Hybrid,Tier2_City,1,3,3,3,2,0,3,31.45,Other,4,1,3,4,0,1,5,1,3,3,1,0,5,1,57.98
Medicine,Nurse,3.6085239149294304,3,1,1,0,9,1,3,4,0,2,3,1,0,0,Science,High School,18-24,4,0,0,Hybrid,Any,1,5,1,3,5,2,5,40.86,Other,3,4,2,3,5,0,5,3,1,1,1,0,2,4,42.69
Architecture,Aerospace Engineer,3.610551315883132,5,1,0,0,8,1,2,4,0,4,4,2,2,0,Interdisciplinary,Bachelors,25-30,12,1,17,Remote,Tier1_City,5,3,0,2,5,3,4,47.03,Other,3,3,2,3,4,1,5,5,4,2,0,0,1,3,63.13
Biology,Social Media Manager,3.5550225567120624,0,1,4,0,8,0,4,4,0,3,0,4,1,1,Science,Bachelors,40+,1,0,0,Office,Any,1,3,0,4,4,3,1,6.19,Manufacturing,4,1,2,1,4,3,1,2,5,4,0,1,5,2,53.72
Business,Advertising Manager,2.89019472591771,7,2,2,1,4,1,3,1,1,2,0,3,2,0,Commerce,Masters,36-40,12,0,0,Remote,Any,3,1,3,1,4,2,5,16.06,Finance,5,5,5,4,2,4,4,4,1,4,0,0,2,4,60.29
Music,Ecologist,2.856919012515301,6,2,1,1,5,1,2,4,1,4,0,3,4,0,Arts,Bachelors,36-40,3,1,44,Hybrid,Tier3_City,2,2,1,5,4,0,4,14.99,Other,4,4,1,5,4,2,2,3,4,3,1,0,1,5,56.59
Physics,Biotechnologist,2.9337219491165536,5,0,4,1,6,0,2,0,4,1,3,2,4,1,Science,Bachelors,36-40,6,1,25,Office,Tier3_City,4,3,5,2,0,1,1,19.8,Manufacturing,5,5,5,4,4,1,1,3,2,3,1,0,4,2,47.39
Marketing,Composer,4.216463072378327,7,1,4,1,1,0,3,2,1,3,1,3,2,1,Commerce,Masters,18-24,13,1,45,Hybrid,Tier2_City,4,5,5,1,2,2,3,22.94,Education,4,1,4,4,4,1,2,2,5,2,1,1,3,4,64.59
Biology,Conductor,4.946352464246979,9,2,1,1,7,0,1,1,0,0,2,2,0,0,Science,PhD,18-24,5,1,24,Flexible,Tier2_City,4,2,1,2,2,4,3,21.29,Other,4,3,3,3,5,3,2,2,2,1,0,0,2,2,41.01
Finance,Artist,4.198079717565735,5,1,2,0,0,1,2,3,1,4,1,0,4,1,Commerce,Bachelors,18-24,9,1,43,Hybrid,Any,5,2,2,3,4,1,1,47.75,Finance,2,5,1,4,1,3,2,5,1,1,1,0,5,3,48.03
Medicine,Sound Engineer,3.314271540701782,1,0,2,1,8,0,2,3,3,0,0,1,1,0,Science,Bachelors,25-30,6,0,0,Flexible,Tier1_City,5,5,2,5,3,4,5,23.55,Healthcare,5,5,3,4,4,2,1,4,5,5,1,0,4,5,54.23
Business,Physical Chemist,4.489196382691634,5,1,4,0,7,0,3,4,1,4,1,2,3,1,Commerce,Bachelors,18-24,4,1,11,Remote,Tier1_City,3,4,3,1,0,2,1,28.92,Tech,1,2,4,3,2,1,4,3,4,5,1,0,5,2,57.7
Computer Science,Pharmacist,3.138871932113271,6,2,0,1,1,0,4,0,3,2,1,2,3,1,Science,High School,25-30,1,0,0,Flexible,Tier1_City,4,5,5,1,3,0,1,38.19,Healthcare,2,1,2,3,3,3,4,5,2,3,0,0,3,5,38.51
Finance,Biomedical Engineer,3.891217942549405,8,1,4,1,9,0,0,0,0,1,1,3,3,1,Commerce,PhD,31-35,7,0,0,Hybrid,Tier3_City,5,4,2,1,1,4,3,37.08,Finance,2,3,3,1,1,4,3,3,1,2,0,0,3,3,43.1
Business,Civil Engineer,3.079942737409308,3,1,0,0,1,1,4,4,1,0,3,2,4,0,Commerce,Bachelors,36-40,13,0,0,Office,Tier1_City,4,2,1,1,2,2,3,30.4,Finance,2,2,2,1,2,0,5,5,4,5,1,0,2,2,63.98
Business,Physicist,3.0056225127421508,1,0,1,0,0,1,4,1,1,2,0,1,3,0,Commerce,Masters,31-35,11,0,0,Flexible,Tier1_City,1,5,4,1,2,1,3,43.46,Finance,2,4,3,4,0,0,5,5,4,2,0,0,3,5,56.71
Biology,Forensic Psychologist,3.609086011677549,1,2,1,0,2,1,1,0,0,1,3,0,0,1,Science,Bachelors,36-40,1,0,0,Hybrid,Tier3_City,4,3,0,2,3,0,4,32.34,Finance,1,3,4,4,2,3,4,4,4,1,1,0,3,1,33.94
Chemistry,Graphic Designer,4.866729898336494,3,1,2,1,9,0,1,2,4,2,2,4,4,0,Science,Masters,18-24,11,0,0,Flexible,Tier2_City,3,5,3,5,0,4,4,44.11,Other,2,2,3,2,3,2,5,1,4,3,1,1,5,2,61.76
Chemistry,Market Research Analyst,2.747318879146043,0,0,3,0,8,1,2,3,2,2,2,3,0,1,Science,Masters,18-24,7,0,0,Hybrid,Tier2_City,3,3,5,3,2,2,2,17.23,Education,1,4,4,5,1,3,4,3,2,2,0,0,2,5,58.83
Marketing,Social Media Manager,2.717753046154035,1,0,0,1,8,0,2,2,0,3,1,4,3,0,Commerce,Masters,31-35,14,1,54,Hybrid,Tier1_City,5,3,2,3,3,0,4,9.21,Tech,1,3,1,2,3,3,2,5,4,1,1,1,3,3,59.35
Chemistry,Teacher,4.553596598247568,7,0,3,0,2,0,4,3,4,3,1,0,2,0,Science,Bachelors,25-30,6,1,55,Hybrid,Tier1_City,4,2,2,3,5,0,5,41.52,Other,2,2,5,2,5,0,3,5,3,1,0,1,1,1,55.94
Art,Biotechnologist,4.480759524314577,2,1,0,0,1,1,4,2,0,4,1,1,4,0,Arts,High School,25-30,2,0,0,Remote,Tier1_City,3,4,1,3,5,3,5,20.98,Healthcare,3,3,4,4,0,3,5,2,5,2,0,1,4,3,46.32
Marketing,Artist,3.3043615950727245,7,1,4,0,6,1,1,4,3,4,1,2,4,0,Commerce,Bachelors,25-30,12,1,33,Hybrid,Tier2_City,1,4,2,2,0,0,3,33.6,Education,1,5,3,3,0,2,2,1,4,2,1,0,3,4,57.49
Finance,Curriculum Developer,4.089385649689982,4,1,0,0,7,0,1,3,2,0,4,2,1,0,Commerce,PhD,25-30,3,0,0,Flexible,Tier3_City,5,3,0,4,3,2,1,37.65,Manufacturing,2,2,1,3,5,0,5,2,4,5,1,0,3,4,64.17
Medicine,Construction Manager,4.152942277434062,7,0,4,0,4,0,1,0,0,3,3,3,0,1,Science,Masters,25-30,12,1,25,Office,Tier3_City,1,4,3,5,5,1,3,18.36,Finance,4,5,4,5,0,5,3,1,3,5,1,0,3,3,66.82
Medicine,Chemist,4.857015788022702,4,2,2,0,8,1,3,3,0,2,2,2,4,0,Science,Masters,25-30,6,0,0,Office,Tier1_City,3,5,2,1,0,5,1,26.74,Healthcare,4,2,3,3,5,0,1,4,5,4,1,1,4,5,60.67
Law,Doctor,2.817907602438942,8,1,1,1,4,1,1,3,2,1,2,1,0,0,Arts,Masters,25-30,3,0,0,Hybrid,Any,5,3,4,4,4,3,3,45.06,Manufacturing,5,5,4,4,5,0,3,4,4,1,1,1,5,4,46.89
Medicine,Microbiologist,2.7384226086822667,8,1,4,1,7,1,3,0,0,0,0,3,1,1,Science,Masters,31-35,8,0,0,Hybrid,Tier1_City,4,3,4,3,0,2,3,44.35,Tech,1,1,4,3,5,4,2,2,4,4,1,0,2,3,51.27
Computer Science,Market Research Analyst,4.756013708608209,0,1,0,1,2,1,2,4,2,1,2,1,1,0,Science,Bachelors,25-30,6,0,0,Remote,Tier1_City,2,1,5,4,1,2,5,38.22,Healthcare,1,5,2,1,2,1,3,2,4,5,0,1,2,2,55.05
Education,Accountant,3.0590053545051807,5,2,0,1,5,0,2,2,4,3,0,4,1,0,Arts,PhD,25-30,0,0,0,Remote,Tier3_City,4,5,5,5,4,2,1,38.85,Education,4,1,3,5,2,3,2,1,3,1,0,1,2,1,50.84
Education,Art Therapist,2.7955168573755884,5,2,3,1,2,1,1,0,4,0,4,4,4,1,Arts,Bachelors,18-24,0,0,0,Remote,Tier1_City,4,4,3,1,3,4,2,45.19,Other,1,3,5,3,4,4,3,1,5,2,0,0,2,4,49.8
Marketing,Clinical Psychologist,4.516587709818074,5,0,4,0,0,0,1,0,0,1,2,2,4,1,Commerce,Bachelors,25-30,14,0,0,Office,Tier3_City,1,4,4,1,4,4,2,37.61,Manufacturing,1,4,4,3,0,3,5,2,1,1,0,1,2,2,41.9
Art,Data Scientist,4.7229785586251465,3,2,0,0,4,1,1,0,3,2,1,3,0,0,Arts,Bachelors,31-35,3,0,0,Office,Tier1_City,4,1,4,5,4,1,3,18.96,Healthcare,4,4,1,1,3,2,3,2,5,2,1,0,1,4,47.36
Law,Analytical Chemist,4.174600786400377,4,1,4,1,0,1,4,0,1,4,2,2,0,1,Arts,High School,31-35,13,0,0,Remote,Tier1_City,2,5,5,5,3,2,3,8.68,Other,2,4,3,2,0,5,3,5,3,3,1,0,5,1,56.71
Law,Biologist,4.768519433598878,9,1,2,1,8,0,2,3,2,4,3,0,2,0,Arts,Bachelors,31-35,13,1,22,Remote,Tier2_City,5,2,2,3,3,4,5,22.83,Other,4,1,5,4,1,1,4,3,5,2,0,1,5,2,65.0
Physics,Game Developer,3.2582719361383807,8,1,1,1,5,1,4,2,3,0,2,1,1,0,Science,Masters,18-24,12,0,0,Hybrid,Tier1_City,5,2,4,1,5,4,1,7.11,Other,3,4,3,3,2,3,3,2,4,1,1,1,3,4,62.28
Marketing,Art Director,4.34366110748132,3,0,2,1,0,0,1,3,0,4,2,2,1,0,Commerce,Bachelors,25-30,8,0,0,Remote,Tier1_City,2,5,2,4,1,4,3,8.44,Education,4,4,5,1,0,3,5,1,3,5,1,0,4,1,54.12
Computer Science,Social Media Manager,4.667283134080658,5,0,4,1,9,1,3,1,0,2,0,1,1,1,Science,Masters,25-30,12,0,0,Hybrid,Tier2_City,1,4,0,2,3,1,2,47.66,Finance,4,5,5,1,4,1,2,5,3,2,0,0,2,3,52.09
Physics,Risk Analyst,4.759313708526903,0,2,4,0,7,0,2,0,4,4,2,4,2,0,Science,Bachelors,25-30,3,1,33,Remote,Tier1_City,2,2,1,2,2,1,1,34.77,Healthcare,2,4,4,2,0,2,1,4,5,4,0,0,2,5,54.95
Biology,Acoustics Specialist,3.461365807565815,3,2,0,1,7,1,1,1,4,1,1,3,3,1,Science,Bachelors,25-30,12,0,0,Hybrid,Tier3_City,5,2,5,5,2,2,3,43.03,Other,4,1,2,3,4,2,1,4,5,3,0,0,5,5,61.66
Education,Pharmacist,3.203311159787905,6,0,0,1,1,0,1,2,1,0,2,2,1,1,Arts,Bachelors,25-30,4,1,50,Flexible,Tier3_City,2,4,2,3,1,3,1,33.22,Finance,4,5,3,2,2,3,1,4,2,3,1,0,5,3,36.89
Physics,Quantum Physicist,4.929637110397117,9,0,3,1,9,1,1,1,3,0,3,3,2,0,Science,Bachelors,25-30,0,0,0,Hybrid,Tier2_City,1,5,1,2,0,2,5,22.67,Other,2,1,1,5,2,1,1,5,5,2,1,1,4,4,42.43
Medicine,Architect,3.5183062568061656,2,0,4,0,0,1,2,0,2,2,0,0,1,0,Science,Masters,31-35,14,0,0,Office,Tier1_City,4,1,2,1,0,4,2,4.18,Manufacturing,4,2,1,1,4,0,2,2,5,4,0,1,4,5,53.12
Physics,Biomedical Engineer,2.536558980853718,9,0,4,0,2,0,4,0,4,2,1,1,0,1,Science,Bachelors,18-24,13,0,0,Hybrid,Tier2_City,4,5,2,5,2,5,1,47.92,Manufacturing,2,4,2,4,5,0,2,3,4,4,0,1,4,4,66.14
Chemistry,Nuclear Physicist,3.4662535707766247,2,0,1,1,9,0,4,1,0,1,4,4,1,1,Science,Masters,31-35,1,0,0,Hybrid,Tier3_City,5,1,3,4,3,4,2,6.33,Manufacturing,3,1,1,1,1,5,1,4,1,1,0,0,2,3,42.86
Finance,Digital Marketing Specialist,3.4800778868775826,2,2,3,0,5,1,2,1,3,4,3,1,4,0,Commerce,Bachelors,18-24,10,0,0,Office,Tier1_City,1,5,2,5,1,0,3,31.68,Finance,2,1,3,2,5,4,3,2,1,3,0,0,5,4,57.32
Finance,Legal Analyst,2.595387400839292,0,0,0,1,8,1,3,0,4,0,1,4,4,1,Commerce,Masters,18-24,3,0,0,Hybrid,Tier1_City,4,2,4,4,0,5,4,7.8,Finance,1,5,1,4,5,5,3,4,1,2,0,1,1,3,41.66
Chemistry,Physical Chemist,3.2662602292602942,2,1,0,1,3,1,1,2,2,4,2,1,3,1,Science,PhD,40+,11,0,0,Remote,Tier3_City,4,3,4,5,0,5,1,16.35,Other,1,2,3,4,2,1,4,4,5,4,1,0,4,2,71.89
Architecture,Teacher,3.5313730571655166,4,0,3,1,6,1,2,0,3,3,2,2,4,1,Interdisciplinary,Masters,40+,3,1,34,Remote,Tier2_City,4,3,2,5,4,2,2,11.73,Education,2,2,5,1,4,2,2,4,1,2,0,1,4,5,43.03
Computer Science,Risk Analyst,4.389946181499596,5,0,4,1,2,1,0,2,2,4,3,1,1,1,Science,Bachelors,18-24,10,0,0,Office,Tier2_City,3,4,5,5,2,4,1,29.02,Healthcare,4,4,4,4,2,4,4,1,2,1,0,1,5,5,48.7
Engineering,Construction Manager,3.267686371373522,7,2,4,0,4,0,2,1,3,4,4,2,3,0,Science,High School,25-30,9,0,0,Hybrid,Tier1_City,4,5,5,4,3,4,3,44.69,Education,5,3,2,3,0,2,5,5,3,2,1,1,1,5,55.3
Architecture,Mechanical Engineer,3.674501745995192,1,1,0,1,5,0,3,0,1,0,1,4,2,1,Interdisciplinary,Bachelors,18-24,5,0,0,Hybrid,Tier3_City,3,5,5,4,1,3,3,32.87,Finance,5,3,2,1,3,4,2,5,2,2,1,1,2,2,36.44
Education,Special Education Teacher,4.620748029991665,0,1,1,0,7,1,1,1,4,1,2,2,2,0,Arts,Masters,25-30,12,0,0,Remote,Tier1_City,2,4,0,5,0,0,2,34.22,Healthcare,3,5,1,2,1,2,1,1,2,4,0,0,2,1,58.4
Education,Chemist,4.055350498078875,5,2,1,1,6,1,1,2,3,0,4,1,3,1,Arts,Bachelors,36-40,5,0,0,Remote,Any,5,4,4,2,4,2,5,45.72,Manufacturing,3,4,3,5,3,3,1,4,1,4,0,1,1,5,52.11
Business,Software Developer,4.503297717249241,3,1,1,1,3,1,4,2,0,2,4,1,2,0,Commerce,Bachelors,40+,7,1,22,Office,Tier1_City,5,1,1,3,2,1,1,38.22,Education,5,5,4,2,1,2,4,5,1,4,1,0,2,4,50.72
Medicine,Teacher,4.147139364210368,0,1,3,1,7,0,3,2,3,0,1,3,3,0,Science,Masters,31-35,11,1,16,Office,Any,3,1,0,3,2,2,1,43.7,Education,5,4,1,3,0,1,2,5,2,5,1,0,2,5,61.28
Computer Science,Judge,4.484395864711654,5,0,0,1,7,1,1,1,1,1,0,4,2,0,Science,Bachelors,25-30,12,0,0,Hybrid,Tier1_City,1,3,1,3,1,5,3,22.57,Education,2,2,4,5,4,4,3,5,2,1,0,1,4,3,44.49
Chemistry,Financial Analyst,4.937223200307527,1,1,0,0,6,0,3,1,0,4,1,4,2,1,Science,Masters,31-35,8,1,59,Remote,Tier2_City,3,2,2,4,0,2,1,43.67,Finance,5,3,3,5,5,0,2,4,2,4,0,0,3,2,60.96
Computer Science,Education Administrator,4.208984928598337,0,0,3,0,2,1,4,2,3,1,3,3,0,0,Science,Bachelors,25-30,13,0,0,Flexible,Tier3_City,4,5,2,4,1,3,2,33.36,Healthcare,1,1,1,2,4,3,4,4,2,5,0,0,5,1,62.48
Law,Special Education Teacher,3.189581753121999,5,0,0,0,0,1,0,4,1,3,2,1,0,0,Arts,Bachelors,36-40,0,0,0,Hybrid,Tier1_City,1,3,2,2,1,2,4,9.37,Manufacturing,3,3,1,1,4,5,4,5,2,1,0,1,4,5,31.62
Business,Physicist,3.2737821981254807,6,2,2,0,3,0,3,0,4,3,0,2,1,0,Commerce,Masters,36-40,0,0,0,Office,Tier1_City,5,3,4,3,5,3,3,4.82,Finance,3,4,4,1,0,2,1,3,5,1,0,0,5,2,46.18
Chemistry,Quantum Physicist,2.662792171604535,2,0,3,0,7,1,3,1,4,2,2,3,4,0,Science,Bachelors,25-30,14,0,0,Remote,Any,2,2,5,3,4,5,4,14.47,Manufacturing,1,3,1,5,5,0,1,2,2,3,0,0,3,5,65.83
Biology,Illustrator,3.38832299997745,2,2,0,1,0,1,2,3,2,4,1,2,3,0,Science,Masters,25-30,5,0,0,Hybrid,Tier1_City,2,3,0,5,2,3,1,20.78,Tech,3,1,4,2,3,5,5,2,3,4,1,1,5,4,56.79
Engineering,Acoustics Specialist,2.8912785140802435,0,1,0,1,7,0,0,4,3,0,0,3,4,0,Science,Bachelors,25-30,3,0,0,Flexible,Tier3_City,3,3,1,4,5,4,5,42.37,Tech,5,2,3,2,2,5,4,4,1,3,0,0,1,5,41.75
Chemistry,Legal Consultant,3.064938370636668,5,2,4,0,1,0,3,4,2,1,0,2,2,0,Science,Bachelors,18-24,10,0,0,Hybrid,Tier1_City,3,2,3,3,3,1,2,37.84,Manufacturing,3,2,4,1,5,5,5,3,3,5,0,1,4,5,56.81
Business,Biochemist,4.789893501231424,6,0,1,1,9,0,1,0,3,3,4,2,0,1,Commerce,Masters,36-40,3,1,39,Office,Tier2_City,3,3,5,2,2,5,1,47.9,Tech,1,4,3,3,5,4,5,3,4,5,1,1,4,2,59.75
Architecture,Risk Analyst,4.94781119943366,7,2,1,0,3,0,2,4,1,1,0,4,2,0,Interdisciplinary,Masters,25-30,0,0,0,Office,Tier1_City,3,5,0,2,2,3,2,29.28,Healthcare,3,3,3,1,4,3,1,3,1,5,0,1,3,4,41.11
Physics,Physical Chemist,3.3253413310836786,6,2,0,0,9,0,2,3,2,1,1,3,0,0,Science,Masters,25-30,8,1,59,Remote,Tier3_City,5,4,1,3,4,0,1,38.14,Healthcare,5,4,5,1,2,5,3,1,3,2,0,0,1,3,56.2
Architecture,Curriculum Developer,2.82498578144011,7,1,4,1,4,0,3,3,4,3,3,4,1,1,Interdisciplinary,Bachelors,25-30,11,0,0,Office,Tier1_City,4,2,3,4,3,5,1,15.94,Finance,2,3,4,3,3,3,1,1,2,1,1,0,2,3,63.18
Education,Geneticist,4.120420717072838,4,1,3,0,5,0,0,1,0,0,1,0,0,1,Arts,Masters,36-40,10,0,0,Remote,Tier2_City,5,4,0,2,0,0,1,34.94,Manufacturing,5,5,2,1,2,3,2,5,2,2,1,0,3,5,37.09
Medicine,Illustrator,2.727504598539784,4,2,1,0,2,1,1,4,4,1,0,4,3,1,Science,Bachelors,18-24,2,1,26,Office,Tier1_City,2,5,0,5,3,1,3,36.19,Finance,3,4,5,5,2,5,3,3,1,4,0,1,5,2,47.19
Physics,Urban Planner,2.7119473165728367,4,1,3,1,9,1,0,0,2,2,1,2,2,1,Science,Bachelors,36-40,14,0,0,Flexible,Tier2_City,2,3,5,2,0,3,4,42.88,Healthcare,4,3,5,5,5,0,4,2,5,3,0,1,3,2,51.2
Law,Physical Chemist,2.528523571198716,0,0,0,1,4,0,4,4,0,3,4,3,4,1,Arts,PhD,36-40,4,0,0,Flexible,Tier1_City,2,3,2,1,3,5,5,28.21,Healthcare,3,5,4,5,2,5,3,1,2,2,0,1,1,2,60.63
Chemistry,Legal Secretary,4.870025577325906,8,0,3,1,1,0,1,2,2,4,4,3,3,0,Science,Bachelors,36-40,9,0,0,Office,Tier1_City,4,3,5,1,1,5,4,33.5,Healthcare,3,4,5,5,0,4,4,4,3,5,1,0,4,5,63.62
Computer Science,Analytical Chemist,3.971531342213607,8,0,4,0,2,1,3,0,3,2,1,1,3,1,Science,PhD,25-30,0,0,0,Hybrid,Tier2_City,4,4,0,4,3,1,4,12.54,Education,1,2,5,5,3,2,4,4,1,3,1,1,5,4,47.46
Psychology,School Counselor,3.240756992966422,0,2,2,1,9,1,3,4,4,3,2,2,2,1,Arts,Bachelors,18-24,7,0,0,Office,Tier1_City,1,1,5,3,5,4,2,37.63,Tech,4,5,1,2,2,4,5,3,5,5,0,1,2,4,69.93
Art,Electrical Engineer,3.604934898906684,2,0,4,1,8,1,1,0,3,1,2,2,3,1,Arts,Bachelors,25-30,2,0,0,Office,Any,4,4,5,4,5,0,3,42.41,Finance,1,4,3,2,4,3,2,5,2,1,1,0,2,5,40.01
Finance,Surgeon,3.780897887445323,6,2,4,1,7,1,0,4,3,3,4,3,4,0,Commerce,Bachelors,25-30,13,1,20,Remote,Tier3_City,2,1,5,4,4,5,3,30.91,Finance,1,1,2,3,4,4,1,3,5,5,1,0,2,2,75.59
Architecture,Industrial-Organizational Psychologist,4.798995437819756,3,2,1,0,8,0,2,2,4,0,2,4,2,1,Interdisciplinary,Masters,18-24,14,0,0,Remote,Tier2_City,4,4,1,4,0,2,1,8.44,Healthcare,5,2,4,4,5,2,5,4,3,5,1,0,1,3,66.15
Computer Science,Microbiologist,4.796985528704143,5,2,4,0,0,1,2,1,0,0,0,1,2,0,Science,Masters,31-35,0,0,0,Hybrid,Tier1_City,4,5,2,4,2,0,4,17.7,Education,2,5,1,5,3,5,5,4,1,1,1,1,4,4,28.18
Finance,Biologist,3.4926223820612803,0,1,0,1,4,1,3,4,4,2,0,4,3,1,Commerce,Masters,25-30,9,0,0,Remote,Tier2_City,4,4,0,5,4,3,5,25.35,Finance,3,3,2,4,5,5,2,5,2,4,1,0,4,5,70.63
Art,Actuary,4.763231544129482,3,0,4,0,4,0,1,4,4,3,1,4,4,1,Arts,Masters,36-40,5,0,0,Flexible,Tier1_City,3,4,2,5,5,1,2,34.83,Other,4,1,2,4,0,5,1,1,5,4,1,0,3,4,67.38
Engineering,Teacher,2.554336864641088,8,1,2,0,0,0,3,0,4,4,3,4,0,1,Science,Masters,18-24,0,0,0,Hybrid,Tier3_City,4,2,3,2,5,0,3,18.06,Finance,3,3,1,5,2,4,5,5,1,2,0,1,1,2,52.01
Education,Analytical Chemist,4.316011679678327,3,2,2,0,0,1,0,3,1,4,4,2,0,0,Arts,Masters,31-35,14,0,0,Remote,Tier1_City,3,3,1,1,0,2,1,42.49,Education,1,1,4,1,0,5,3,2,3,1,0,1,1,5,54.11
Physics,Art Therapist,3.471286441756192,6,1,0,1,7,0,0,4,1,4,3,1,4,1,Science,Bachelors,31-35,14,0,0,Hybrid,Tier1_City,2,3,3,4,5,2,5,20.47,Healthcare,2,4,3,3,3,5,1,4,1,4,1,0,5,1,58.55
Physics,Musician,2.928799048220838,3,2,4,0,1,1,2,0,0,4,3,0,4,1,Science,Bachelors,31-35,2,1,38,Flexible,Tier1_City,1,3,1,2,5,1,4,5.01,Education,1,4,1,4,1,5,2,2,2,1,1,1,2,3,36.6
Medicine,Entrepreneur,2.680844611179962,1,0,3,1,4,1,1,2,0,0,0,2,0,0,Science,Bachelors,36-40,4,0,0,Flexible,Any,5,1,4,1,0,1,5,40.32,Tech,3,3,5,1,4,3,3,4,4,3,1,0,2,3,34.97
Business,Biochemist,4.584543536565134,7,2,0,0,4,1,4,1,0,3,4,4,0,1,Commerce,PhD,31-35,3,1,17,Remote,Tier3_City,1,5,3,3,5,0,3,33.28,Finance,5,3,2,1,2,3,3,4,1,4,1,1,3,3,57.01
Art,Entrepreneur,3.0928594784487133,8,1,2,1,7,0,2,1,0,2,0,1,2,0,Arts,PhD,36-40,6,0,0,Office,Tier1_City,5,1,4,5,2,3,2,40.69,Tech,3,3,5,5,2,2,5,3,2,5,1,1,2,5,55.61
Marketing,Electrical Engineer,4.644254172160842,3,1,0,1,1,1,2,3,4,4,3,1,0,0,Commerce,High School,25-30,5,0,0,Hybrid,Any,2,2,5,1,1,4,4,19.4,Finance,1,5,4,3,3,1,2,4,5,2,0,0,2,1,56.86
Architecture,Surgeon,4.938480643714279,1,2,4,0,9,1,1,0,0,0,3,0,0,0,Interdisciplinary,Masters,25-30,11,0,0,Hybrid,Tier1_City,3,2,2,3,4,2,2,3.83,Tech,4,2,3,5,3,4,2,4,1,4,0,1,2,1,53.33
Education,Art Director,4.375435889713956,1,0,3,1,5,0,0,2,1,3,3,0,1,0,Arts,PhD,18-24,2,1,10,Office,Tier3_City,4,4,3,1,2,1,5,6.47,Finance,4,3,3,3,5,3,5,4,1,4,0,1,4,2,43.74
Finance,Legal Consultant,3.1168910632818965,6,1,1,1,4,0,4,0,2,3,3,4,4,1,Commerce,Bachelors,18-24,10,0,0,Remote,Tier2_City,3,2,0,5,2,4,5,8.25,Other,4,4,3,5,5,5,1,4,4,3,0,1,3,1,68.38
Music,Legal Secretary,2.917053147293722,0,0,4,0,6,0,4,3,1,1,3,4,4,1,Arts,Masters,18-24,7,1,56,Hybrid,Tier3_City,5,2,5,5,1,4,1,40.84,Healthcare,4,4,5,3,5,4,4,3,4,1,0,1,2,1,59.32
Engineering,Conductor,2.581618257359928,0,2,1,1,0,1,2,3,1,1,0,4,4,0,Science,PhD,18-24,7,1,19,Hybrid,Tier1_City,4,5,1,2,4,4,4,17.17,Other,4,3,4,2,0,2,5,3,4,5,1,0,1,1,66.6
Business,Credit Analyst,4.981691333247512,3,0,2,1,6,1,4,3,1,1,4,4,0,1,Commerce,High School,25-30,13,1,34,Remote,Tier2_City,5,2,0,4,2,3,5,49.9,Manufacturing,2,3,5,1,5,0,3,2,4,5,1,0,1,2,64.04
Business,Composer,4.726030938544065,7,0,2,1,3,0,4,1,3,1,3,0,3,1,Commerce,Masters,18-24,1,0,0,Remote,Tier2_City,5,4,0,1,5,1,3,38.64,Education,2,4,2,1,4,0,4,2,2,3,1,0,1,5,50.8
Music,Physicist,3.5861364254303814,7,2,1,1,8,0,3,2,2,3,0,1,2,1,Arts,Bachelors,18-24,6,1,6,Remote,Tier1_City,4,3,5,1,1,2,3,31.25,Finance,5,5,3,1,0,5,1,2,4,1,0,1,5,5,46.14
Physics,Zoologist,3.629015713324544,2,0,2,0,8,1,2,1,0,3,3,4,1,1,Science,PhD,36-40,13,1,18,Hybrid,Tier1_City,1,1,2,3,4,1,2,49.23,Education,4,1,4,3,3,5,1,5,4,2,1,1,1,5,65.55
Computer Science,Cybersecurity Analyst,2.806457746658028,0,2,3,0,7,1,1,1,3,2,4,4,4,0,Science,PhD,18-24,0,0,0,Remote,Tier3_City,1,1,2,5,3,0,3,17.87,Finance,1,4,5,1,4,3,1,3,3,1,1,1,2,4,50.1
Business,Construction Manager,4.586628894200354,7,0,0,0,5,0,1,2,4,0,4,2,3,0,Commerce,PhD,31-35,1,1,37,Hybrid,Tier2_City,5,1,0,1,0,2,5,10.78,Manufacturing,1,1,5,2,3,2,4,3,4,5,1,0,1,2,56.61
Computer Science,Judge,3.6530824522131646,3,1,2,1,9,0,1,4,3,3,2,0,0,0,Science,Bachelors,18-24,7,1,39,Hybrid,Tier2_City,2,4,5,5,5,1,3,37.65,Healthcare,3,3,5,2,5,2,5,1,2,2,1,0,1,5,53.16
Computer Science,Nurse,4.095323992517207,4,1,4,1,7,0,0,3,1,3,3,4,4,0,Science,Masters,36-40,11,0,0,Flexible,Tier1_City,3,5,0,1,1,2,4,16.07,Healthcare,4,2,5,4,0,4,2,1,2,5,0,1,3,5,63.67
Music,Animator,4.391906865685615,0,1,2,0,1,0,3,4,3,2,0,3,2,1,Arts,Masters,36-40,0,0,0,Hybrid,Tier1_City,1,4,0,2,0,0,2,48.17,Education,1,3,5,1,5,3,5,1,2,4,0,0,5,5,42.58
Law,Curriculum Developer,4.247176840231395,5,1,4,0,3,1,2,0,0,2,4,1,0,1,Arts,Bachelors,31-35,1,0,0,Flexible,Tier3_City,4,1,1,4,3,5,4,49.44,Other,5,3,2,5,0,0,5,2,5,5,1,0,2,1,50.08
Education,Financial Analyst,4.948669533882208,0,0,2,0,6,1,0,4,1,0,1,3,0,0,Arts,Masters,31-35,11,0,0,Remote,Tier3_City,5,4,2,1,2,2,5,46.54,Manufacturing,1,3,3,5,0,2,4,4,5,3,0,1,4,3,62.28
Biology,Architect,3.932554587600484,5,2,4,0,5,1,3,4,2,1,4,3,1,1,Science,High School,18-24,0,0,0,Office,Tier3_City,3,4,3,5,2,5,5,47.4,Education,5,4,5,5,1,5,3,5,3,4,0,1,2,3,47.56
Art,Risk Analyst,4.007306671599531,2,0,3,1,7,1,4,2,1,0,4,1,4,0,Arts,Masters,40+,4,0,0,Remote,Tier3_City,3,4,2,2,4,4,3,31.94,Healthcare,4,4,2,2,0,2,4,3,5,1,0,0,3,3,56.63
Music,Advertising Manager,3.786483501689104,7,2,4,1,4,0,2,0,0,3,1,1,3,0,Arts,Bachelors,36-40,6,0,0,Office,Tier3_City,5,3,0,1,1,3,1,35.53,Tech,3,2,4,4,2,0,3,2,3,4,0,0,2,5,44.52
Education,Sound Engineer,2.8512034805864164,3,2,0,1,9,1,3,1,4,3,4,0,1,1,Arts,Bachelors,36-40,5,0,0,Hybrid,Tier1_City,3,4,3,3,1,0,1,7.43,Education,3,1,4,4,0,4,4,5,5,1,0,0,2,1,55.87
Art,Doctor,3.3429190267164315,8,0,4,1,2,0,2,0,4,0,0,3,4,0,Arts,Bachelors,31-35,5,1,20,Hybrid,Tier1_City,2,5,5,4,4,2,5,38.86,Finance,2,1,2,2,5,4,3,3,1,1,1,0,4,2,36.41
Finance,Electrical Engineer,4.049373510458565,7,0,0,1,8,0,2,3,1,0,3,3,0,0,Commerce,Masters,25-30,5,0,0,Hybrid,Tier3_City,5,3,5,1,0,0,5,12.5,Healthcare,4,1,2,4,3,4,2,5,3,3,0,0,3,2,49.4
Business,Zoologist,4.935798893080337,8,2,3,1,1,1,2,3,1,3,1,2,2,1,Commerce,Bachelors,36-40,7,1,11,Remote,Tier1_City,3,4,3,2,2,4,2,42.5,Finance,1,3,2,5,5,4,2,5,5,2,0,0,3,3,55.81
Physics,Biochemist,3.7799347986973815,2,0,2,0,0,0,3,4,3,0,2,4,0,1,Science,Masters,25-30,4,0,0,Office,Any,3,2,3,3,2,5,5,48.19,Manufacturing,3,2,4,5,0,3,1,3,1,5,1,0,2,5,59.42
Art,Lawyer,3.898200490122632,7,2,2,0,4,0,4,1,0,1,3,1,1,0,Arts,Bachelors,25-30,14,1,42,Flexible,Any,1,1,2,2,1,3,5,12.98,Other,5,3,5,2,3,4,1,5,3,4,0,0,2,2,57.9
Biology,Dentist,4.5386454362120245,3,1,3,1,2,0,2,0,0,0,2,2,0,0,Science,Bachelors,18-24,9,1,24,Remote,Tier2_City,3,3,0,2,1,0,2,6.67,Other,5,2,3,5,3,4,3,1,3,3,0,1,5,4,50.11
Medicine,Entrepreneur,3.955668205807216,8,2,0,1,6,0,0,3,0,1,4,3,0,0,Science,Bachelors,36-40,6,0,0,Flexible,Tier1_City,3,2,5,3,4,5,4,25.74,Healthcare,1,5,5,3,5,3,5,1,1,3,1,1,4,2,48.13
Art,Special Education Teacher,4.031630636761664,8,0,3,1,6,0,4,3,4,0,2,2,3,0,Arts,Masters,18-24,2,0,0,Remote,Tier2_City,1,1,5,2,3,4,4,40.2,Healthcare,1,4,1,5,4,2,1,5,3,4,0,0,1,5,60.01
Biology,Investment Banker,3.054666635101816,1,0,1,1,6,1,0,2,3,3,4,4,3,0,Science,Bachelors,18-24,8,0,0,Office,Tier3_City,5,5,5,3,0,4,2,39.22,Other,4,3,2,1,1,1,4,2,1,2,0,1,1,2,52.09
Architecture,Forensic Psychologist,3.4553384127880897,5,0,3,1,9,1,4,2,4,1,3,1,2,0,Interdisciplinary,Masters,25-30,9,1,44,Flexible,Tier3_City,1,2,0,1,5,4,2,35.75,Education,1,5,5,2,3,4,2,4,1,5,1,0,5,5,69.44
Psychology,Inorganic Chemist,3.1107039902242555,9,1,2,0,3,0,2,4,0,4,2,0,3,1,Arts,Masters,31-35,2,1,23,Remote,Tier1_City,4,5,4,3,3,5,4,41.57,Other,1,1,3,2,3,1,1,3,3,3,0,1,1,1,45.51
Marketing,Brand Manager,4.241486378420352,7,2,0,0,5,1,3,4,4,4,0,2,0,1,Commerce,Masters,31-35,13,0,0,Hybrid,Tier3_City,4,5,1,3,3,2,4,11.22,Other,1,5,5,4,2,5,1,2,3,1,1,0,3,2,64.3
Psychology,Manager,4.922362672162327,9,1,1,0,1,0,0,1,0,3,3,0,3,1,Arts,Bachelors,18-24,13,0,0,Hybrid,Tier2_City,2,2,2,4,1,1,4,33.64,Education,3,4,1,4,0,0,1,4,4,2,1,0,2,2,47.79
Engineering,Financial Advisor,3.6366631308976376,9,1,3,1,7,0,0,0,0,2,0,1,3,0,Science,High School,18-24,5,0,0,Hybrid,Tier1_City,3,2,5,3,1,0,4,31.47,Finance,4,4,1,4,1,1,4,3,4,5,1,0,1,3,39.02
Finance,Counselor,3.7214700734803015,0,2,4,1,9,1,1,3,4,3,0,0,2,1,Commerce,Masters,31-35,2,0,0,Office,Tier1_City,4,3,4,3,1,1,3,10.21,Education,1,4,5,1,1,0,4,4,2,4,1,0,2,5,46.21
Biology,Market Research Analyst,4.346917236961016,2,1,1,0,5,1,2,4,3,0,3,1,3,1,Science,High School,40+,0,1,17,Office,Tier2_City,5,5,4,1,3,4,2,22.48,Tech,1,5,3,5,5,1,1,3,2,3,1,0,4,1,44.02
Education,Biologist,2.819545374409445,7,0,2,1,1,1,2,2,0,4,4,3,2,1,Arts,Masters,36-40,0,0,0,Flexible,Tier1_City,5,2,5,4,0,1,1,43.07,Healthcare,5,1,5,2,4,4,5,1,1,5,0,1,5,1,49.47
Physics,Acoustics Specialist,3.1222413093351955,6,0,4,1,2,1,0,2,2,3,0,0,0,0,Science,Bachelors,25-30,2,1,11,Remote,Tier1_City,4,5,4,5,1,5,3,48.67,Other,3,3,2,5,3,5,5,2,3,3,0,1,2,3,40.26
Finance,Landscape Architect,2.937337403191888,0,2,2,1,0,1,0,0,4,4,0,2,2,1,Commerce,PhD,36-40,3,1,31,Hybrid,Tier1_City,1,4,2,1,2,4,1,34.28,Manufacturing,1,1,3,4,3,1,4,4,1,5,0,1,3,5,50.71
Education,Financial Advisor,2.575535487313698,7,2,0,1,2,1,3,3,4,4,2,0,4,0,Arts,Masters,25-30,13,1,21,Hybrid,Any,2,4,1,1,0,4,1,46.33,Healthcare,3,2,4,2,2,2,4,1,4,1,1,1,3,3,60.21
Psychology,Physician Assistant,3.828403034043177,0,0,3,0,2,1,0,1,2,0,1,3,0,0,Arts,PhD,25-30,1,0,0,Flexible,Tier1_City,1,4,3,5,2,3,5,9.21,Other,4,2,3,4,1,5,2,2,2,5,0,0,4,3,45.14
Law,Forensic Psychologist,2.9920622200850726,7,0,2,1,3,1,3,4,3,3,0,3,3,1,Arts,Bachelors,25-30,8,0,0,Remote,Tier1_City,2,5,1,3,0,3,2,48.83,Finance,4,3,5,1,0,1,5,5,1,1,1,1,2,5,48.19
Education,Curriculum Developer,2.511824599838946,7,0,1,1,5,1,3,3,2,4,1,1,2,0,Arts,Masters,25-30,14,0,0,Flexible,Tier1_City,4,5,1,2,1,5,3,4.57,Other,2,4,5,2,4,0,1,2,3,4,1,0,5,3,64.14
Chemistry,Inorganic Chemist,4.344523675895847,0,1,3,1,9,0,1,4,4,0,2,3,1,1,Science,Bachelors,31-35,10,1,29,Hybrid,Tier3_City,1,2,5,4,5,5,2,27.78,Education,5,3,4,4,4,2,3,2,2,2,1,0,5,2,61.96
Physics,AI Researcher,3.906185315577471,0,0,2,0,7,0,2,1,4,3,1,0,3,0,Science,Bachelors,25-30,7,0,0,Hybrid,Tier3_City,4,2,5,2,4,1,4,16.68,Healthcare,2,5,1,4,4,5,2,1,1,5,0,1,5,5,53.27
Art,Financial Advisor,3.02601054797408,0,1,3,1,9,0,1,1,4,4,0,3,3,0,Arts,Masters,25-30,11,0,0,Hybrid,Tier3_City,2,3,0,5,1,0,2,41.25,Education,3,4,5,4,4,1,2,1,2,3,0,0,3,4,59.97
Marketing,Psychologist,3.739594567061112,3,2,0,1,7,0,2,0,4,0,1,0,4,0,Commerce,Masters,25-30,12,1,12,Flexible,Tier2_City,5,3,4,1,3,1,1,13.22,Other,5,3,1,1,5,0,1,4,3,4,1,1,3,5,58.36
Medicine,Cybersecurity Analyst,3.2578855322889435,5,0,4,0,1,1,1,3,1,2,2,0,4,0,Science,PhD,18-24,2,0,0,Hybrid,Tier2_City,1,3,4,1,5,5,4,3.54,Finance,1,3,1,5,1,5,1,4,2,5,1,0,4,1,52.34
Psychology,Psychologist,4.455116252560357,5,1,3,0,7,1,1,1,1,1,2,2,2,1,Arts,Masters,25-30,6,0,0,Office,Tier2_City,4,1,3,4,3,0,2,22.49,Education,5,5,2,5,3,0,4,5,1,4,0,1,3,2,49.08
Law,Industrial-Organizational Psychologist,4.669420949814125,2,2,4,0,1,0,3,4,2,3,0,0,1,1,Arts,Bachelors,18-24,3,0,0,Hybrid,Tier2_City,2,4,0,1,0,1,2,6.01,Manufacturing,5,5,1,5,1,4,5,1,1,4,0,0,1,2,41.57
Biology,Accountant,3.973450244397176,7,2,1,1,4,1,4,4,2,0,2,1,1,0,Science,Bachelors,18-24,4,0,0,Hybrid,Tier1_City,5,5,3,1,3,2,1,16.63,Other,4,1,3,1,5,0,4,1,2,4,1,0,1,4,50.59
Psychology,Architect,4.2010404491063404,2,1,0,0,5,0,4,1,2,3,2,4,1,1,Arts,Masters,31-35,3,0,0,Remote,Tier2_City,1,4,5,4,5,2,4,33.26,Finance,2,2,1,5,0,5,5,2,3,4,1,0,5,2,60.41
Medicine,Digital Marketing Specialist,2.7115201207416098,5,1,0,0,5,1,4,0,0,1,0,0,0,0,Science,Bachelors,31-35,8,0,0,Office,Tier1_City,2,5,2,4,5,0,1,16.85,Healthcare,4,3,2,5,4,2,5,2,1,3,1,0,4,2,48.09
Education,Graphic Designer,2.914495061131026,2,0,0,1,4,0,2,1,2,4,2,2,4,0,Arts,Bachelors,31-35,10,1,34,Remote,Any,1,1,0,5,1,3,2,14.55,Healthcare,4,1,5,1,5,3,3,5,5,1,1,0,5,2,57.26
Finance,Architectural Technologist,2.6203398850953947,6,2,4,0,1,0,1,2,0,1,3,2,3,1,Commerce,Bachelors,25-30,6,1,20,Office,Tier2_City,1,5,4,1,2,0,3,10.31,Manufacturing,2,4,5,2,1,0,2,2,2,1,1,0,5,4,36.76
Engineering,Aerospace Engineer,4.703496262432697,3,1,3,1,8,0,1,0,0,3,4,0,3,1,Science,Bachelors,36-40,12,0,0,Hybrid,Tier2_City,3,3,3,1,1,1,3,9.35,Tech,4,4,4,4,0,2,3,2,4,3,1,0,3,4,55.49
Business,Data Scientist,4.5429084587669,3,2,3,0,6,1,3,3,4,1,0,3,2,0,Commerce,Bachelors,36-40,3,1,44,Hybrid,Tier2_City,4,4,0,5,0,4,5,27.72,Education,5,2,1,4,2,5,1,4,1,4,1,0,1,4,44.08
Art,Acoustics Specialist,4.393702677107023,0,0,2,1,7,1,1,0,2,1,1,2,0,1,Arts,Bachelors,36-40,12,0,0,Hybrid,Tier3_City,3,4,0,3,3,2,3,35.03,Other,3,4,3,1,4,3,3,5,4,3,0,1,4,2,52.12
Engineering,Construction Manager,3.346532197023659,0,0,2,0,7,0,3,1,4,0,1,2,3,0,Science,High School,31-35,7,0,0,Hybrid,Tier2_City,1,4,1,3,2,4,4,24.28,Healthcare,1,2,4,5,5,1,3,4,4,4,1,0,1,5,55.51
Music,Doctor,4.923891806825883,8,2,3,1,5,0,1,2,1,0,1,1,3,1,Arts,High School,25-30,1,1,51,Office,Tier2_City,2,1,0,3,4,2,5,8.81,Other,1,4,4,3,3,0,2,5,3,4,1,1,3,5,37.78
Education,Inorganic Chemist,2.5958210775896524,6,0,3,1,1,1,3,0,1,1,2,1,1,0,Arts,PhD,40+,6,0,0,Office,Tier1_City,4,4,0,5,5,1,4,33.44,Manufacturing,4,4,2,5,3,4,3,4,3,2,0,0,3,1,56.24
Art,Biomedical Engineer,3.972482298087181,4,0,4,0,3,1,0,0,1,0,0,3,3,1,Arts,Bachelors,25-30,10,0,0,Remote,Tier1_City,2,2,4,1,2,2,3,29.18,Education,2,3,5,3,3,1,2,4,3,1,1,0,2,5,42.42
Music,Quantum Physicist,2.941775388956743,1,0,2,0,4,1,3,0,2,4,1,2,2,1,Arts,Bachelors,18-24,0,0,0,Flexible,Tier1_City,2,3,2,5,2,0,3,20.92,Finance,5,5,1,4,0,4,2,5,2,3,0,1,3,3,41.4
Computer Science,Paralegal,2.7312210785490447,6,1,1,1,0,0,3,4,4,0,3,4,2,0,Science,Masters,25-30,7,0,0,Hybrid,Tier1_City,5,3,3,5,1,4,2,18.51,Other,4,3,1,1,1,2,2,2,4,5,0,1,3,5,71.3
Medicine,Marketing Manager,4.872507111730055,4,0,2,0,7,0,2,1,2,3,0,4,0,0,Science,Bachelors,18-24,12,0,0,Flexible,Any,1,5,2,3,4,5,4,11.61,Manufacturing,5,1,5,5,4,2,2,3,1,4,0,1,1,4,58.18
Chemistry,Inorganic Chemist,3.904989671144024,0,1,4,1,9,0,3,4,3,2,2,1,2,0,Science,PhD,40+,13,1,16,Remote,Tier3_City,2,1,0,2,5,4,1,9.88,Finance,5,5,2,1,4,5,3,1,4,5,0,0,4,3,78.73
Psychology,Sound Engineer,3.333010186112458,8,0,2,0,1,1,1,2,3,1,4,3,3,1,Arts,Masters,25-30,11,0,0,Remote,Tier1_City,1,5,4,1,0,1,2,18.92,Finance,1,3,2,5,5,3,4,5,5,2,0,0,1,2,65.53
Law,Physician Assistant,3.98029655703041,7,0,2,1,3,0,0,3,4,2,1,4,3,1,Arts,Bachelors,25-30,13,1,56,Hybrid,Tier1_City,3,5,4,3,0,5,4,4.96,Finance,3,5,2,5,4,4,4,3,4,1,0,0,1,4,55.21
Music,AI Researcher,4.764128518247135,8,2,2,0,1,1,2,1,1,3,0,3,0,0,Arts,Bachelors,31-35,12,0,0,Hybrid,Tier2_City,3,3,4,2,2,4,5,23.52,Education,3,5,3,5,4,2,1,4,4,4,1,0,2,5,58.51
Marketing,Education Administrator,3.761972557199229,2,2,2,1,7,1,1,3,4,4,3,3,0,1,Commerce,Masters,25-30,14,0,0,Flexible,Tier2_City,2,2,4,2,2,1,4,31.27,Tech,2,5,1,3,2,5,2,2,2,5,1,0,1,2,70.77
Marketing,Art Director,3.906473423032039,8,0,1,0,4,1,0,1,1,0,2,1,2,0,Commerce,PhD,18-24,5,0,0,Remote,Tier3_City,1,1,1,4,3,3,5,47.26,Other,3,4,2,1,5,4,4,4,1,2,0,0,4,1,40.94
Psychology,Artist,3.947110394847004,3,2,3,1,1,1,1,0,1,4,3,3,1,0,Arts,Bachelors,31-35,11,0,0,Remote,Tier2_City,5,1,0,1,4,0,5,32.41,Finance,4,5,2,4,4,2,1,5,5,1,0,1,4,4,60.29
Finance,Credit Analyst,3.307863300731173,6,2,3,0,3,0,4,4,4,1,2,0,0,0,Commerce,Masters,31-35,4,1,29,Remote,Any,4,1,1,2,5,2,3,32.33,Healthcare,1,4,5,2,2,4,3,3,2,5,0,1,2,3,59.29
Computer Science,Biochemist,4.1291711093271815,9,0,3,1,2,0,4,4,1,2,2,0,1,1,Science,Bachelors,25-30,8,0,0,Remote,Tier1_City,3,2,1,3,2,2,1,20.6,Education,1,5,4,3,1,5,1,4,5,3,1,0,1,4,57.42
Architecture,Data Scientist,3.634676809733045,0,1,1,0,3,1,2,0,4,2,1,2,2,0,Interdisciplinary,PhD,31-35,8,0,0,Hybrid,Tier1_City,3,1,0,4,3,2,4,9.27,Education,5,4,4,4,3,3,4,2,4,4,0,1,3,3,66.78
Engineering,Manager,4.940370216268419,8,0,0,0,9,0,2,1,0,1,4,3,1,0,Science,Bachelors,18-24,2,0,0,Hybrid,Any,5,4,4,1,4,3,1,24.01,Finance,4,5,4,1,2,1,1,5,1,2,0,0,3,3,35.1
Education,Acoustics Specialist,2.631316312430138,8,2,4,1,1,1,0,0,1,2,0,4,2,0,Arts,PhD,18-24,8,0,0,Hybrid,Tier1_City,2,2,3,5,5,0,5,31.14,Healthcare,4,1,1,2,3,0,1,5,4,5,1,0,3,1,61.87
Law,Financial Analyst,3.690502195580098,9,0,0,1,0,0,3,1,0,4,3,0,3,1,Arts,Masters,18-24,12,0,0,Remote,Tier1_City,3,5,4,3,0,4,3,37.03,Manufacturing,5,3,3,2,3,2,1,4,2,3,0,1,4,3,55.18
Art,Legal Consultant,4.377193899771748,4,1,3,1,5,0,3,0,2,2,4,3,2,1,Arts,Masters,25-30,14,0,0,Remote,Tier1_City,3,4,4,2,3,4,1,41.83,Education,5,5,1,1,0,5,4,2,1,5,0,1,3,2,61.7
Law,Landscape Architect,3.103720907206285,2,0,1,0,6,1,4,3,1,2,4,2,4,1,Arts,Bachelors,36-40,12,0,0,Remote,Tier2_City,4,5,1,2,4,0,2,15.03,Finance,1,1,5,3,2,5,2,5,5,2,0,1,4,3,69.92
Engineering,Conductor,2.8561172938412422,1,2,2,1,3,0,4,3,1,0,1,1,0,1,Science,Bachelors,36-40,8,0,0,Office,Tier1_City,5,1,2,3,3,5,5,14.34,Other,4,3,2,5,4,5,3,5,1,4,0,0,5,3,52.95
Chemistry,Web Developer,4.740955246370017,1,1,0,0,9,0,4,3,1,2,1,3,1,0,Science,Bachelors,25-30,1,1,41,Office,Any,5,2,4,2,2,0,2,29.57,Finance,3,2,1,5,5,5,2,4,1,1,1,0,2,3,43.0
Art,School Counselor,3.1359795067346226,8,0,0,1,7,0,4,3,0,3,3,1,2,1,Arts,Bachelors,25-30,4,0,0,Office,Any,1,4,0,4,1,2,1,29.6,Other,3,5,4,5,0,5,5,3,2,1,0,1,5,4,43.17
Psychology,Legal Secretary,4.1915466305326845,7,1,4,1,4,1,0,0,2,4,1,3,2,0,Arts,Bachelors,31-35,10,1,36,Flexible,Tier3_City,5,2,0,1,0,4,1,13.24,Other,1,2,3,4,4,4,2,1,2,1,1,1,1,3,47.79
Medicine,AI Researcher,4.086679952485604,0,1,2,0,9,1,1,1,4,2,4,2,2,1,Science,Masters,18-24,1,0,0,Flexible,Tier1_City,4,2,0,4,2,0,1,30.61,Tech,3,3,5,1,5,2,3,2,4,2,1,0,3,4,47.54
Music,Interior Designer,3.1325254494595605,6,0,0,0,4,1,2,4,3,4,2,1,1,1,Arts,Bachelors,18-24,0,0,0,Hybrid,Any,5,2,1,2,2,4,4,19.26,Tech,3,3,2,3,3,2,1,5,1,1,1,0,4,4,39.53
Business,Principal,3.374038566533702,7,0,3,1,3,0,4,4,4,0,0,1,4,1,Commerce,Bachelors,40+,6,0,0,Hybrid,Tier3_City,1,5,3,5,4,0,5,33.05,Manufacturing,4,5,3,1,0,0,2,5,1,4,1,0,4,5,48.71
Art,Human Resources Specialist,4.3333299513450445,1,2,1,0,8,0,0,4,4,2,0,0,0,1,Arts,PhD,31-35,3,0,0,Flexible,Tier1_City,4,2,3,1,3,1,5,16.68,Manufacturing,4,1,1,2,4,3,4,5,3,2,0,1,4,1,46.57
Education,Chemical Engineer,4.674670755735481,5,1,1,0,3,1,0,0,3,2,0,3,2,1,Arts,Masters,40+,4,0,0,Hybrid,Tier1_City,3,1,3,1,0,2,5,30.84,Other,2,5,1,4,4,0,5,3,4,5,1,0,2,1,49.41
Computer Science,Architectural Technologist,4.14589555519949,2,2,4,0,8,1,3,0,4,2,1,3,4,0,Science,PhD,25-30,3,0,0,Remote,Tier2_City,2,4,4,3,2,0,4,39.11,Manufacturing,4,1,3,3,1,1,1,1,3,5,1,1,1,1,61.76
Chemistry,Chemical Engineer,4.375324628043055,9,2,0,0,7,1,0,1,0,0,2,1,3,0,Science,PhD,31-35,5,0,0,Hybrid,Tier3_City,3,3,4,3,4,3,1,49.07,Manufacturing,2,5,3,2,0,1,1,4,2,2,1,1,2,3,44.28
Law,Human Resources Specialist,4.9231639135717735,7,0,1,0,7,0,3,0,3,2,0,1,2,1,Arts,Bachelors,18-24,10,1,19,Flexible,Tier1_City,1,2,2,5,0,0,1,45.82,Finance,4,1,2,5,0,1,1,2,5,4,0,0,3,5,57.33
Business,Microbiologist,4.3487024749315975,2,0,0,0,2,0,4,0,0,1,4,3,1,0,Commerce,Bachelors,25-30,1,1,25,Office,Tier2_City,4,4,2,1,3,1,2,26.67,Finance,5,4,4,5,3,1,2,3,4,2,0,1,5,5,45.12
Physics,Web Developer,3.59153889562661,6,2,4,1,7,0,1,2,0,2,2,1,3,1,Science,Masters,25-30,7,1,59,Remote,Any,3,5,2,5,2,3,4,25.95,Finance,4,1,3,5,5,1,4,5,1,2,0,0,2,1,48.68
Education,Accountant,2.6938021897043747,5,2,4,0,4,0,3,3,2,1,0,0,1,1,Arts,Masters,25-30,3,0,0,Flexible,Tier1_City,1,5,1,3,5,3,3,23.57,Healthcare,2,1,2,1,3,4,3,1,3,5,0,0,2,1,52.41
Biology,Architect,4.689725507778634,4,1,2,0,4,0,4,1,3,4,3,1,3,1,Science,Bachelors,18-24,7,0,0,Flexible,Tier1_City,3,2,3,3,2,0,4,4.3,Other,3,3,3,2,0,2,5,1,1,2,0,0,3,1,50.0
Biology,Music Teacher,4.236771937948658,5,1,2,0,0,1,3,2,1,3,2,0,2,1,Science,Masters,25-30,2,0,0,Remote,Any,2,2,4,1,2,1,2,10.8,Manufacturing,4,2,3,3,1,4,4,1,5,4,1,0,5,4,50.99
Psychology,Principal,3.223461341041056,4,2,4,1,4,0,4,3,4,4,1,1,1,1,Arts,Bachelors,18-24,11,0,0,Flexible,Tier1_City,3,1,2,4,0,3,2,5.78,Healthcare,3,5,4,2,1,4,2,4,1,1,1,1,5,4,52.82
Finance,Industrial-Organizational Psychologist,3.104752779144902,2,0,2,1,8,1,1,4,2,4,0,3,4,0,Commerce,Bachelors,31-35,11,0,0,Flexible,Any,3,3,1,2,0,2,2,35.73,Education,3,3,2,3,5,0,5,2,3,4,0,0,2,3,55.92
Biology,Urban Planner,3.055056523262677,5,1,0,0,7,0,3,1,4,3,4,0,3,1,Science,Bachelors,25-30,10,0,0,Remote,Tier3_City,3,2,5,3,0,5,1,22.42,Other,4,2,1,4,3,0,4,5,4,4,1,0,4,2,67.1
Business,Legal Consultant,4.261700139685079,3,0,2,0,0,1,2,2,4,3,4,1,4,0,Commerce,Masters,18-24,4,0,0,Office,Tier1_City,1,2,2,3,0,2,3,6.0,Education,4,3,2,4,2,4,3,3,1,5,0,0,4,4,55.51
Marketing,Animator,3.4213837874446207,4,0,3,1,4,1,1,4,2,1,0,0,2,1,Commerce,Masters,18-24,11,1,11,Hybrid,Tier1_City,4,1,4,4,4,4,2,35.46,Finance,5,3,2,3,4,1,3,3,3,1,0,1,3,5,52.46
Biology,Principal,4.839637965734379,8,1,1,1,2,1,0,0,4,3,0,2,0,0,Science,Bachelors,18-24,2,1,28,Office,Tier1_City,5,5,2,4,1,4,5,33.29,Education,2,5,2,2,3,3,1,3,2,3,1,1,1,4,35.61
Engineering,Digital Marketing Specialist,3.8725196808892046,4,0,1,0,8,1,2,4,0,2,3,2,0,1,Science,Masters,31-35,11,0,0,Flexible,Tier1_City,1,3,1,5,4,1,1,36.84,Finance,4,4,4,3,1,2,1,3,1,2,1,1,3,5,58.31
Education,Chemist,2.8428976943721964,5,1,2,1,7,0,0,4,4,4,2,4,4,0,Arts,Bachelors,18-24,14,0,0,Hybrid,Tier3_City,5,5,5,5,2,3,3,31.19,Other,3,3,4,3,0,1,3,5,1,1,0,0,3,5,59.06
Physics,Game Developer,4.156831227605535,0,2,4,1,0,1,0,1,4,2,4,0,2,1,Science,Bachelors,31-35,12,1,41,Hybrid,Tier2_City,5,2,5,2,4,2,5,10.59,Other,3,5,5,5,1,0,1,2,5,5,0,1,4,4,68.1
Law,Illustrator,4.08805903936796,6,1,0,0,7,0,3,1,2,3,0,1,3,0,Arts,Masters,18-24,6,0,0,Flexible,Tier3_City,3,3,1,2,3,2,3,5.89,Manufacturing,4,1,1,3,0,4,1,5,1,2,1,1,5,4,46.7
Business,Psychologist,2.908937124666094,3,1,4,0,7,0,2,0,0,0,0,0,0,1,Commerce,PhD,18-24,14,0,0,Flexible,Tier2_City,2,2,2,1,5,5,3,41.41,Healthcare,2,2,4,5,3,5,3,3,3,5,1,0,3,1,61.53
Marketing,Brand Manager,3.4292719295116205,3,1,2,1,0,0,2,4,2,1,3,4,3,0,Commerce,Masters,36-40,2,0,0,Remote,Tier2_City,5,1,4,5,0,1,5,13.14,Finance,3,5,4,5,4,5,5,2,5,2,1,1,1,5,56.96
Marketing,Forensic Psychologist,3.1208573380365614,0,2,1,1,3,1,4,4,4,4,4,0,1,0,Commerce,Masters,31-35,14,0,0,Flexible,Any,5,1,1,3,3,3,4,28.5,Tech,5,4,2,3,5,0,3,4,5,5,1,1,1,3,79.57
Biology,Software Developer,3.163447673790984,7,2,2,0,0,0,0,2,4,2,4,4,1,0,Science,Masters,18-24,11,0,0,Remote,Tier3_City,3,5,3,5,5,1,3,25.81,Tech,3,5,2,1,4,2,1,2,1,5,1,1,5,2,64.75
Engineering,Art Director,3.4618067811067945,8,2,2,1,8,0,3,0,3,3,0,2,0,0,Science,Masters,36-40,7,1,8,Hybrid,Any,2,4,1,3,3,0,4,46.29,Manufacturing,2,5,3,2,3,4,5,4,4,5,1,0,5,4,63.59
Biology,Credit Analyst,4.174881989168326,7,2,1,0,5,0,2,2,1,1,4,3,0,1,Science,Bachelors,25-30,8,0,0,Office,Tier1_City,3,5,0,4,2,2,3,28.96,Healthcare,1,1,3,3,4,3,1,5,2,2,0,1,4,1,49.88
Architecture,Architect,4.596018464467825,6,1,2,0,4,0,2,3,3,1,4,1,4,0,Interdisciplinary,Bachelors,36-40,12,0,0,Office,Tier3_City,5,3,2,5,0,1,5,30.26,Finance,5,2,3,4,4,4,2,4,4,3,1,0,2,2,64.22
Law,Principal,4.414468924544666,0,0,2,1,1,1,1,0,4,0,4,3,1,0,Arts,Bachelors,31-35,11,0,0,Office,Tier2_City,1,1,3,4,3,1,3,18.02,Manufacturing,5,2,4,3,5,0,1,4,3,1,0,0,2,3,54.86
Business,Urban Planner,2.7856793723113045,4,1,2,0,1,1,4,4,3,2,1,2,0,0,Commerce,Bachelors,31-35,1,1,13,Remote,Any,5,5,4,2,2,5,2,48.06,Healthcare,1,4,3,3,2,1,4,2,1,2,1,0,4,4,43.08
Finance,Surgeon,3.299030813277454,1,2,1,0,5,1,2,3,1,1,4,1,0,1,Commerce,Masters,40+,2,0,0,Remote,Tier2_City,1,1,3,2,0,0,2,31.78,Tech,5,2,1,4,2,0,4,5,1,3,1,0,5,1,47.12
Architecture,Counselor,4.657381064015192,9,1,1,1,2,1,1,1,0,4,4,3,4,1,Interdisciplinary,Bachelors,18-24,11,0,0,Flexible,Tier1_City,4,4,5,1,1,4,3,3.23,Finance,5,1,3,5,2,2,1,2,2,1,0,0,1,1,52.92
Biology,Physical Chemist,3.573782063633931,0,0,3,0,6,0,3,2,2,4,0,0,4,1,Science,Bachelors,31-35,12,0,0,Remote,Tier1_City,2,5,5,5,2,2,5,29.14,Healthcare,5,4,5,5,0,3,1,1,4,2,1,0,4,4,60.17
Education,Architect,3.5423113455321875,4,2,2,1,1,0,0,0,3,1,0,1,0,1,Arts,Bachelors,25-30,6,0,0,Remote,Tier1_City,4,1,1,4,4,5,5,20.1,Education,3,1,5,1,2,5,2,4,4,1,0,1,3,5,39.83
Physics,Principal,3.832576361228043,7,1,4,1,5,0,4,4,0,4,2,4,2,1,Science,Masters,18-24,4,0,0,Office,Tier1_City,3,2,1,3,0,1,1,4.51,Finance,3,1,2,3,3,2,5,2,4,3,0,0,2,4,60.88
Law,Analytical Chemist,4.017535236746459,4,0,2,1,8,1,2,2,4,3,1,4,0,1,Arts,Bachelors,18-24,9,0,0,Hybrid,Tier2_City,5,4,0,2,3,2,5,23.28,Education,4,5,4,3,5,2,5,5,4,5,1,0,5,1,65.31
Finance,Cybersecurity Analyst,4.442867362751757,4,0,4,0,4,1,1,4,4,3,1,4,4,0,Commerce,Masters,18-24,6,1,49,Hybrid,Any,4,2,5,2,5,4,4,39.36,Other,4,5,5,2,2,1,2,2,5,4,0,0,1,3,66.09
Medicine,Architect,4.610211307524214,0,2,2,1,7,1,2,0,3,1,0,4,2,1,Science,Bachelors,31-35,1,1,15,Remote,Tier1_City,2,3,3,3,3,1,3,26.68,Other,3,5,1,5,5,0,3,1,2,1,1,1,3,3,38.91
Education,Clinical Psychologist,4.797793716162213,7,1,4,0,2,1,0,1,0,4,3,2,0,1,Arts,Bachelors,25-30,13,0,0,Flexible,Tier1_City,1,4,1,4,4,0,2,33.05,Other,5,3,2,3,3,1,1,4,3,2,1,0,3,3,53.29
Biology,Data Scientist,3.4577142885838184,8,1,0,1,8,0,2,1,1,0,2,3,3,1,Science,Masters,25-30,13,0,0,Flexible,Any,1,1,4,4,4,2,5,33.07,Manufacturing,2,1,5,2,2,1,1,1,4,4,0,0,2,1,63.38
Law,Composer,4.007630960919885,2,1,0,1,5,1,0,1,2,1,0,3,1,0,Arts,Masters,18-24,3,0,0,Remote,Tier1_City,3,2,4,5,3,5,2,34.54,Healthcare,1,2,3,1,4,4,4,1,2,1,1,0,2,4,33.41
Art,Surgeon,2.779036861294984,2,1,1,1,5,0,4,1,3,1,4,1,2,0,Arts,Bachelors,25-30,0,1,35,Hybrid,Any,3,3,5,5,5,0,1,21.22,Other,4,4,5,2,2,0,4,4,2,1,0,1,2,4,44.48
Chemistry,Credit Analyst,3.725191045900511,0,1,0,0,0,0,1,1,3,2,1,2,1,0,Science,Masters,36-40,14,0,0,Remote,Tier1_City,5,2,3,1,0,4,3,20.39,Healthcare,5,3,5,5,3,5,3,1,1,4,0,0,1,4,56.82
Medicine,Architectural Technologist,2.761786924108472,4,2,0,0,8,1,0,0,3,0,0,1,0,1,Science,Masters,25-30,4,1,16,Office,Tier2_City,4,4,3,2,2,4,5,3.22,Healthcare,4,5,2,5,3,4,5,4,3,5,1,0,5,5,45.03
Physics,Musician,4.747765201610683,3,0,2,0,4,0,3,0,2,3,1,1,4,0,Science,Bachelors,31-35,7,0,0,Hybrid,Tier1_City,5,2,0,5,4,2,2,10.25,Healthcare,2,3,4,1,5,5,5,4,3,2,0,1,2,5,50.46
Biology,Digital Marketing Specialist,2.710099430179324,1,0,2,0,1,1,4,0,2,0,4,2,3,1,Science,Masters,31-35,0,1,40,Office,Any,1,2,3,4,4,4,5,47.69,Finance,5,3,3,3,3,0,5,3,3,2,1,1,5,4,50.23
Computer Science,Pharmacist,4.354340102404559,6,1,4,1,2,0,4,2,4,4,4,0,3,0,Science,Masters,31-35,6,1,6,Hybrid,Any,1,5,4,3,4,3,1,42.59,Education,3,1,3,2,2,1,1,5,5,5,0,1,1,5,73.51
Finance,Brand Manager,3.2846253830164622,4,2,4,1,3,0,3,0,3,2,0,4,0,1,Commerce,Masters,25-30,6,1,22,Hybrid,Tier3_City,4,1,3,4,5,5,2,15.93,Education,2,1,3,3,0,3,4,2,4,3,0,1,5,5,59.46
Computer Science,Forensic Psychologist,4.398214309279543,3,1,2,0,1,1,2,2,1,4,2,0,0,0,Science,Masters,36-40,6,0,0,Flexible,Tier1_City,5,2,1,2,1,2,2,21.86,Manufacturing,4,2,3,3,3,4,1,2,4,1,0,1,1,4,50.51
Physics,Paralegal,2.5278592838620693,0,2,1,0,4,1,2,3,3,1,3,2,0,1,Science,Masters,25-30,14,0,0,Hybrid,Any,3,5,1,4,5,3,3,47.18,Other,5,4,4,3,5,0,3,5,4,3,0,1,3,4,70.38
Education,AI Researcher,3.5404443546852304,4,0,4,1,4,1,3,0,2,1,0,1,1,1,Arts,Masters,36-40,0,0,0,Office,Any,4,1,5,1,0,4,3,14.77,Manufacturing,5,4,3,4,0,4,2,1,2,4,1,1,1,1,39.29
Finance,Nuclear Physicist,2.8660200022562545,7,1,0,1,5,0,2,3,4,0,4,0,3,0,Commerce,Masters,18-24,11,0,0,Hybrid,Tier2_City,3,4,5,2,0,2,2,28.03,Healthcare,1,5,4,1,2,0,2,5,5,2,1,0,5,4,61.86
Psychology,Education Administrator,4.39605876838166,5,0,2,1,0,0,4,1,0,0,0,1,1,0,Arts,Masters,25-30,10,0,0,Remote,Tier2_City,4,4,3,3,0,3,3,4.04,Tech,1,2,2,3,5,4,5,4,3,4,0,1,5,4,54.93
Biology,Astronomer,2.6444823578665657,1,2,2,0,3,0,3,3,3,2,3,2,2,1,Science,Masters,18-24,2,0,0,Hybrid,Any,3,5,2,1,0,4,2,32.13,Tech,1,4,1,1,0,3,4,4,1,1,0,1,2,4,40.98
Education,Judge,4.188112288234676,8,1,1,1,8,0,1,1,0,4,3,0,2,1,Arts,Masters,31-35,10,0,0,Hybrid,Tier2_City,2,5,3,2,0,1,4,46.71,Healthcare,3,3,4,3,0,0,3,2,3,2,0,0,3,4,50.36
Psychology,Art Therapist,3.998024682518506,1,2,2,0,9,1,4,4,0,0,0,3,1,0,Arts,Masters,25-30,1,0,0,Hybrid,Tier1_City,1,4,0,3,3,1,5,44.58,Other,5,3,3,2,3,3,1,3,2,4,1,0,4,2,46.5
Business,Chemical Engineer,3.035984186210957,6,0,4,1,3,0,2,3,4,0,1,1,4,1,Commerce,Bachelors,18-24,14,0,0,Office,Any,4,3,4,1,4,0,4,26.59,Education,5,4,2,2,5,5,3,1,4,2,1,1,1,2,58.62
Psychology,Biochemist,2.7839448775378632,8,1,0,0,2,0,2,0,3,1,4,0,2,0,Arts,Masters,18-24,14,0,0,Hybrid,Tier2_City,2,1,4,1,5,1,4,33.53,Manufacturing,4,3,2,1,2,3,3,5,1,2,1,1,4,3,53.86
Medicine,Accountant,3.90877561836218,8,0,1,1,5,1,4,2,0,1,0,3,1,0,Science,Masters,36-40,4,0,0,Flexible,Any,4,1,3,2,3,3,5,29.78,Finance,3,3,5,3,3,5,3,4,2,2,0,1,1,4,44.21
Computer Science,Game Developer,2.9924279898247392,0,1,0,0,0,0,4,1,3,1,0,2,2,1,Science,High School,36-40,1,0,0,Hybrid,Tier2_City,1,5,2,5,5,5,2,6.15,Tech,1,5,5,1,4,3,4,4,1,3,1,0,1,5,33.19
Finance,Biotechnologist,4.844512527439356,8,0,1,1,1,0,0,2,3,2,1,3,4,1,Commerce,Masters,25-30,12,1,55,Remote,Tier1_City,1,1,4,1,1,1,2,10.46,Manufacturing,5,3,1,1,1,4,3,3,5,4,1,1,3,2,60.99
Chemistry,Astronomer,3.3379897550813515,5,2,4,1,6,0,4,3,4,0,2,1,0,1,Science,Bachelors,31-35,13,0,0,Remote,Tier2_City,3,3,2,1,2,2,3,48.3,Tech,1,4,1,4,0,2,2,4,1,5,0,1,2,2,60.65
Finance,Surgeon,2.783352900465069,2,0,3,1,3,1,2,3,0,0,2,2,4,1,Commerce,Bachelors,25-30,4,0,0,Flexible,Tier3_City,1,1,4,3,4,2,1,15.03,Education,2,1,5,3,2,1,5,5,1,2,1,0,3,1,41.42
Biology,Astronomer,2.622861281473437,9,1,4,1,1,1,0,1,4,4,3,4,0,1,Science,Masters,25-30,4,0,0,Remote,Tier1_City,1,5,1,4,1,2,2,21.07,Education,3,3,5,4,0,2,3,2,2,1,0,0,4,5,51.1
Education,Construction Manager,2.781265882135779,2,2,3,1,3,1,3,0,0,1,3,1,0,0,Arts,Bachelors,36-40,3,0,0,Remote,Tier2_City,1,2,0,2,3,1,5,26.92,Healthcare,1,4,2,3,2,2,1,2,1,3,1,1,4,5,38.89
Law,Cybersecurity Analyst,2.7654851729430865,9,0,4,0,7,0,0,1,2,1,4,1,3,1,Arts,Masters,18-24,10,0,0,Remote,Tier1_City,5,2,4,2,2,1,1,49.02,Healthcare,3,3,4,5,3,4,2,1,2,3,1,1,1,2,58.46
Chemistry,Doctor,3.867606281858441,3,0,1,1,0,0,1,3,3,2,1,0,3,1,Science,Masters,25-30,6,1,34,Hybrid,Tier2_City,5,5,3,5,1,0,5,35.43,Tech,5,2,5,5,1,2,3,5,4,5,1,1,2,1,57.62
Medicine,Ecologist,4.83193846302337,9,1,3,0,4,0,1,2,0,4,4,1,2,0,Science,Bachelors,25-30,9,0,0,Hybrid,Any,1,2,1,5,5,5,5,32.59,Tech,2,5,3,4,1,2,4,4,2,5,1,0,5,3,63.41
Business,Legal Consultant,4.485336386279494,6,2,0,0,6,1,2,4,4,4,2,4,0,1,Commerce,High School,25-30,5,0,0,Remote,Tier2_City,5,1,2,2,2,5,5,27.65,Manufacturing,4,1,4,5,1,4,3,4,4,3,0,1,5,4,59.95
Art,Cybersecurity Analyst,4.043254358216744,6,2,0,1,8,1,1,4,3,0,4,4,3,1,Arts,Bachelors,25-30,1,0,0,Hybrid,Tier2_City,4,5,0,5,5,4,1,35.93,Healthcare,2,3,4,4,1,1,5,5,5,3,0,1,2,5,54.98
Music,Zoologist,2.6781269720412384,1,0,0,0,4,1,1,1,3,3,3,1,2,1,Arts,Masters,25-30,14,0,0,Hybrid,Tier1_City,2,5,2,3,1,0,4,34.21,Education,3,4,3,5,0,1,2,2,3,4,1,1,1,4,66.31
Medicine,Clinical Psychologist,2.9082395736062203,8,0,3,0,7,0,1,3,2,4,1,3,0,0,Science,PhD,18-24,3,1,45,Office,Tier2_City,2,5,2,2,3,3,5,45.43,Other,2,1,3,4,2,2,5,4,4,3,0,1,5,4,62.2
Law,Nuclear Physicist,3.683956571798016,1,2,2,0,0,1,2,0,1,3,3,0,1,1,Arts,Masters,25-30,12,0,0,Office,Tier2_City,5,2,4,5,5,2,3,28.47,Manufacturing,5,3,3,5,4,1,5,4,5,3,0,1,1,4,64.31
Medicine,Legal Consultant,4.926189013307624,2,2,1,1,7,0,2,2,1,0,1,3,1,0,Science,Bachelors,18-24,13,1,41,Office,Tier3_City,2,4,1,2,2,1,2,22.81,Manufacturing,3,2,2,1,2,4,4,5,4,2,1,0,3,3,51.33
Architecture,Financial Advisor,3.678626669736639,5,2,2,0,0,0,1,1,1,0,1,3,0,1,Interdisciplinary,Masters,18-24,10,0,0,Hybrid,Any,5,2,0,4,1,4,2,40.94,Finance,3,4,5,1,0,3,3,1,1,5,1,1,4,4,51.38
Engineering,Chemist,2.5716787805283543,7,1,1,0,8,0,2,4,4,0,2,4,1,1,Science,Bachelors,18-24,6,1,42,Remote,Tier2_City,3,5,1,1,5,4,2,40.59,Other,5,5,5,1,5,0,5,5,3,4,0,1,2,3,58.3
Engineering,Fluid Mechanics Engineer,2.5771964819468334,5,0,0,1,4,1,2,3,1,2,0,3,0,0,Science,Masters,31-35,8,0,0,Office,Any,1,1,1,2,3,1,1,10.98,Education,1,3,2,3,3,4,2,4,5,3,1,1,3,2,59.82
Chemistry,Web Developer,4.437569977817091,8,0,0,1,0,0,1,4,2,3,1,4,4,1,Science,Bachelors,25-30,8,0,0,Hybrid,Tier3_City,2,4,5,1,4,0,3,14.13,Manufacturing,4,4,4,2,4,1,3,5,5,4,0,0,5,2,63.3
Architecture,Biochemist,2.778560095451494,7,0,2,1,7,1,3,1,3,0,0,2,2,1,Interdisciplinary,Masters,31-35,11,1,41,Hybrid,Tier1_City,1,5,4,5,3,4,3,48.06,Other,2,3,2,4,4,2,5,5,1,5,0,0,3,1,59.77
Chemistry,Quantum Physicist,2.915454744725909,0,0,0,1,3,0,3,2,3,4,2,3,1,0,Science,Bachelors,31-35,2,0,0,Flexible,Tier2_City,2,2,2,1,3,5,3,23.87,Finance,4,5,5,2,5,5,1,1,4,3,0,0,3,5,54.02
Business,School Psychologist,2.69131863614963,4,2,1,0,4,0,4,2,2,4,1,4,3,1,Commerce,PhD,31-35,0,0,0,Flexible,Any,4,3,1,2,4,0,3,27.42,Other,4,2,1,1,4,1,1,2,5,2,0,1,5,1,59.22
Biology,Electrical Engineer,4.604851688139418,8,2,4,1,4,1,2,1,4,0,0,0,0,0,Science,Bachelors,25-30,8,0,0,Flexible,Any,4,5,2,4,3,1,3,17.58,Healthcare,5,5,2,4,0,5,1,5,4,3,0,1,3,5,49.3
Law,Music Therapist,2.57138160202614,1,2,3,0,9,1,3,2,2,3,1,3,0,1,Arts,Masters,25-30,7,0,0,Flexible,Tier1_City,5,1,1,5,4,0,4,25.61,Education,1,5,1,4,1,2,5,5,4,5,0,0,2,5,66.48
Biology,School Psychologist,3.682828466855909,4,2,1,0,7,0,4,2,2,1,0,1,1,0,Science,PhD,25-30,6,0,0,Flexible,Tier3_City,1,3,0,2,4,5,3,37.94,Healthcare,4,5,1,3,5,0,4,1,1,4,1,1,5,2,53.32
Biology,Lawyer,3.0858621037530214,9,1,2,1,5,1,4,4,0,0,2,1,1,0,Science,Bachelors,31-35,5,0,0,Office,Tier2_City,5,3,3,5,5,2,3,25.67,Finance,3,1,3,2,1,3,5,4,4,2,0,1,5,1,50.57
Art,Financial Analyst,3.125633021582566,0,0,2,0,9,1,2,3,1,1,0,0,0,1,Arts,PhD,25-30,13,0,0,Remote,Tier1_City,3,2,3,3,5,1,1,17.79,Education,1,4,3,2,1,3,2,3,3,1,1,1,1,3,54.52
Engineering,Urban Planner,2.5404646849453,2,1,1,0,0,0,0,4,1,3,2,1,2,1,Science,Masters,36-40,14,0,0,Flexible,Any,5,2,3,1,4,5,1,7.51,Tech,5,3,3,5,2,4,1,3,1,1,1,0,5,3,57.06
Medicine,Marketing Manager,4.835258857420171,4,1,2,1,5,1,0,1,2,2,2,2,1,0,Science,Bachelors,36-40,9,0,0,Flexible,Any,5,4,4,3,1,1,3,46.63,Tech,4,2,1,4,1,0,5,4,1,5,0,0,5,5,49.74
Chemistry,AI Researcher,4.314305622410641,2,1,2,1,0,1,4,3,4,3,1,2,2,1,Science,Bachelors,18-24,6,0,0,Remote,Tier2_City,5,5,4,2,2,5,4,43.97,Tech,5,3,5,1,4,4,1,4,2,5,1,1,4,3,57.16
Marketing,Entrepreneur,4.688822004631292,4,0,2,0,5,1,2,0,3,2,0,3,3,0,Commerce,Masters,18-24,10,1,59,Hybrid,Tier1_City,2,4,2,4,1,5,3,40.19,Other,2,1,3,5,1,5,2,4,3,2,1,1,1,2,55.96
Architecture,Market Research Analyst,4.409721079038652,7,1,0,0,3,1,3,3,2,3,3,2,0,1,Interdisciplinary,Bachelors,31-35,8,0,0,Remote,Tier3_City,2,4,4,5,4,4,3,35.62,Manufacturing,5,2,3,5,5,5,4,2,5,4,1,1,2,1,69.72
Physics,Microbiologist,2.9233296867146774,8,2,3,0,6,0,3,0,3,4,1,4,0,0,Science,Masters,25-30,5,1,36,Flexible,Tier2_City,3,3,3,1,2,4,3,27.23,Other,3,1,4,4,5,0,4,2,4,3,0,0,3,3,61.09
Art,Education Administrator,4.442024981962126,0,0,1,1,8,0,0,0,3,2,0,1,2,0,Arts,Bachelors,18-24,14,0,0,Hybrid,Tier1_City,1,2,4,5,5,4,5,45.18,Other,5,3,1,5,4,0,4,1,4,1,1,1,4,5,50.4
Medicine,Musician,4.168012041215073,5,2,3,0,2,1,1,4,0,1,2,1,3,1,Science,Masters,36-40,13,0,0,Remote,Tier1_City,4,3,3,2,2,2,4,40.21,Other,1,2,1,4,4,3,1,4,1,1,1,1,1,1,49.77
Chemistry,Art Therapist,2.627122508290712,2,1,4,1,0,1,4,1,2,0,2,4,4,1,Science,High School,18-24,13,0,0,Remote,Tier1_City,1,5,1,5,4,2,2,41.35,Other,2,3,3,4,2,0,5,5,4,5,0,1,5,3,65.65
Education,Music Therapist,4.03782042271311,0,0,4,1,1,1,2,1,0,0,4,3,0,0,Arts,Masters,36-40,9,0,0,Flexible,Tier2_City,4,4,5,1,5,5,3,17.55,Tech,3,4,4,5,5,0,3,4,3,5,1,1,5,3,67.2
Chemistry,Investment Banker,3.045089573417952,4,0,3,0,6,0,0,0,3,4,1,0,2,0,Science,PhD,31-35,2,0,0,Hybrid,Tier1_City,2,4,3,2,2,3,2,22.9,Manufacturing,2,1,4,1,1,1,2,4,5,4,1,1,1,4,52.74
Computer Science,Manager,2.6276293794687624,1,0,3,0,9,1,0,4,3,1,3,3,2,0,Science,PhD,31-35,12,0,0,Hybrid,Tier1_City,5,5,3,5,2,1,4,36.22,Manufacturing,3,4,2,5,3,0,1,5,4,2,0,0,1,1,66.92
Music,Artist,2.703851452403707,8,2,0,1,5,1,2,4,3,2,2,1,2,1,Arts,Masters,18-24,13,0,0,Hybrid,Any,3,4,0,4,1,4,3,20.44,Finance,2,4,2,2,1,3,2,1,1,1,1,1,4,5,55.15
Music,Counselor,3.3359371697169804,3,1,0,0,0,0,0,3,0,2,4,4,0,1,Arts,Bachelors,18-24,2,1,52,Remote,Any,3,2,5,2,2,1,2,26.22,Tech,4,3,3,4,3,3,1,4,3,4,1,1,4,1,47.19
Medicine,Sound Engineer,2.6787121711868043,1,0,1,0,0,1,0,1,1,4,3,2,0,1,Science,Masters,25-30,3,1,27,Remote,Tier1_City,3,2,0,2,4,5,2,33.39,Education,5,3,1,1,5,3,4,5,5,2,0,0,4,5,51.53
Music,Teacher,2.9068073054625714,4,1,2,1,6,1,2,4,0,2,0,1,4,0,Arts,High School,18-24,9,0,0,Hybrid,Tier1_City,1,4,0,4,0,0,4,23.57,Other,1,5,4,3,2,2,2,3,3,1,0,0,1,5,37.51
Medicine,Illustrator,2.825900133975352,2,2,4,0,6,0,2,3,0,3,3,4,0,0,Science,High School,25-30,12,0,0,Hybrid,Tier2_City,2,5,0,3,0,5,3,40.27,Manufacturing,1,5,4,3,0,4,3,3,3,3,1,0,1,5,52.86
Computer Science,Music Therapist,2.622637723229608,3,2,1,0,0,1,0,1,1,3,3,4,4,1,Science,Bachelors,25-30,13,0,0,Hybrid,Tier1_City,2,3,3,1,0,2,5,8.47,Finance,4,2,4,5,2,0,4,5,3,4,0,1,4,2,58.06
Engineering,Investment Banker,4.623611410316457,8,2,0,0,9,0,0,0,0,0,2,2,3,1,Science,Bachelors,18-24,14,0,0,Hybrid,Tier1_City,5,4,2,3,4,3,4,36.75,Manufacturing,2,3,1,3,2,2,4,4,4,1,1,1,4,3,45.89
Engineering,Advertising Manager,3.4463225289492625,9,0,3,1,6,1,3,1,1,4,3,1,1,0,Science,Masters,18-24,13,0,0,Remote,Tier1_City,1,1,0,5,0,0,5,9.82,Education,5,1,2,2,3,3,3,2,3,2,1,1,1,3,60.1
Art,Investment Banker,3.692975872477642,6,0,3,0,1,1,4,3,4,1,4,3,3,0,Arts,Masters,31-35,9,0,0,Flexible,Any,5,2,4,4,1,1,3,47.08,Education,4,3,3,5,2,3,3,2,4,1,0,0,5,3,67.98
Psychology,Acoustics Specialist,3.400247562278518,3,2,2,1,6,1,3,4,2,4,4,2,3,0,Arts,Bachelors,18-24,7,1,21,Remote,Any,4,1,4,3,4,2,2,17.76,Tech,2,3,2,5,4,3,4,4,3,3,0,0,4,2,66.66
Architecture,Game Developer,2.9914636675825728,3,0,0,1,0,1,2,0,3,3,4,1,0,0,Interdisciplinary,Bachelors,18-24,9,0,0,Remote,Tier3_City,2,1,4,2,5,4,4,40.39,Manufacturing,5,4,4,1,2,0,3,5,5,5,0,0,4,3,66.96
Law,Art Therapist,2.804661999062492,8,0,1,0,7,0,0,3,0,2,1,2,3,1,Arts,PhD,31-35,8,0,0,Remote,Tier2_City,3,1,3,5,4,0,4,27.51,Education,2,4,4,4,5,2,4,1,1,5,1,0,1,4,58.57
Art,Entrepreneur,4.5269297598206695,9,1,2,0,1,0,0,2,0,3,0,1,2,1,Arts,Bachelors,40+,13,1,18,Remote,Tier3_City,5,4,1,5,4,2,4,7.28,Healthcare,1,5,1,5,2,2,5,2,4,4,1,0,2,2,53.46
Biology,Graphic Designer,4.161023124539666,2,1,1,1,7,0,3,0,1,4,1,2,1,0,Science,Bachelors,25-30,7,0,0,Remote,Tier2_City,4,4,5,3,2,1,1,30.38,Education,5,2,1,5,3,1,1,3,1,2,1,1,2,2,49.4
Physics,Brand Manager,3.170031722357096,4,1,4,0,4,0,3,2,0,3,3,2,3,0,Science,Bachelors,18-24,10,0,0,Hybrid,Tier2_City,3,1,5,3,2,5,3,45.87,Education,1,2,1,5,5,4,5,1,5,3,1,1,4,3,67.22
Biology,Credit Analyst,2.770131550739889,9,1,4,0,9,0,4,4,4,1,2,3,1,1,Science,Masters,25-30,9,1,29,Office,Tier2_City,3,4,1,4,2,1,1,10.39,Manufacturing,1,3,3,1,2,3,1,3,1,2,0,1,3,4,62.72
Chemistry,School Counselor,3.0500964169670413,2,1,1,1,3,1,3,4,0,3,4,1,2,0,Science,Masters,36-40,1,0,0,Remote,Tier3_City,5,1,0,1,3,0,4,18.1,Other,5,1,5,5,2,5,1,4,3,4,0,0,2,5,57.64
Architecture,School Psychologist,4.728465792188953,4,1,3,0,0,0,3,2,2,1,0,4,4,1,Interdisciplinary,Bachelors,31-35,3,0,0,Hybrid,Tier1_City,5,1,4,3,1,0,4,23.64,Education,4,4,5,4,5,1,5,1,5,3,1,0,4,5,51.12
Physics,Digital Marketing Specialist,3.887401805150441,0,0,4,1,6,1,0,4,3,0,0,4,1,1,Science,Bachelors,31-35,3,0,0,Flexible,Tier1_City,5,3,5,3,4,5,5,15.93,Finance,2,1,3,4,5,0,1,4,4,1,0,1,3,3,46.5
Computer Science,Biologist,3.08741692228316,1,0,0,0,9,0,3,1,2,0,0,0,2,1,Science,Masters,25-30,11,0,0,Remote,Any,2,3,0,2,4,0,1,47.36,Other,5,4,3,5,5,1,1,2,5,5,1,0,1,1,65.19
Finance,Biotechnologist,4.975638099480433,0,0,0,0,0,0,0,1,4,0,0,2,0,0,Commerce,Masters,25-30,1,1,22,Office,Tier1_City,1,3,3,5,2,3,2,20.74,Education,1,3,3,1,1,3,4,4,4,1,1,1,3,3,34.58
Computer Science,Aerospace Engineer,4.67653939438553,4,0,3,0,6,0,4,1,1,3,1,0,0,1,Science,Bachelors,18-24,12,0,0,Remote,Tier1_City,5,5,4,1,4,4,3,33.93,Healthcare,2,2,2,3,5,1,1,2,3,1,1,1,4,3,54.84
Architecture,AI Researcher,4.001118177677161,0,0,1,0,8,0,2,0,3,1,3,3,0,1,Interdisciplinary,PhD,31-35,7,0,0,Remote,Tier2_City,2,2,0,2,5,2,2,13.52,Education,5,3,3,5,4,3,3,2,2,2,1,0,2,3,62.77
Chemistry,School Counselor,3.524769765071881,9,2,1,1,8,0,3,0,3,1,3,3,4,1,Science,Bachelors,31-35,2,0,0,Hybrid,Tier1_City,1,4,2,4,4,5,2,13.33,Tech,4,4,2,5,4,1,1,5,3,2,1,1,2,5,46.97
Chemistry,Legal Consultant,3.262513662998927,4,1,1,1,6,1,2,2,1,1,0,2,3,1,Science,Bachelors,40+,1,1,32,Remote,Tier1_City,4,3,3,4,0,1,3,11.26,Manufacturing,5,2,1,2,4,3,2,4,3,4,1,1,1,3,36.23
Law,Quantum Physicist,3.71190706857937,5,0,3,1,1,1,4,3,2,3,1,1,0,0,Arts,PhD,25-30,6,0,0,Flexible,Tier1_City,1,2,5,3,5,1,4,23.44,Healthcare,5,1,4,1,2,2,4,1,1,1,1,1,2,4,54.1
Law,Biotechnologist,3.8047056319759616,7,2,0,1,6,0,4,2,2,1,0,3,1,1,Arts,Bachelors,18-24,14,0,0,Remote,Tier2_City,2,2,5,3,5,4,5,28.04,Finance,3,1,5,4,4,1,4,1,2,1,0,1,5,1,52.57
Engineering,Brand Manager,2.725102260229672,7,0,3,0,0,1,3,0,1,3,1,4,3,1,Science,Masters,25-30,0,1,25,Hybrid,Tier1_City,2,4,3,4,4,0,4,3.51,Education,2,5,4,1,1,2,1,5,5,1,1,0,2,3,44.53
Business,Cybersecurity Analyst,4.488318764775559,2,1,4,1,8,1,0,3,1,3,4,2,4,0,Commerce,Bachelors,31-35,14,1,29,Hybrid,Tier2_City,1,5,3,3,3,0,4,42.15,Education,5,1,5,1,0,4,2,4,2,5,0,0,3,1,57.08
Business,Ecologist,3.127229057295807,9,2,0,1,1,0,1,0,3,1,1,3,2,1,Commerce,Bachelors,31-35,5,0,0,Remote,Tier1_City,1,1,2,1,2,1,1,27.1,Finance,1,5,1,5,0,4,2,5,3,3,1,0,2,2,44.6
Education,Architectural Technologist,3.419757765395264,1,0,3,1,9,1,4,3,3,3,2,0,0,1,Arts,PhD,18-24,12,0,0,Office,Tier1_City,2,3,5,3,1,4,2,10.39,Education,1,2,5,2,1,4,4,2,1,5,1,0,3,1,64.63
Business,Financial Analyst,3.127728758692485,5,2,1,0,0,1,2,2,0,2,3,2,4,1,Commerce,Bachelors,25-30,12,0,0,Hybrid,Any,2,5,1,5,1,1,2,6.16,Tech,3,3,1,5,0,1,5,4,2,1,0,1,5,5,49.01
Music,Game Developer,2.7177472912971528,4,1,0,1,6,0,2,4,2,3,2,1,1,0,Arts,Masters,25-30,2,0,0,Office,Tier3_City,4,4,5,3,0,0,2,5.97,Other,1,3,4,1,0,4,2,1,5,4,1,0,1,5,50.8
Law,School Counselor,4.837328887738797,2,1,0,1,5,1,0,2,2,2,2,2,4,0,Arts,Bachelors,25-30,12,0,0,Office,Tier2_City,2,5,1,2,1,5,5,15.11,Other,5,2,2,5,3,2,1,2,2,3,1,0,5,5,54.72
Law,Mechanical Engineer,2.5025324336222434,9,1,0,1,3,1,1,1,4,2,1,2,3,0,Arts,Bachelors,36-40,2,0,0,Hybrid,Tier1_City,2,2,2,1,1,2,5,26.47,Healthcare,2,2,5,1,2,2,3,5,4,3,1,0,4,1,45.6
Education,Art Therapist,2.736723536210897,2,0,4,0,8,1,3,0,1,3,1,1,2,0,Arts,High School,25-30,14,0,0,Hybrid,Tier1_City,3,5,5,2,2,0,5,43.43,Education,3,4,3,4,3,5,5,5,4,1,1,1,3,3,47.87
Biology,Forensic Psychologist,3.4410688844722817,8,0,4,0,6,0,4,4,3,4,4,3,4,1,Science,Masters,31-35,4,0,0,Remote,Tier3_City,3,3,1,2,2,5,3,45.44,Finance,3,1,2,5,3,5,1,5,5,4,0,1,1,3,74.87
Engineering,Marketing Manager,3.810389310132556,0,2,4,1,7,1,0,3,1,4,3,4,4,0,Science,Bachelors,25-30,13,1,50,Remote,Tier1_City,3,5,2,5,3,2,5,42.12,Finance,4,1,2,5,1,5,1,4,2,5,1,0,5,4,67.61
Computer Science,Physical Chemist,3.4356870939174047,2,1,2,0,3,1,3,0,3,4,2,1,0,0,Science,Masters,31-35,2,0,0,Remote,Tier3_City,5,5,0,1,0,3,1,18.44,Healthcare,4,1,1,4,0,4,5,5,1,2,1,1,1,3,45.34
Engineering,Chemical Engineer,4.97267339604253,6,2,4,1,6,0,2,2,4,0,2,2,4,0,Science,Bachelors,25-30,11,0,0,Flexible,Tier2_City,5,2,2,1,1,4,1,17.41,Tech,2,5,4,5,1,4,3,2,5,5,1,1,4,5,66.89
Physics,Paralegal,3.365074460408863,3,2,3,1,4,1,4,2,1,3,2,0,2,0,Science,PhD,36-40,3,1,48,Hybrid,Tier3_City,2,5,1,1,3,5,4,49.41,Healthcare,2,1,3,1,4,0,5,4,3,3,1,1,4,3,52.97
Chemistry,Marketing Manager,4.878915643015513,0,1,2,0,3,1,3,1,2,0,2,0,2,0,Science,Bachelors,25-30,12,0,0,Remote,Tier2_City,3,2,2,1,0,3,4,35.02,Education,3,4,4,3,3,0,4,4,3,4,0,1,5,2,53.9
Marketing,Music Therapist,3.305978335400421,7,0,4,1,9,0,0,0,1,2,0,2,0,1,Commerce,Masters,25-30,12,0,0,Remote,Tier2_City,4,3,2,1,5,0,4,17.33,Other,5,3,4,5,0,1,1,2,5,1,0,1,3,2,53.85
Biology,Curriculum Developer,4.006400185565216,5,2,0,1,8,1,0,3,4,4,4,3,3,1,Science,Masters,18-24,14,0,0,Remote,Tier1_City,4,3,4,5,1,4,4,18.47,Tech,5,3,2,4,2,0,4,1,3,5,0,0,5,4,74.58
Biology,School Psychologist,4.596094358889925,0,1,2,0,8,1,1,4,3,1,3,3,0,1,Science,Masters,25-30,2,0,0,Remote,Tier2_City,4,1,2,3,1,5,1,23.43,Tech,4,5,3,4,3,2,4,4,4,3,1,0,2,2,52.35
Medicine,Manager,3.5741798567577647,7,1,1,1,1,1,3,1,3,3,2,4,0,0,Science,Masters,25-30,6,0,0,Hybrid,Tier3_City,2,1,1,2,2,0,4,32.22,Finance,2,4,5,3,0,2,4,2,1,2,0,0,4,2,54.67
Computer Science,Teacher,4.262892730283696,1,0,4,1,9,1,1,1,2,3,1,2,4,1,Science,Masters,25-30,2,0,0,Remote,Tier1_City,3,2,3,1,4,4,1,45.21,Tech,2,2,3,1,4,1,3,4,1,1,1,0,1,5,35.5
Finance,Cybersecurity Analyst,4.796971934737545,3,1,1,1,7,1,4,3,0,3,2,2,1,0,Commerce,Masters,40+,13,0,0,Remote,Tier1_City,2,1,0,3,0,4,5,12.32,Education,5,3,1,2,1,1,1,1,1,1,0,0,1,4,53.66
Medicine,Composer,2.681702146786765,2,2,4,0,8,0,0,2,0,4,1,4,1,0,Science,Bachelors,18-24,9,0,0,Office,Tier1_City,2,1,2,3,1,0,5,6.97,Education,4,4,2,1,0,3,4,1,2,2,1,0,4,4,47.99
Biology,Graphic Designer,3.324701308274175,6,1,0,1,1,0,4,0,3,0,0,4,3,1,Science,High School,31-35,3,0,0,Flexible,Tier2_City,4,4,1,2,0,0,3,22.07,Education,5,2,3,5,0,0,4,3,5,5,0,0,1,1,50.85
Computer Science,Advertising Manager,3.642272789144628,2,2,0,0,0,1,3,1,0,0,1,4,2,0,Science,PhD,40+,1,0,0,Hybrid,Tier1_City,3,1,5,5,3,5,4,14.54,Other,5,5,1,4,3,3,4,4,3,3,1,0,3,1,49.77
Law,Biotechnologist,2.5341117243376488,8,0,0,0,4,1,3,0,3,3,1,4,1,1,Arts,Masters,18-24,1,0,0,Office,Any,5,5,5,4,3,4,5,30.07,Manufacturing,3,1,5,4,0,4,2,4,2,5,1,0,5,4,52.15
Music,Biochemist,4.716033052461078,1,1,1,0,9,1,1,1,1,4,1,2,4,0,Arts,Masters,31-35,8,0,0,Remote,Tier2_City,1,3,1,4,4,5,5,35.86,Tech,2,4,4,1,4,5,1,2,3,2,1,0,5,1,52.3
Medicine,Software Developer,4.860463563862705,9,0,4,1,8,1,0,1,4,0,4,1,4,1,Science,Bachelors,25-30,10,1,47,Office,Any,2,1,4,3,1,4,2,17.6,Tech,3,3,4,1,2,5,4,2,5,4,1,0,2,3,60.01
Education,Physical Chemist,4.478606322740145,6,2,0,0,0,1,3,3,0,4,3,4,2,1,Arts,Bachelors,18-24,0,0,0,Remote,Tier3_City,3,2,5,2,2,5,2,35.22,Education,3,5,1,5,4,2,3,3,3,4,1,0,2,3,54.4
Engineering,Mechanical Engineer,4.524656143015251,4,2,3,1,6,0,4,1,2,0,3,0,3,0,Science,Bachelors,25-30,0,0,0,Office,Tier1_City,1,4,1,4,1,0,1,19.13,Finance,5,4,2,1,0,1,2,2,2,2,0,0,1,2,36.6
Law,Urban Planner,2.811385297608776,3,0,3,1,9,0,4,2,2,3,1,1,3,1,Arts,Masters,36-40,9,0,0,Flexible,Tier1_City,1,4,3,3,0,0,3,32.84,Other,4,5,4,3,2,4,2,1,2,1,0,0,1,3,54.4
Art,Market Research Analyst,4.353747263251657,1,2,4,0,4,1,3,1,4,3,2,4,4,0,Arts,Bachelors,18-24,0,0,0,Office,Any,5,3,1,5,5,1,2,32.75,Tech,5,2,2,3,4,3,5,5,2,3,0,0,4,5,50.94
Education,AI Researcher,2.6667020504517858,6,2,2,0,5,1,0,4,2,3,1,1,1,0,Arts,Bachelors,25-30,13,1,41,Office,Tier2_City,5,3,3,4,3,5,3,16.07,Manufacturing,4,4,2,2,2,4,3,4,1,3,0,0,2,1,52.39
Engineering,Doctor,3.8120140188279774,7,2,2,0,4,1,1,2,4,1,3,0,3,1,Science,Bachelors,25-30,2,1,25,Hybrid,Tier1_City,2,2,5,3,0,1,5,32.88,Tech,2,1,4,4,5,4,5,3,4,1,1,0,2,5,40.13
Architecture,Entrepreneur,4.538636353064421,6,1,2,1,4,0,4,1,3,2,4,0,4,0,Interdisciplinary,Bachelors,36-40,1,0,0,Remote,Any,2,2,0,3,4,1,1,20.9,Healthcare,1,2,5,5,3,1,2,4,2,4,1,1,3,5,54.32
Biology,Physical Chemist,3.2986611799845647,2,0,4,0,8,0,2,0,1,1,3,2,0,1,Science,Masters,18-24,2,1,25,Hybrid,Tier2_City,3,2,2,1,3,3,3,18.81,Manufacturing,2,1,3,5,0,0,5,3,4,1,0,0,5,4,47.69
Physics,Biomedical Engineer,4.321977681451022,8,1,3,1,2,1,1,3,3,2,0,4,2,0,Science,Bachelors,31-35,13,0,0,Hybrid,Tier1_City,5,4,0,5,2,4,2,16.6,Finance,5,5,4,1,2,1,5,5,2,4,0,0,1,2,53.42
Education,Legal Secretary,3.5916616074199945,3,1,0,0,9,1,2,1,3,1,3,1,3,1,Arts,Masters,31-35,4,1,11,Remote,Tier2_City,5,4,2,1,3,2,5,19.25,Manufacturing,4,1,3,4,1,1,5,3,3,5,0,1,4,2,59.44
Physics,Judge,3.8082190742114186,5,2,1,1,9,0,2,2,1,1,0,2,4,0,Science,Bachelors,31-35,8,0,0,Hybrid,Tier3_City,3,2,5,2,5,3,4,39.98,Manufacturing,1,2,2,2,3,0,4,3,5,2,0,0,2,5,53.74
Business,Principal,4.247922210000045,6,0,2,0,8,0,1,1,1,2,4,1,2,1,Commerce,Bachelors,36-40,1,0,0,Office,Tier1_City,5,1,0,1,1,4,5,14.52,Tech,4,2,5,2,0,0,2,5,2,4,1,0,4,2,41.55
Psychology,Counselor,4.3011538216577145,9,1,0,1,1,0,2,1,0,3,1,1,1,0,Arts,High School,36-40,11,1,55,Remote,Tier1_City,4,1,3,1,5,2,2,35.05,Manufacturing,4,2,2,2,3,1,5,2,1,1,0,1,2,3,43.41
Computer Science,Graphic Designer,2.5351529480638515,9,1,3,1,9,1,3,4,1,3,1,3,2,1,Science,Bachelors,18-24,10,0,0,Hybrid,Tier1_City,1,2,2,4,5,1,2,45.33,Education,1,5,5,4,1,0,3,1,2,2,1,1,3,5,59.3
Law,Geneticist,2.6192774080773806,1,1,2,0,7,1,0,2,2,2,1,3,2,0,Arts,Bachelors,25-30,14,1,10,Office,Tier3_City,4,2,2,3,1,2,4,19.47,Other,1,3,1,2,0,2,4,3,3,4,1,0,2,1,53.32
Medicine,Psychologist,4.550364327516876,8,1,3,1,9,1,0,2,0,4,4,0,0,1,Science,Bachelors,25-30,13,0,0,Remote,Tier3_City,1,4,0,5,3,0,5,4.39,Manufacturing,2,5,5,3,3,4,2,1,3,1,1,0,1,2,52.5
Medicine,Curriculum Developer,4.18784055020104,3,2,1,1,8,0,0,2,0,4,1,0,3,0,Science,Masters,25-30,0,0,0,Hybrid,Tier2_City,3,1,4,1,4,0,3,4.16,Tech,3,2,5,1,3,4,2,3,3,5,0,0,1,1,43.03
Computer Science,Musician,2.7760514895619823,9,0,0,0,8,0,2,1,0,3,3,1,0,0,Science,Bachelors,25-30,10,0,0,Flexible,Tier2_City,3,3,5,5,1,5,3,9.56,Education,1,5,2,2,2,3,1,5,3,1,1,0,3,3,49.93
Law,School Counselor,4.078044504642016,7,2,4,0,5,0,1,4,1,0,3,2,3,1,Arts,Masters,25-30,5,0,0,Flexible,Tier1_City,1,3,4,1,1,4,5,8.17,Finance,3,4,4,3,2,1,2,1,2,5,1,1,5,2,50.98
Engineering,Architect,4.001110249803183,2,2,0,1,7,1,4,1,3,3,2,0,2,0,Science,Masters,25-30,2,0,0,Hybrid,Tier2_City,1,5,0,2,2,3,3,38.16,Healthcare,3,4,4,3,3,4,5,4,4,2,1,0,4,4,53.01
Architecture,Mechanical Engineer,2.6684324758696008,6,1,3,1,2,1,3,2,3,3,4,0,0,1,Interdisciplinary,Masters,40+,12,0,0,Hybrid,Any,1,3,1,1,3,1,5,16.86,Manufacturing,3,3,3,5,2,4,1,1,3,5,0,0,3,3,70.78
Finance,Advertising Manager,3.114988257715787,0,1,1,0,5,1,0,3,2,4,0,3,3,0,Commerce,High School,18-24,6,0,0,Remote,Tier2_City,1,1,0,4,1,4,5,33.67,Education,3,5,1,1,0,4,2,5,3,4,0,1,1,3,44.49
Marketing,Artist,4.025171021755094,2,2,4,1,1,0,0,1,2,2,2,3,3,1,Commerce,Bachelors,36-40,5,1,12,Remote,Any,2,4,5,3,4,1,2,5.0,Education,1,5,5,5,2,0,4,2,2,5,0,0,5,4,49.5
Education,Quantum Physicist,4.403453179910224,5,2,4,0,9,1,4,0,1,1,0,4,0,1,Arts,Bachelors,25-30,10,0,0,Remote,Tier3_City,5,1,3,2,0,0,1,16.9,Finance,4,4,3,4,0,0,2,2,5,1,1,0,3,1,52.8
Engineering,Social Media Manager,2.587981138447373,3,2,1,1,1,0,0,3,0,0,1,2,3,0,Science,Bachelors,31-35,6,1,34,Flexible,Tier1_City,5,1,3,1,3,3,2,14.0,Finance,1,2,5,3,0,4,4,1,1,4,1,0,3,1,38.89
Law,Physician Assistant,2.5086755790330164,0,1,0,1,8,0,0,3,4,3,2,3,4,1,Arts,PhD,36-40,12,0,0,Flexible,Tier3_City,3,3,1,5,2,3,3,16.01,Healthcare,1,1,5,5,0,2,2,5,1,5,1,0,1,3,70.36
Education,Geneticist,3.870184755802179,3,2,4,1,2,0,1,0,1,2,2,4,3,1,Arts,Bachelors,25-30,12,0,0,Office,Tier1_City,2,2,5,2,5,0,1,11.96,Healthcare,5,2,1,1,0,0,2,2,1,1,0,1,2,3,47.94
Computer Science,Geneticist,2.5006980183596994,1,2,4,0,8,0,3,1,2,1,0,3,1,0,Science,Bachelors,25-30,4,0,0,Hybrid,Tier2_City,1,5,4,2,1,2,5,32.04,Tech,5,3,1,3,3,4,5,2,5,2,1,1,2,2,43.27
Architecture,Physical Chemist,4.858354003309992,8,0,0,1,6,1,3,1,3,4,3,3,1,0,Interdisciplinary,Masters,25-30,0,1,54,Remote,Tier2_City,2,3,3,1,4,3,3,34.15,Healthcare,2,1,3,2,4,3,2,2,2,3,1,1,5,2,50.83
Music,Physicist,3.0884519046134544,5,1,3,0,1,1,0,2,0,2,2,4,2,1,Arts,Masters,25-30,13,0,0,Hybrid,Any,1,3,5,2,3,2,4,9.98,Healthcare,3,2,4,1,4,4,5,1,5,1,0,1,3,3,53.48
Computer Science,Psychologist,4.341758698127137,9,1,4,1,6,1,4,3,3,2,3,2,3,0,Science,Masters,36-40,2,0,0,Hybrid,Tier1_City,5,3,3,5,4,1,3,37.83,Education,3,5,5,2,0,5,1,2,3,4,1,1,5,2,57.77
Music,Analytical Chemist,4.155303492922362,8,2,1,1,8,1,3,3,0,2,1,0,4,0,Arts,High School,36-40,2,1,15,Hybrid,Any,1,5,2,2,4,3,1,14.75,Manufacturing,5,5,2,4,4,5,2,5,2,2,1,1,3,4,36.16
Marketing,AI Researcher,3.321148029363876,9,0,2,1,8,0,4,1,4,1,1,1,0,0,Commerce,Bachelors,18-24,6,0,0,Office,Any,5,4,5,5,5,5,1,16.3,Manufacturing,4,4,3,2,0,1,5,5,2,2,1,0,5,2,47.63
Business,School Psychologist,2.8400000127518794,1,2,1,1,4,0,1,4,2,3,0,4,2,0,Commerce,Bachelors,18-24,14,1,7,Office,Tier1_City,1,3,2,1,2,0,5,41.95,Other,2,5,5,2,4,4,4,4,1,2,1,0,1,3,52.49
Computer Science,Social Media Manager,3.936863034531653,6,2,2,1,4,1,3,0,1,1,1,0,4,1,Science,Bachelors,25-30,13,0,0,Office,Any,3,4,1,3,3,2,4,45.35,Healthcare,4,5,1,4,5,1,1,2,3,5,0,1,3,1,53.48
Art,Organic Chemist,4.020483917041869,9,1,3,1,5,0,3,4,0,4,0,0,4,1,Arts,Bachelors,18-24,12,0,0,Hybrid,Tier1_City,5,4,3,2,1,5,5,41.76,Other,5,3,1,4,1,3,1,4,4,2,0,0,2,1,57.26
Physics,Doctor,4.254816761388152,1,1,2,0,5,0,1,0,1,1,0,2,2,1,Science,High School,31-35,2,0,0,Office,Tier1_City,3,1,0,3,2,1,4,9.94,Other,4,1,1,2,2,3,4,4,2,2,1,1,1,4,28.44
Finance,Nurse,4.0904640198213045,7,0,3,0,8,0,0,2,2,3,1,3,0,1,Commerce,Bachelors,18-24,10,0,0,Remote,Any,2,2,4,5,1,1,4,49.97,Tech,3,2,1,3,4,2,1,2,2,3,0,1,1,1,52.89
Computer Science,Pharmacist,3.886884992396325,9,2,0,1,4,1,0,4,4,4,4,2,0,0,Science,Bachelors,25-30,4,1,28,Office,Tier1_City,1,5,1,2,0,3,5,34.59,Tech,5,2,4,3,0,4,4,4,2,5,1,1,5,1,58.06
Marketing,Special Education Teacher,3.770226300730683,8,1,0,1,3,1,0,1,3,0,4,4,0,1,Commerce,Bachelors,18-24,3,1,36,Remote,Tier2_City,2,2,0,4,4,3,3,27.0,Manufacturing,4,3,4,5,2,0,3,2,4,1,0,0,3,3,50.23
Architecture,Physician Assistant,2.7284643987240287,1,2,2,0,2,1,1,3,2,2,4,1,1,0,Interdisciplinary,Masters,25-30,3,0,0,Remote,Tier2_City,1,4,0,3,0,5,2,47.88,Finance,2,1,5,5,2,2,5,3,1,1,0,0,2,3,45.28
Engineering,Lawyer,3.158817426523358,4,2,3,0,9,1,1,1,2,0,3,4,1,1,Science,Masters,31-35,12,1,21,Remote,Tier1_City,5,4,1,2,4,4,4,41.42,Education,2,5,5,4,3,5,2,5,3,4,0,0,2,3,62.58
Computer Science,School Psychologist,3.0047298500129864,1,1,3,0,7,1,3,1,4,1,1,4,3,1,Science,Masters,25-30,6,0,0,Remote,Tier2_City,1,5,1,3,5,4,1,35.51,Healthcare,1,3,3,1,3,2,1,3,4,2,1,0,3,3,61.64
Marketing,Organic Chemist,3.55722410862135,5,2,3,1,0,0,2,0,2,1,1,2,0,0,Commerce,Bachelors,40+,0,0,0,Flexible,Tier1_City,4,2,3,2,2,3,5,42.4,Education,5,5,1,2,4,1,3,1,2,4,1,0,5,3,37.39
Biology,Counselor,4.656912690310808,1,0,0,0,1,0,2,3,1,4,4,3,4,0,Science,Bachelors,36-40,6,0,0,Hybrid,Tier1_City,4,1,4,1,1,4,3,21.12,Healthcare,5,2,1,4,3,2,4,1,1,1,1,0,3,2,50.1
Chemistry,Zoologist,4.82377161604566,6,2,3,1,3,1,0,2,1,0,4,3,1,1,Science,Bachelors,25-30,14,0,0,Flexible,Any,4,2,5,3,5,0,4,35.17,Healthcare,5,3,2,4,0,5,2,4,3,2,1,1,4,4,54.08
Engineering,Financial Controller,2.770696765030405,2,1,4,0,7,0,3,3,4,3,2,2,1,1,Science,Masters,18-24,7,0,0,Remote,Any,3,3,3,4,1,5,3,11.96,Other,3,3,2,4,3,5,4,3,5,2,1,0,2,3,67.41
Biology,Electrical Engineer,3.57082393247101,9,0,3,0,7,1,0,4,2,2,2,2,3,0,Science,Masters,36-40,2,0,0,Remote,Tier2_City,4,2,5,4,2,0,5,49.44,Manufacturing,3,3,1,3,1,2,4,3,1,1,0,0,3,2,42.37
Education,Quantum Physicist,3.4075412858243093,7,0,4,0,4,0,1,3,3,1,3,1,4,0,Arts,High School,36-40,14,0,0,Hybrid,Tier1_City,1,4,5,5,3,4,1,30.68,Education,5,2,2,1,4,2,4,2,3,2,1,1,2,5,50.5
Physics,Teacher,3.552411023792174,3,2,3,0,5,1,2,0,3,3,2,4,3,0,Science,PhD,36-40,2,1,57,Hybrid,Tier2_City,2,5,0,2,0,3,4,41.27,Education,4,2,2,3,2,5,1,4,2,5,1,1,4,3,52.93
Biology,Software Developer,4.78245392003014,2,0,1,0,6,1,0,2,0,4,3,2,1,1,Science,Bachelors,18-24,3,1,45,Hybrid,Any,3,3,5,3,0,0,4,22.14,Finance,3,4,1,5,5,1,3,5,3,2,0,0,4,4,44.81
Art,Credit Analyst,4.03514400956125,3,2,0,0,6,0,0,4,0,3,3,4,1,0,Arts,Bachelors,40+,14,0,0,Hybrid,Tier1_City,5,4,3,5,1,1,3,38.65,Finance,5,2,4,4,2,3,1,3,2,2,1,0,3,4,52.27
Biology,Education Administrator,4.209024504899428,4,0,3,0,4,1,0,0,1,0,0,2,4,1,Science,Masters,25-30,12,0,0,Office,Tier1_City,3,2,3,3,1,3,5,21.21,Education,3,2,4,3,1,2,2,3,1,4,1,1,4,4,46.18
Music,School Counselor,3.006804733455005,6,1,2,0,3,1,1,2,0,2,4,3,1,1,Arts,Masters,31-35,5,0,0,Hybrid,Any,2,5,4,2,1,5,2,30.73,Finance,1,5,5,4,0,3,3,2,5,3,1,1,2,3,59.74
Law,Financial Analyst,2.774539906208788,7,2,0,0,9,1,3,1,1,4,0,4,1,0,Arts,Masters,36-40,13,1,15,Hybrid,Tier2_City,4,3,2,4,2,2,4,39.57,Finance,2,2,4,1,2,3,2,2,1,1,0,1,5,1,49.92
Marketing,Doctor,4.871431026840165,4,2,2,0,2,0,0,1,3,2,3,3,1,1,Commerce,Masters,18-24,6,0,0,Hybrid,Tier1_City,2,2,4,1,3,2,1,8.47,Healthcare,1,1,1,2,1,5,1,5,2,1,1,0,1,1,46.35
Art,Urban Planner,3.5581314257421006,3,0,0,1,9,0,4,3,4,4,3,0,3,0,Arts,Bachelors,36-40,0,0,0,Office,Tier1_City,3,3,3,4,0,3,4,19.77,Manufacturing,5,5,2,3,3,5,5,4,4,1,0,0,1,5,49.45
Law,Nurse,2.84461313211452,1,0,3,1,6,1,0,3,2,1,4,3,4,1,Arts,Masters,25-30,14,1,39,Office,Any,3,1,2,5,5,4,4,28.61,Healthcare,2,4,1,1,4,5,5,2,1,4,1,0,1,5,58.42
Engineering,Marketing Manager,4.14356672904488,5,2,2,1,3,1,1,1,1,4,0,2,3,0,Science,Bachelors,40+,12,0,0,Hybrid,Tier2_City,3,1,5,1,4,0,2,18.7,Other,4,1,3,2,1,5,3,1,5,2,1,1,1,5,54.75
Physics,Marketing Manager,3.7335646015667328,3,0,1,1,9,0,0,2,3,3,0,4,0,1,Science,Masters,25-30,3,0,0,Remote,Tier1_City,2,5,0,5,2,0,2,17.53,Finance,5,4,2,4,1,1,5,3,4,3,0,1,3,3,53.38
Business,Risk Analyst,4.97704221645129,6,1,0,0,8,0,1,0,1,2,3,1,1,1,Commerce,Bachelors,40+,11,0,0,Hybrid,Any,1,1,4,2,0,3,5,16.24,Healthcare,4,3,1,1,3,3,4,1,4,4,0,1,5,2,52.43
Physics,Doctor,4.045308247473512,2,1,0,0,1,0,1,2,3,2,0,4,4,0,Science,Masters,18-24,6,0,0,Flexible,Tier3_City,1,4,1,1,3,1,4,13.71,Healthcare,4,3,5,5,0,5,5,1,2,3,1,0,4,5,55.31
Psychology,Dentist,4.593538475654422,0,0,3,1,8,0,2,0,0,1,3,3,1,0,Arts,Bachelors,31-35,10,1,18,Remote,Tier1_City,4,2,0,5,2,5,4,42.9,Tech,3,3,5,2,5,1,5,3,3,5,1,1,4,5,54.34
Music,Chemical Engineer,4.057946479778872,3,2,1,0,1,1,2,3,1,3,4,3,4,1,Arts,Masters,25-30,1,0,0,Office,Tier2_City,5,3,2,2,5,4,3,46.41,Healthcare,3,2,2,2,5,2,4,3,5,5,1,1,3,2,61.56
Biology,Counselor,2.544597786851869,4,1,2,1,7,1,2,3,0,4,1,2,2,1,Science,Bachelors,25-30,0,0,0,Hybrid,Tier1_City,2,3,0,4,0,1,3,35.91,Healthcare,2,2,4,4,3,0,4,2,2,4,1,1,5,5,38.9
Psychology,Human Resources Specialist,2.797925090241715,4,2,3,1,1,1,1,4,2,1,4,2,0,1,Arts,Masters,18-24,0,0,0,Hybrid,Tier2_City,1,1,1,2,2,3,1,4.41,Manufacturing,2,5,5,5,3,1,2,4,5,4,1,1,5,5,57.6
Engineering,Musician,4.26570865085019,9,2,1,0,9,1,3,4,4,3,1,3,1,0,Science,Bachelors,31-35,9,0,0,Flexible,Tier1_City,4,3,1,3,0,3,1,39.95,Education,3,1,3,3,2,5,1,3,3,3,0,1,2,2,62.91
Biology,Acoustics Specialist,3.9928894709334246,3,1,0,0,3,0,3,0,2,0,4,2,4,0,Science,Bachelors,18-24,13,0,0,Hybrid,Tier1_City,5,3,4,2,0,1,3,28.0,Tech,2,1,2,1,5,0,3,4,2,4,0,0,4,4,51.05
Music,Composer,2.829119907325276,8,1,4,0,8,1,0,1,3,4,1,2,4,0,Arts,Bachelors,25-30,13,0,0,Office,Tier2_City,4,2,5,2,3,2,1,38.63,Tech,1,3,3,4,1,2,4,3,1,2,1,1,5,3,48.05
Finance,Physician Assistant,4.448400788633768,1,0,1,1,3,1,2,3,1,4,0,4,4,0,Commerce,Bachelors,25-30,5,0,0,Hybrid,Tier2_City,4,5,4,3,4,3,4,23.55,Tech,5,3,2,5,1,0,3,1,1,4,0,1,5,3,50.19
Education,Quantum Physicist,3.5954412464111307,2,2,3,0,7,1,0,1,0,1,4,0,1,0,Arts,Masters,40+,11,0,0,Remote,Tier1_City,5,3,3,5,3,5,2,4.94,Other,1,2,4,2,3,4,2,1,4,4,1,0,4,2,57.52
Biology,Credit Analyst,4.438427533419995,3,2,1,1,5,1,1,1,3,1,1,0,3,1,Science,Bachelors,18-24,4,0,0,Office,Tier1_City,3,1,3,5,0,4,4,35.04,Tech,5,4,1,2,3,4,5,5,3,2,0,1,2,5,33.9
Psychology,Doctor,2.524025714859995,7,2,2,0,1,0,3,0,1,4,0,4,0,1,Arts,PhD,18-24,0,0,0,Flexible,Any,1,1,0,2,2,1,3,23.87,Manufacturing,3,1,2,2,1,5,1,2,2,1,1,0,4,4,40.54
Art,Physical Chemist,4.115040055401629,0,0,4,1,3,1,3,1,3,4,4,4,0,1,Arts,Bachelors,18-24,9,1,57,Office,Tier1_City,1,5,1,3,5,2,5,44.08,Education,1,1,1,5,1,2,1,2,3,1,0,0,5,2,67.22
Physics,School Counselor,3.751540599287893,3,1,4,1,8,1,1,3,3,0,2,1,1,1,Science,Bachelors,25-30,2,0,0,Remote,Tier2_City,5,3,0,3,3,1,5,37.69,Other,4,4,2,5,1,3,4,3,3,5,1,0,4,1,49.81
Business,Education Administrator,3.471636376224553,7,1,3,1,2,0,4,0,4,3,2,3,1,0,Commerce,Masters,18-24,14,1,10,Hybrid,Tier1_City,1,3,2,4,4,2,3,19.9,Manufacturing,1,1,4,3,0,3,5,3,1,4,1,0,5,5,67.64
Physics,Financial Analyst,3.775845719300928,8,0,2,0,0,1,2,4,4,3,0,4,1,1,Science,Masters,25-30,10,0,0,Hybrid,Tier2_City,2,3,2,5,0,2,4,37.03,Tech,2,1,3,1,3,1,1,2,2,5,1,1,5,1,67.52
Business,Special Education Teacher,3.083215761572844,6,2,4,1,1,0,1,0,4,2,4,1,3,1,Commerce,Bachelors,36-40,6,1,57,Hybrid,Tier1_City,2,5,3,1,5,5,1,26.27,Education,1,2,1,2,3,5,3,5,4,4,1,1,1,4,57.91
Marketing,Quantum Physicist,3.606848263315983,8,0,1,0,1,0,0,1,2,0,3,2,1,0,Commerce,Masters,31-35,11,0,0,Remote,Tier1_City,2,1,5,5,3,4,1,12.37,Manufacturing,3,1,3,3,2,4,5,3,2,2,0,0,3,4,50.33
Marketing,Composer,4.869992711227923,7,0,3,1,7,1,1,4,0,3,2,1,1,0,Commerce,Masters,25-30,8,0,0,Remote,Tier2_City,5,3,0,5,3,3,5,22.73,Education,3,3,2,5,2,1,4,4,1,3,1,1,1,1,51.58
Engineering,Investment Banker,2.678756016197737,2,0,4,1,6,1,2,4,0,3,3,3,2,0,Science,Bachelors,18-24,12,0,0,Office,Tier1_City,4,3,2,4,3,2,3,13.46,Other,2,3,2,3,4,2,3,3,4,4,0,1,3,5,65.42
Business,Financial Controller,3.3420687376585425,1,0,2,0,9,1,4,4,0,2,3,0,3,0,Commerce,PhD,31-35,8,0,0,Office,Tier2_City,4,4,3,1,3,3,3,3.23,Manufacturing,5,5,4,2,1,0,1,4,4,5,1,1,1,1,69.8
Chemistry,Counselor,4.412119385223923,7,2,2,0,3,0,4,1,1,0,2,4,0,1,Science,PhD,18-24,14,1,36,Office,Tier1_City,3,2,0,4,5,4,2,14.6,Education,2,2,2,1,1,5,3,4,5,5,1,0,4,2,74.38
Physics,Legal Secretary,3.5848390056509176,5,2,0,1,3,1,3,3,0,4,0,1,3,0,Science,Masters,31-35,5,0,0,Flexible,Tier1_City,3,5,1,1,2,3,5,12.85,Manufacturing,5,2,4,3,4,5,5,1,2,4,1,1,5,5,48.9
Engineering,Human Resources Specialist,2.753974148866076,8,2,0,0,6,1,4,1,4,4,1,0,2,0,Science,Bachelors,25-30,2,0,0,Hybrid,Tier3_City,2,2,2,2,4,5,3,3.2,Tech,3,3,2,5,3,4,3,1,5,5,1,1,3,3,58.01
Business,Zoologist,4.5457592519455225,4,2,2,1,7,1,3,2,4,3,0,4,0,1,Commerce,Masters,25-30,0,1,55,Flexible,Tier1_City,2,5,5,1,4,5,2,39.84,Tech,3,2,3,4,1,3,4,5,1,5,1,1,1,1,56.43
Psychology,Microbiologist,3.275887635398215,4,0,4,0,4,1,1,4,3,1,2,4,3,0,Arts,Bachelors,25-30,2,0,0,Office,Tier1_City,5,2,2,4,0,0,1,6.62,Tech,5,2,2,4,2,1,1,1,2,2,0,1,2,3,43.42
Finance,Biomedical Engineer,3.7049131047775608,0,2,1,1,2,1,1,1,2,4,4,2,3,0,Commerce,High School,36-40,9,0,0,Flexible,Tier1_City,2,4,1,5,1,5,5,24.11,Other,1,5,1,3,0,0,3,4,2,5,0,0,3,1,53.3
Law,Legal Consultant,2.7460013963007626,6,2,0,1,9,0,3,0,3,2,0,1,3,0,Arts,Bachelors,18-24,1,0,0,Remote,Tier1_City,2,2,3,1,2,2,5,22.64,Manufacturing,1,4,5,5,5,3,3,5,2,1,1,1,2,1,36.71
Medicine,Lawyer,2.731230080781108,3,1,1,0,2,1,4,0,2,0,3,2,2,1,Science,Bachelors,25-30,10,0,0,Remote,Tier1_City,2,3,2,1,0,4,3,11.53,Education,2,1,1,3,3,3,2,1,5,1,0,0,5,5,55.92
Art,Acoustics Specialist,4.753498784974873,7,1,3,0,7,0,1,0,1,3,1,0,0,1,Arts,Masters,18-24,4,1,27,Office,Tier1_City,1,2,1,3,0,5,3,48.44,Education,3,5,1,3,0,5,5,1,3,3,1,1,5,3,41.68
Psychology,Lawyer,3.9869650230329774,7,2,3,0,4,1,1,1,3,4,4,4,2,0,Arts,Masters,31-35,7,0,0,Flexible,Tier1_City,4,2,3,5,3,1,4,31.38,Finance,1,4,4,4,0,2,4,4,3,1,0,0,5,2,59.73
Finance,Graphic Designer,4.673539505093884,6,0,2,1,1,1,2,0,0,2,2,3,1,0,Commerce,Masters,36-40,4,0,0,Office,Any,1,1,4,2,1,4,1,41.24,Healthcare,3,1,2,3,4,3,1,3,3,1,0,0,5,4,44.27
Biology,Game Developer,4.645426968239642,2,0,4,1,9,1,2,4,2,1,0,1,2,1,Science,Bachelors,25-30,0,0,0,Office,Tier1_City,2,5,3,4,1,2,1,26.32,Tech,2,3,3,4,0,3,3,5,5,2,1,1,2,2,38.19
Law,Sound Engineer,2.773631471017561,4,0,3,1,9,1,3,4,2,0,4,1,0,1,Arts,Bachelors,25-30,2,0,0,Hybrid,Any,2,2,2,2,2,4,2,36.97,Tech,4,4,2,5,1,3,2,1,5,4,0,1,1,3,54.45
Psychology,Legal Secretary,3.0469069168087564,4,2,0,1,9,1,3,0,4,0,4,2,1,1,Arts,Bachelors,36-40,11,0,0,Office,Tier3_City,1,3,3,5,1,5,2,48.58,Tech,3,1,5,5,4,0,5,4,4,2,0,1,2,4,60.64
Engineering,Architectural Technologist,2.58963478739815,4,1,4,1,1,1,4,4,2,1,4,1,2,1,Science,PhD,25-30,4,0,0,Office,Tier1_City,1,3,5,1,0,1,4,19.38,Finance,4,5,2,5,2,0,4,1,3,5,1,0,3,3,68.56
Psychology,Mechanical Engineer,3.192277226820485,1,1,2,1,3,1,3,3,0,4,2,2,3,1,Arts,High School,25-30,6,0,0,Office,Tier1_City,5,5,2,1,1,0,1,26.7,Finance,3,1,5,4,0,3,2,3,5,1,0,1,5,4,51.27
Psychology,Quantum Physicist,3.308116367570677,8,0,1,1,5,1,2,4,3,3,0,3,1,1,Arts,Masters,25-30,4,1,48,Office,Tier1_City,5,4,3,5,1,2,2,27.18,Finance,5,2,5,2,1,5,5,2,4,5,1,0,2,3,61.54
Marketing,Marketing Manager,3.949139911269128,4,2,2,0,6,0,2,4,1,0,4,2,0,1,Commerce,Masters,31-35,13,0,0,Remote,Tier2_City,2,5,4,1,4,2,1,49.62,Tech,4,1,1,2,1,2,1,5,1,4,0,1,2,3,62.62
Education,Mechanical Engineer,3.6012515947054062,0,0,1,0,3,1,3,1,3,4,0,3,1,1,Arts,Bachelors,18-24,9,0,0,Office,Tier2_City,1,3,3,1,0,4,1,13.96,Education,5,3,5,2,2,3,4,5,1,4,1,1,2,4,53.73
Marketing,Chemical Engineer,4.13266163476268,0,0,2,1,2,0,2,2,0,1,3,0,4,1,Commerce,Masters,36-40,4,0,0,Hybrid,Tier2_City,5,4,4,1,5,3,2,34.74,Tech,5,5,5,2,4,4,1,4,5,3,0,1,5,3,54.04
Computer Science,Human Resources Specialist,4.140517958454076,5,1,4,1,0,0,3,2,1,1,1,0,2,0,Science,Bachelors,25-30,6,1,46,Flexible,Tier2_City,3,4,2,4,1,3,3,9.5,Finance,2,4,3,5,4,4,5,4,4,3,1,0,5,4,46.78
Architecture,Forensic Psychologist,3.16074790124114,3,1,0,1,5,0,1,0,2,2,0,1,4,0,Interdisciplinary,Masters,18-24,12,0,0,Hybrid,Tier1_City,1,1,3,4,1,1,3,46.57,Finance,2,1,4,2,4,1,3,1,4,2,1,0,3,3,47.67
Education,Advertising Manager,3.834980522730018,3,1,2,1,7,0,2,2,4,1,3,2,1,0,Arts,PhD,31-35,14,1,13,Hybrid,Tier3_City,4,2,1,3,3,0,2,30.75,Healthcare,1,5,2,3,2,4,3,5,5,1,0,0,4,3,71.83
Music,Musician,3.595820614252545,8,2,0,1,7,0,2,2,2,4,4,2,4,1,Arts,Bachelors,25-30,7,1,29,Flexible,Tier1_City,3,1,5,2,1,0,4,43.39,Manufacturing,4,3,3,4,2,1,3,1,2,5,0,1,3,3,62.36
Business,Zoologist,4.602115357335547,9,0,3,0,2,0,2,4,2,3,2,3,1,1,Commerce,Bachelors,18-24,13,1,21,Remote,Any,3,2,4,5,1,4,5,45.08,Healthcare,1,4,4,2,2,1,1,2,1,3,1,1,1,5,55.53
Art,Judge,4.403253790821194,2,1,2,1,4,0,2,4,4,3,4,4,0,1,Arts,Masters,31-35,7,0,0,Remote,Tier1_City,1,1,0,5,4,4,1,29.18,Healthcare,4,1,1,5,4,1,1,5,1,4,0,1,5,5,72.84
Business,School Counselor,4.597810874254581,6,1,1,0,5,0,3,2,3,0,4,4,1,1,Commerce,PhD,36-40,6,0,0,Office,Tier1_City,2,4,4,5,0,3,5,35.05,Tech,2,3,3,2,0,1,1,2,2,4,0,1,2,4,62.23
Chemistry,Conductor,3.12306691915816,6,1,2,1,2,0,4,2,2,0,3,2,2,1,Science,Bachelors,36-40,12,0,0,Hybrid,Any,4,2,3,3,2,5,2,35.84,Manufacturing,2,2,3,4,2,3,3,1,1,3,0,0,4,1,53.6
Finance,Risk Analyst,4.937099227174048,7,0,2,1,6,0,1,1,2,1,4,1,3,1,Commerce,Masters,40+,13,1,25,Hybrid,Tier2_City,5,3,4,4,0,0,1,24.64,Manufacturing,2,5,1,1,2,5,5,3,1,4,1,0,5,1,49.76
Art,Industrial-Organizational Psychologist,3.795421658258971,3,0,2,1,6,1,3,4,2,0,2,0,1,1,Arts,Masters,36-40,2,1,56,Flexible,Tier3_City,5,4,3,3,3,5,5,23.44,Tech,4,5,5,1,4,0,3,2,1,1,1,0,2,5,38.75
Psychology,Architect,4.57391292861482,8,0,2,1,4,0,3,1,4,2,0,0,4,1,Arts,Masters,18-24,10,1,25,Hybrid,Tier2_City,2,5,2,5,0,0,3,11.75,Education,2,1,1,5,2,4,5,3,1,1,1,0,1,1,51.18
Physics,Ecologist,3.9810805458344327,4,2,1,0,7,1,0,4,4,1,0,0,1,1,Science,Bachelors,25-30,1,0,0,Remote,Any,4,4,2,2,1,5,4,21.04,Other,1,3,2,5,0,4,5,5,3,2,1,0,5,5,39.85
Engineering,Physical Chemist,4.704557682812567,2,0,2,0,4,0,4,0,0,0,3,3,1,1,Science,Masters,36-40,0,0,0,Hybrid,Any,4,3,5,1,3,5,5,49.57,Tech,5,4,1,5,4,4,5,3,5,1,0,1,4,2,47.2
Biology,Geneticist,4.385589100782209,8,2,2,1,7,1,3,0,2,1,1,4,2,0,Science,PhD,25-30,5,0,0,Remote,Tier2_City,3,1,1,4,0,0,4,15.68,Education,4,4,3,2,2,1,4,3,2,3,1,1,5,4,51.31
Education,Zoologist,4.249329277758951,6,2,1,0,6,1,2,0,0,0,4,0,2,1,Arts,Bachelors,31-35,12,0,0,Hybrid,Tier1_City,3,2,0,4,3,1,3,38.83,Education,5,4,1,4,2,2,1,1,1,3,0,0,4,4,50.48
Chemistry,Legal Consultant,3.4106001462526447,6,0,4,1,2,0,0,0,3,3,2,2,4,1,Science,Bachelors,31-35,8,0,0,Remote,Tier2_City,4,1,5,3,2,1,5,5.79,Manufacturing,1,4,2,4,3,0,5,1,3,1,1,0,4,5,45.09
Music,School Psychologist,4.674527119034053,8,0,2,1,8,0,0,2,2,4,3,2,2,1,Arts,PhD,25-30,2,0,0,Flexible,Any,1,1,2,4,0,4,2,24.97,Tech,3,1,5,4,3,2,5,1,5,3,1,1,4,3,55.42
Education,Clinical Psychologist,3.693907548642008,2,1,1,1,4,1,3,3,0,3,4,3,3,0,Arts,Bachelors,36-40,4,1,38,Hybrid,Tier2_City,1,2,1,5,5,5,1,5.75,Tech,2,1,5,1,1,2,5,1,2,2,0,0,3,5,52.99
Education,Entrepreneur,2.6870709781944524,9,1,2,0,7,1,4,2,0,2,2,1,1,0,Arts,Masters,25-30,8,0,0,Remote,Any,1,1,0,5,1,5,3,25.36,Manufacturing,1,5,4,4,1,4,1,5,1,2,0,1,1,3,49.8
Art,Judge,4.500161306623763,8,0,1,1,3,0,1,3,0,2,0,4,0,1,Arts,Bachelors,25-30,13,1,33,Hybrid,Tier1_City,4,3,1,3,3,5,4,4.29,Healthcare,3,3,4,5,2,2,4,1,1,4,0,1,5,4,51.86
Computer Science,Actuary,3.820213499207744,2,1,4,0,4,0,0,0,0,4,3,4,0,1,Science,Bachelors,40+,13,1,10,Hybrid,Any,5,5,2,5,5,5,4,31.82,Tech,4,2,2,2,3,3,1,5,1,2,0,0,5,5,50.13
Art,Industrial-Organizational Psychologist,2.548292819610888,3,1,2,0,7,1,1,3,1,2,3,3,2,1,Arts,Masters,25-30,8,0,0,Hybrid,Tier1_City,1,2,5,2,5,5,3,30.57,Other,1,1,4,1,1,2,3,5,4,5,0,0,4,4,67.19
Medicine,Conductor,3.90149491081693,3,0,4,1,9,1,2,3,0,4,3,2,0,1,Science,Bachelors,18-24,6,0,0,Hybrid,Tier1_City,5,1,0,3,4,3,2,40.5,Other,4,4,5,2,4,2,1,3,3,1,1,1,2,3,51.66
Architecture,Data Scientist,2.6531482855848583,7,0,2,1,9,0,3,1,0,2,1,0,2,0,Interdisciplinary,Bachelors,25-30,13,0,0,Flexible,Tier2_City,1,2,2,2,3,2,2,30.41,Finance,5,2,5,3,3,4,1,5,5,3,1,1,4,5,53.92
Computer Science,Musician,2.836467813536144,8,1,0,1,1,0,2,0,0,0,3,1,0,0,Science,Bachelors,36-40,3,0,0,Hybrid,Tier2_City,4,1,3,1,5,5,4,46.52,Finance,5,5,4,5,0,2,2,1,2,3,0,0,5,2,39.29
Music,Nuclear Physicist,2.722837880549928,7,1,0,1,2,1,3,3,0,1,4,0,2,0,Arts,Masters,31-35,10,0,0,Hybrid,Tier1_City,1,3,5,2,4,3,3,39.81,Tech,4,4,1,1,0,1,2,4,2,2,0,0,5,4,58.7
Business,Architect,4.468229835196153,0,2,2,1,4,1,2,3,3,4,3,3,3,0,Commerce,Bachelors,31-35,1,0,0,Office,Any,5,4,0,1,5,1,3,9.23,Education,5,3,5,5,0,5,4,3,3,2,1,0,5,2,53.22
Physics,Physician Assistant,4.4910500117382846,6,2,0,1,3,1,1,1,4,1,4,2,3,1,Science,Bachelors,31-35,1,1,34,Hybrid,Any,2,5,1,1,1,5,1,15.48,Other,5,2,4,2,0,0,1,5,3,2,1,1,4,4,44.56
Business,Forensic Psychologist,3.493333403846961,4,0,3,0,7,1,4,3,4,1,3,4,2,0,Commerce,PhD,25-30,3,0,0,Remote,Tier3_City,5,5,3,2,2,1,4,4.23,Other,2,5,4,4,3,3,2,3,1,3,1,0,4,5,61.25
Medicine,Paralegal,4.5367290913961416,3,1,3,1,0,0,1,1,4,4,0,2,2,1,Science,Bachelors,36-40,0,0,0,Remote,Tier1_City,2,2,1,3,4,4,2,21.15,Manufacturing,4,1,2,3,4,0,1,5,2,5,0,0,3,5,48.51
Biology,Human Resources Specialist,3.9656566283119545,4,2,3,1,2,1,4,1,0,0,0,0,1,0,Science,Masters,36-40,13,1,34,Flexible,Tier1_City,5,5,2,5,2,2,5,26.95,Other,4,3,2,5,0,1,5,5,1,3,1,0,5,3,47.66
Art,Biologist,2.679571633341125,5,1,2,1,5,1,0,0,2,3,0,0,4,1,Arts,Bachelors,18-24,3,0,0,Flexible,Tier2_City,1,1,2,5,3,0,2,47.46,Education,3,4,5,3,4,2,2,3,3,2,1,1,5,2,36.1
Finance,Game Developer,2.6924346341722223,3,0,2,1,7,0,1,4,0,4,2,1,0,1,Commerce,Masters,18-24,11,0,0,Remote,Tier3_City,1,3,3,1,1,2,2,27.55,Finance,2,2,3,2,1,4,2,3,3,5,1,0,5,2,63.42
Medicine,School Counselor,3.3939956819532955,7,1,3,0,4,0,3,3,2,4,1,0,2,0,Science,Bachelors,40+,13,1,35,Hybrid,Tier1_City,5,3,3,1,4,5,5,39.71,Finance,1,5,4,5,1,0,2,2,3,2,1,1,4,1,59.69
Chemistry,Composer,3.473629558652366,6,2,3,0,9,0,0,0,1,1,1,4,3,1,Science,PhD,36-40,10,0,0,Remote,Tier2_City,1,2,0,3,3,5,4,15.6,Manufacturing,2,2,1,4,2,2,1,2,5,5,0,1,5,3,64.47
Education,Education Administrator,2.743889346827451,0,1,1,1,0,0,1,2,2,0,4,3,2,0,Arts,Bachelors,36-40,5,0,0,Office,Tier2_City,1,1,1,4,5,2,1,10.2,Finance,1,3,3,3,3,0,5,1,5,2,0,0,4,5,52.5
Finance,Industrial-Organizational Psychologist,2.7561292516842832,1,1,1,0,7,1,3,3,2,3,4,1,3,0,Commerce,Bachelors,36-40,5,1,28,Remote,Tier3_City,4,5,4,2,0,2,2,41.11,Healthcare,4,1,4,1,0,2,1,5,1,5,1,0,1,1,50.1
Biology,Paralegal,3.545072598316282,7,2,3,0,9,1,2,4,4,2,2,0,1,0,Science,Bachelors,25-30,6,0,0,Remote,Tier2_City,3,1,2,1,3,4,2,14.63,Finance,2,1,3,2,4,4,2,3,3,1,1,0,3,2,47.66
Art,Electrical Engineer,4.878690745441848,0,1,3,0,0,0,4,0,4,2,2,4,2,0,Arts,Bachelors,31-35,4,0,0,Office,Tier2_City,3,5,4,5,2,1,4,43.95,Other,3,3,4,5,4,5,5,4,1,5,1,1,1,5,58.88
Biology,Art Therapist,2.6744847579930138,9,2,0,0,1,1,3,1,0,3,2,3,2,0,Science,Bachelors,25-30,8,0,0,Hybrid,Tier1_City,5,1,4,3,1,0,4,10.98,Education,5,4,4,1,5,1,2,3,1,2,0,0,2,5,45.81
Engineering,Social Media Manager,3.760487980160645,4,2,4,1,7,0,4,4,2,1,4,1,0,1,Science,Bachelors,18-24,1,0,0,Remote,Tier1_City,3,5,3,2,1,2,3,43.02,Education,1,2,3,4,3,0,4,2,5,4,0,0,1,4,57.08
Marketing,Paralegal,3.096551396552849,7,2,4,1,2,1,3,2,4,2,3,4,4,0,Commerce,Masters,31-35,1,1,31,Office,Any,2,5,1,3,3,0,4,39.32,Healthcare,5,4,2,4,1,3,5,3,4,2,1,0,3,3,59.59
Finance,Surgeon,4.382527979602347,3,2,2,1,2,1,0,1,1,0,0,4,3,1,Commerce,Bachelors,25-30,3,1,20,Office,Tier1_City,5,3,4,2,5,2,4,31.73,Education,4,5,4,3,3,1,4,4,5,4,1,1,2,1,46.73
Architecture,Financial Advisor,4.023855435253016,7,2,0,0,9,1,3,3,4,4,3,4,4,1,Interdisciplinary,Bachelors,31-35,14,0,0,Office,Any,5,4,1,2,0,1,2,42.96,Education,4,4,5,2,4,5,3,3,1,3,0,1,5,3,60.13
Computer Science,Quantum Physicist,3.329142040338502,9,1,1,0,8,0,4,3,3,3,2,0,1,1,Science,Masters,25-30,3,1,40,Flexible,Tier1_City,2,4,3,1,2,0,1,18.54,Education,4,3,3,5,3,4,2,3,5,5,0,1,5,2,65.71
Marketing,Interior Designer,2.612926363985145,4,0,0,1,1,1,2,4,4,4,1,2,2,1,Commerce,Masters,25-30,3,1,30,Hybrid,Tier2_City,3,2,5,3,3,3,2,10.8,Tech,5,1,2,1,5,5,3,4,3,5,1,1,5,4,59.39
Medicine,Actuary,3.7870021403238088,3,2,1,0,3,1,0,2,1,2,1,0,3,0,Science,Bachelors,18-24,0,0,0,Remote,Tier1_City,2,4,5,3,3,1,4,10.38,Healthcare,4,3,1,5,1,3,1,2,3,2,0,1,3,4,31.78
Computer Science,Chemist,3.539731922711887,8,1,2,1,9,0,0,4,1,2,4,4,3,0,Science,Bachelors,25-30,3,0,0,Remote,Any,1,2,5,5,1,0,3,15.71,Healthcare,4,3,4,1,1,2,4,3,2,3,0,1,2,4,45.83
Finance,School Psychologist,4.503836702352007,8,1,2,1,2,0,3,0,1,3,4,3,1,1,Commerce,High School,18-24,11,0,0,Hybrid,Any,5,3,5,5,2,2,1,23.97,Finance,5,2,4,2,5,5,3,2,4,2,0,1,2,1,55.15
Chemistry,Architect,4.7395849315737,4,1,1,0,1,0,2,1,0,0,0,1,3,0,Science,Masters,18-24,4,0,0,Remote,Tier1_City,4,2,4,1,0,2,3,44.17,Other,4,3,5,4,0,0,3,4,5,1,1,1,2,3,37.62
Education,Civil Engineer,2.509816370415349,7,0,2,1,7,0,2,0,4,2,3,2,0,1,Arts,Masters,40+,8,0,0,Hybrid,Tier1_City,2,4,4,1,1,1,5,7.21,Healthcare,1,5,2,4,0,5,2,3,4,1,0,1,5,2,59.64
Computer Science,Investment Banker,3.8003041362156447,3,2,4,0,3,0,1,0,1,3,0,3,4,1,Science,Bachelors,18-24,2,0,0,Remote,Tier3_City,5,5,2,4,3,1,3,46.02,Manufacturing,2,2,4,5,5,3,5,3,2,4,1,1,4,4,38.7
Biology,Physicist,4.777384960362773,7,2,2,0,4,1,0,1,2,3,2,2,3,1,Science,Masters,25-30,14,0,0,Hybrid,Any,5,2,4,5,1,2,3,46.5,Healthcare,1,2,2,5,0,5,2,5,3,5,0,0,1,1,61.61
Education,Clinical Psychologist,2.8772563290175555,5,1,1,0,2,1,2,4,3,4,1,0,4,0,Arts,Masters,25-30,2,1,53,Remote,Tier2_City,2,4,0,2,1,0,4,37.18,Manufacturing,4,4,4,3,1,1,2,1,1,4,1,1,4,2,46.92
Medicine,Physicist,3.6033414384616624,8,2,0,1,7,0,3,3,3,3,2,3,0,1,Science,Masters,31-35,13,1,26,Hybrid,Any,4,4,3,3,4,3,4,45.31,Education,4,3,1,1,4,5,1,4,5,4,1,0,4,5,71.56
Business,Judge,2.652224088927534,8,0,0,0,9,0,0,3,1,3,0,0,4,1,Commerce,Masters,18-24,4,0,0,Office,Tier1_City,5,5,0,1,1,4,4,39.19,Other,4,4,5,3,0,3,4,2,3,5,0,1,3,5,44.2
Computer Science,Financial Controller,4.256982900720942,3,2,3,0,1,1,4,4,1,4,4,2,3,0,Science,Bachelors,31-35,9,1,27,Hybrid,Tier2_City,1,1,5,3,5,1,4,27.83,Manufacturing,4,4,1,1,3,4,1,4,2,1,1,0,1,4,58.79
Art,School Psychologist,2.7815312552066724,4,0,4,0,7,0,4,1,2,1,2,2,3,1,Arts,Bachelors,31-35,5,0,0,Hybrid,Tier3_City,1,4,4,3,1,2,4,31.24,Other,5,2,1,2,4,3,5,5,1,4,1,1,4,1,43.46
Law,Landscape Architect,2.674148213892701,3,1,0,1,2,1,0,0,0,3,3,0,4,1,Arts,Bachelors,18-24,2,0,0,Flexible,Tier1_City,1,3,4,4,5,0,3,32.53,Other,2,4,3,5,5,0,3,4,3,5,0,0,4,2,45.83
Marketing,Biologist,4.362263778110732,7,2,1,1,5,0,4,4,4,4,2,0,2,0,Commerce,Bachelors,25-30,0,0,0,Office,Tier3_City,4,5,0,5,2,1,5,8.96,Tech,5,4,1,1,2,5,4,1,3,1,0,0,5,3,45.23
Marketing,Advertising Manager,2.749887472276545,8,1,4,0,5,0,1,2,1,0,1,1,3,0,Commerce,Bachelors,36-40,9,1,23,Hybrid,Any,3,1,2,1,1,0,4,12.07,Other,5,2,5,4,0,0,1,4,3,5,0,1,4,3,52.89
Art,Software Developer,2.8876316953718257,9,0,0,0,4,1,3,3,0,4,2,3,3,1,Arts,PhD,36-40,7,1,15,Hybrid,Any,1,5,2,3,0,1,5,27.6,Education,4,2,5,2,2,2,1,2,5,5,0,1,4,2,70.11
Music,Education Administrator,4.470004532267255,4,2,1,1,9,0,4,0,3,0,3,3,3,0,Arts,High School,31-35,11,1,27,Hybrid,Tier1_City,2,2,0,1,5,2,5,8.42,Manufacturing,1,1,4,4,0,3,5,2,5,2,0,0,3,5,65.03
Medicine,Teacher,2.83260906595535,1,0,3,1,8,0,0,1,4,2,4,2,2,0,Science,Bachelors,18-24,0,1,49,Remote,Tier1_City,3,4,0,2,5,0,2,48.35,Other,1,3,1,2,4,3,3,1,1,1,1,0,5,4,35.22
Marketing,Industrial-Organizational Psychologist,4.82944356041901,0,1,4,0,0,0,0,0,3,0,0,3,4,0,Commerce,Bachelors,25-30,1,0,0,Remote,Tier2_City,2,4,3,4,3,2,2,26.83,Education,3,1,2,1,2,4,3,5,5,4,1,1,5,3,39.75
Education,Architectural Technologist,3.4308668373352846,5,1,0,1,7,0,4,3,1,1,1,0,3,0,Arts,PhD,25-30,2,1,24,Hybrid,Tier1_City,4,5,2,2,2,0,1,20.86,Tech,2,2,3,4,1,0,4,3,2,5,1,0,4,1,51.01
Psychology,Marketing Manager,4.4814764666466615,1,2,1,1,1,0,0,3,0,1,2,2,1,1,Arts,Bachelors,18-24,5,0,0,Hybrid,Any,1,2,5,1,1,1,2,10.4,Education,3,5,3,1,0,1,4,3,1,2,0,1,1,1,33.65
Computer Science,Manager,4.196294045465844,1,1,4,0,7,1,4,1,4,0,3,0,4,0,Science,Bachelors,25-30,3,0,0,Remote,Tier1_City,5,5,1,1,0,4,4,22.58,Education,5,4,3,3,5,2,2,1,3,3,0,1,2,1,44.69
Art,Counselor,2.6350683031570528,5,2,1,1,6,1,1,3,1,4,4,4,1,1,Arts,High School,31-35,3,0,0,Remote,Tier3_City,1,3,5,5,3,4,5,17.21,Healthcare,3,4,5,2,5,3,5,1,2,3,1,0,1,1,44.44
Finance,Nurse,2.506163625634932,4,1,4,1,5,0,1,0,2,3,1,4,3,0,Commerce,Bachelors,25-30,14,0,0,Remote,Tier1_City,4,4,4,3,2,3,1,7.13,Finance,3,2,5,5,3,2,4,2,3,2,0,1,1,2,56.9
Physics,School Psychologist,3.7874363088995313,7,0,2,0,4,0,2,3,4,1,3,4,3,1,Science,PhD,31-35,8,0,0,Flexible,Tier2_City,1,4,4,3,5,3,2,48.45,Manufacturing,3,4,4,4,2,3,5,1,1,1,0,1,1,2,64.59
Psychology,Market Research Analyst,2.541420087805521,2,1,2,1,3,1,3,4,4,2,0,2,3,0,Arts,PhD,36-40,5,0,0,Remote,Tier1_City,1,3,0,2,0,5,3,15.45,Finance,2,1,1,1,5,5,4,2,3,3,0,1,4,2,58.28
Education,Astronomer,3.33656831772894,1,2,0,1,9,0,4,1,1,0,2,0,4,1,Arts,High School,25-30,11,0,0,Remote,Tier1_City,1,1,5,4,1,2,1,35.45,Tech,1,4,5,4,3,3,5,4,4,4,0,1,5,2,50.34
Marketing,Investment Banker,4.213945256686175,8,2,3,0,9,0,2,2,4,3,0,4,2,1,Commerce,PhD,36-40,1,0,0,Hybrid,Tier2_City,4,4,1,3,4,0,4,7.29,Tech,1,5,3,1,2,4,2,2,2,2,0,0,3,3,51.2
Music,Industrial-Organizational Psychologist,4.250349694527723,2,1,2,0,1,0,3,0,1,1,3,3,3,0,Arts,Masters,18-24,6,0,0,Hybrid,Tier2_City,1,5,2,5,4,3,5,45.92,Education,3,3,5,3,4,3,1,2,1,5,0,0,5,4,57.89
Engineering,Marketing Specialist,4.403994604219585,3,1,1,1,8,0,1,3,4,2,0,2,2,0,Science,Masters,36-40,14,0,0,Hybrid,Tier3_City,5,1,2,2,2,1,4,30.77,Finance,2,1,1,5,3,2,1,4,1,2,1,1,4,3,58.68
Physics,Zoologist,4.363813085889955,4,2,3,1,1,0,1,3,1,0,0,0,3,1,Science,Bachelors,18-24,12,0,0,Hybrid,Tier1_City,5,1,2,2,0,4,4,33.87,Manufacturing,1,3,5,4,0,2,3,2,3,4,1,1,5,4,46.4
Chemistry,Clinical Psychologist,3.628299594773884,4,2,2,0,1,1,0,0,4,3,0,3,3,0,Science,Bachelors,18-24,2,1,19,Hybrid,Tier1_City,3,5,5,5,3,0,3,39.74,Manufacturing,4,3,1,4,1,4,2,3,3,2,1,1,4,1,44.14
Education,Marketing Manager,3.4382825667006367,5,0,0,0,5,1,4,0,2,3,1,2,3,1,Arts,Bachelors,31-35,8,1,44,Office,Tier3_City,3,3,0,4,0,5,3,31.48,Education,1,5,4,1,4,4,1,2,2,4,0,1,1,3,50.34
Computer Science,Interior Designer,2.6129969594154847,9,2,1,0,4,1,2,4,1,3,1,3,0,1,Science,Masters,25-30,5,0,0,Remote,Tier3_City,3,1,0,5,5,4,5,6.33,Manufacturing,1,5,5,1,2,2,2,1,5,4,0,1,2,3,60.4
Art,Curriculum Developer,4.736427424787335,6,2,0,1,8,1,3,0,1,4,4,1,4,0,Arts,Bachelors,36-40,7,1,17,Hybrid,Tier1_City,3,4,4,4,4,0,2,23.19,Healthcare,2,5,1,4,0,2,4,2,2,2,1,0,5,5,53.89
Architecture,Web Developer,3.03767186998442,6,2,0,1,7,1,0,4,0,1,0,2,2,1,Interdisciplinary,High School,25-30,12,0,0,Flexible,Tier1_City,5,2,5,5,2,3,4,15.32,Finance,2,5,1,3,2,3,3,4,4,2,1,0,2,4,45.63
Engineering,Pharmacist,3.719517020247749,5,1,4,0,6,0,0,2,4,2,0,3,3,0,Science,Bachelors,25-30,12,0,0,Remote,Tier1_City,3,1,4,5,1,3,2,25.88,Tech,1,1,2,4,3,0,2,1,2,2,0,1,2,1,48.41
Music,Clinical Psychologist,3.134432367470478,9,1,3,1,2,0,4,2,0,4,4,1,2,1,Arts,Masters,25-30,0,0,0,Remote,Tier1_City,2,3,2,1,0,2,5,22.0,Manufacturing,4,5,4,2,3,2,4,4,3,5,1,1,2,2,52.49
Marketing,Digital Marketing Specialist,2.7165607342489007,3,2,4,0,3,1,3,4,1,4,2,4,2,0,Commerce,Bachelors,25-30,1,0,0,Remote,Tier1_City,4,5,4,2,4,5,4,41.85,Manufacturing,4,1,5,2,1,1,4,4,5,5,0,0,4,1,61.54
Education,Conductor,3.3117378613143704,0,0,4,0,6,0,4,1,3,3,4,4,0,0,Arts,Masters,25-30,5,0,0,Remote,Tier2_City,4,4,4,5,3,0,2,14.61,Manufacturing,3,4,2,4,3,0,3,3,5,4,1,0,3,4,71.67
Psychology,Astronomer,2.526669577421005,5,1,0,1,0,1,4,2,0,1,1,4,1,0,Arts,PhD,31-35,2,0,0,Remote,Any,5,2,2,5,2,5,4,12.46,Education,3,3,5,3,4,1,5,5,2,3,1,0,5,3,52.46
Engineering,Digital Marketing Specialist,3.9962979138931214,7,2,0,1,1,0,3,4,1,4,2,0,1,1,Science,Bachelors,31-35,0,0,0,Remote,Tier1_City,4,1,0,3,1,1,3,48.03,Tech,1,4,3,1,2,0,3,3,4,2,1,0,1,1,39.83
Business,Urban Planner,4.860129935353163,9,0,4,1,5,0,2,2,1,2,3,2,0,1,Commerce,Masters,36-40,5,0,0,Remote,Tier3_City,4,3,4,2,0,5,3,47.63,Finance,1,4,3,1,2,2,4,4,2,3,1,0,2,1,45.39
Music,Nurse,4.425406867347927,1,1,1,1,8,0,3,0,2,2,0,0,1,1,Arts,Bachelors,40+,4,1,34,Hybrid,Tier2_City,1,2,0,3,3,3,1,49.69,Manufacturing,1,2,1,4,4,4,2,4,1,1,0,0,4,2,36.09
Chemistry,Principal,3.800482308428063,4,2,1,0,7,0,2,2,0,1,2,3,1,1,Science,Masters,25-30,12,0,0,Remote,Any,3,2,1,2,1,2,5,29.71,Healthcare,4,4,2,5,3,4,1,4,5,1,0,1,3,5,58.17
Chemistry,Curriculum Developer,4.14353071585807,9,1,0,0,1,1,0,1,3,1,0,1,1,1,Science,Bachelors,31-35,8,1,9,Office,Tier3_City,3,4,0,3,5,3,2,8.32,Other,5,4,1,1,3,2,1,4,1,2,1,1,3,1,39.76
Education,Physical Chemist,2.77710437083843,6,1,0,0,9,0,1,4,4,1,1,2,4,1,Arts,Masters,25-30,5,0,0,Office,Any,1,4,3,5,4,4,4,44.37,Education,3,2,1,2,4,0,4,4,4,1,1,0,2,3,54.26
Architecture,Digital Marketing Specialist,2.851686816563043,7,2,2,0,6,1,1,2,2,3,0,1,1,0,Interdisciplinary,Masters,31-35,4,1,49,Hybrid,Tier2_City,5,1,3,5,5,3,1,9.82,Finance,3,4,1,2,1,2,2,3,4,3,1,0,4,2,49.94
Business,Principal,2.698402854199557,2,0,0,1,4,1,0,4,4,4,0,1,1,0,Commerce,PhD,25-30,0,0,0,Flexible,Tier3_City,2,1,2,1,4,0,5,10.31,Manufacturing,5,2,3,5,0,0,3,5,3,1,1,1,5,5,52.67
Medicine,Animator,2.574158740657918,2,2,1,1,4,1,1,4,0,1,0,4,2,0,Science,Masters,40+,14,1,53,Office,Tier1_City,5,2,3,3,3,2,5,12.09,Finance,1,1,1,5,0,5,1,4,2,2,0,1,3,2,57.57
Chemistry,Biomedical Engineer,4.557176303665877,0,0,2,1,4,0,4,2,3,0,4,0,3,1,Science,Bachelors,31-35,0,1,17,Office,Tier1_City,2,3,1,4,5,0,5,33.71,Education,3,3,1,2,3,2,4,5,2,4,1,1,3,4,46.19
Music,Architectural Technologist,4.103546687171159,9,1,0,0,9,1,0,4,2,4,4,4,2,1,Arts,Masters,40+,10,0,0,Remote,Any,2,2,0,1,4,1,2,8.04,Other,4,5,1,4,5,5,5,1,2,5,0,1,2,1,71.4
Business,Acoustics Specialist,3.257256524131277,7,2,1,0,4,1,0,1,2,0,3,3,4,1,Commerce,Masters,36-40,0,0,0,Office,Tier3_City,1,3,0,3,2,1,3,39.58,Healthcare,5,4,1,4,0,1,1,2,1,5,0,0,4,4,40.65
Business,Graphic Designer,3.6471022046172346,8,0,4,1,0,1,3,4,3,3,0,4,0,0,Commerce,Masters,36-40,6,0,0,Flexible,Tier1_City,5,4,5,3,3,3,1,5.74,Manufacturing,4,1,2,4,0,5,1,4,4,5,0,1,4,2,70.67
Medicine,Brand Manager,3.993800425368233,5,0,1,0,1,1,0,1,4,1,3,3,1,0,Science,High School,36-40,5,1,28,Remote,Any,3,3,4,1,4,2,2,8.19,Healthcare,1,3,5,2,5,2,4,4,4,4,1,0,4,4,51.8
Marketing,Zoologist,4.916785068794728,6,0,1,0,4,1,2,0,2,0,3,4,4,1,Commerce,PhD,25-30,13,0,0,Office,Tier1_City,5,3,4,5,0,5,4,23.42,Education,3,1,2,5,0,0,5,4,1,1,1,0,4,1,55.91
Music,Music Therapist,4.501362724833463,7,1,0,1,2,0,0,1,3,3,2,0,2,0,Arts,Masters,25-30,4,0,0,Office,Tier1_City,5,4,4,3,4,2,2,20.82,Healthcare,4,2,4,3,3,3,4,2,2,5,0,0,2,5,52.52
Biology,Financial Advisor,4.247139276561124,2,0,1,0,4,1,1,1,3,2,4,1,2,1,Science,Masters,25-30,3,0,0,Hybrid,Tier2_City,2,5,0,5,5,2,4,49.52,Education,5,1,2,2,2,5,1,5,2,3,0,1,2,2,52.51
Finance,Curriculum Developer,2.7569596098974376,2,2,4,1,2,0,2,2,3,0,1,1,1,1,Commerce,Bachelors,18-24,10,0,0,Hybrid,Tier2_City,2,2,0,1,2,2,4,48.44,Other,1,4,4,2,3,4,4,3,1,1,0,0,3,4,42.61
Law,Astronomer,4.266159042733938,8,2,3,0,8,0,3,2,1,0,3,4,4,1,Arts,Masters,25-30,13,0,0,Remote,Tier2_City,3,1,5,5,1,3,5,11.92,Healthcare,3,4,3,1,3,3,1,4,3,4,0,1,3,4,64.29
Biology,Legal Consultant,2.6663651856338704,3,2,4,1,7,1,3,1,4,2,0,3,0,1,Science,Bachelors,25-30,12,1,30,Remote,Tier1_City,3,3,4,2,1,0,2,47.49,Finance,3,5,5,4,5,2,2,2,3,5,1,0,5,4,61.79
Music,Legal Secretary,2.588037333098812,2,0,4,0,0,0,2,3,0,1,0,4,2,0,Arts,Masters,25-30,12,0,0,Remote,Any,2,1,5,4,4,3,3,35.54,Finance,1,5,1,1,1,0,4,1,2,1,0,0,1,5,48.05
Psychology,Architectural Technologist,2.808989219474445,9,0,1,1,2,0,2,2,3,3,0,0,0,1,Arts,Bachelors,40+,10,1,49,Hybrid,Any,5,1,0,3,1,5,4,22.22,Education,1,4,4,2,1,4,3,2,2,4,1,0,3,2,54.09
Psychology,Animator,3.781449116042385,8,2,4,1,7,1,0,2,4,3,3,4,3,1,Arts,Masters,36-40,7,0,0,Hybrid,Tier1_City,2,2,1,4,4,0,5,37.76,Finance,1,1,3,2,3,2,4,4,1,2,0,0,2,2,56.85
Medicine,Doctor,4.063685552570766,7,2,4,1,2,1,0,4,0,4,3,0,1,0,Science,PhD,18-24,10,0,0,Flexible,Tier1_City,4,5,4,5,2,5,3,45.31,Other,4,4,5,2,4,3,2,5,5,5,0,0,5,4,66.11
Engineering,Cybersecurity Analyst,4.538059887303248,9,0,2,1,5,0,2,1,3,4,3,1,3,0,Science,High School,25-30,7,0,0,Hybrid,Tier1_City,4,5,3,3,1,4,2,11.47,Healthcare,2,1,4,3,4,4,1,5,4,2,1,0,3,2,51.73
Finance,Art Therapist,3.2424504630905555,0,0,0,1,5,1,1,0,4,3,3,2,3,0,Commerce,PhD,25-30,4,1,55,Remote,Any,2,5,4,5,5,4,3,12.21,Healthcare,3,4,3,1,1,2,2,1,2,2,1,0,5,2,55.3
Art,Special Education Teacher,4.2227694389765,9,0,0,0,3,0,2,1,3,0,0,4,3,1,Arts,Bachelors,25-30,14,0,0,Remote,Any,3,5,3,2,5,0,2,22.21,Manufacturing,4,3,1,5,5,4,2,4,2,5,1,0,2,5,62.13
Business,Biomedical Engineer,4.423228948897836,4,0,0,0,2,1,3,0,0,0,0,4,4,1,Commerce,Masters,31-35,3,0,0,Flexible,Tier2_City,2,4,2,1,0,3,4,10.95,Education,5,1,3,4,1,1,4,1,5,3,0,0,4,5,46.32
Chemistry,Fluid Mechanics Engineer,2.725824665997979,7,2,0,0,3,1,4,4,3,3,1,3,0,0,Science,Masters,25-30,14,0,0,Hybrid,Tier3_City,5,1,3,3,4,5,1,19.94,Finance,3,2,3,4,2,4,3,1,3,2,1,0,5,1,68.68
Biology,Acoustics Specialist,3.983915120789746,5,0,1,0,2,0,3,2,3,3,2,4,4,1,Science,Masters,25-30,1,0,0,Office,Tier3_City,4,1,5,2,1,5,1,33.35,Other,2,2,1,3,1,1,3,4,4,4,0,1,4,5,60.33
Art,Legal Consultant,2.8462260381979494,0,0,3,1,1,0,0,0,0,3,1,4,2,1,Arts,Masters,36-40,6,1,21,Remote,Tier2_City,1,4,1,2,5,1,4,41.2,Education,5,5,4,1,5,5,4,5,5,3,0,1,1,5,52.47
Medicine,Dentist,3.3555058817555814,7,1,3,1,8,1,0,0,1,2,3,4,1,0,Science,Masters,36-40,4,0,0,Hybrid,Tier1_City,3,2,0,3,2,5,3,17.19,Finance,3,3,3,4,0,4,3,5,1,2,1,1,3,2,42.75
Business,Psychologist,4.334177467042348,6,1,1,0,7,1,3,4,1,1,0,2,1,1,Commerce,Bachelors,18-24,2,0,0,Hybrid,Tier1_City,1,3,5,5,2,3,2,16.24,Manufacturing,2,2,1,2,3,4,3,5,3,2,0,1,2,1,36.94
Psychology,Biotechnologist,3.0294050817973446,7,2,1,1,5,1,2,0,0,3,0,1,2,0,Arts,Bachelors,31-35,8,0,0,Remote,Tier1_City,3,5,5,2,0,1,1,39.65,Healthcare,1,4,4,1,3,4,3,5,4,5,1,1,5,5,47.25
Music,Electrical Engineer,3.738358242531409,2,1,1,1,9,0,0,0,1,2,1,1,2,1,Arts,Masters,25-30,8,0,0,Office,Tier2_City,1,5,1,4,2,3,2,20.91,Healthcare,2,2,1,4,5,1,5,5,3,5,1,1,4,4,52.26
Chemistry,Dentist,3.2093143331085807,2,0,4,1,3,1,2,2,0,4,1,4,2,0,Science,Masters,25-30,10,0,0,Hybrid,Tier1_City,1,4,2,2,2,2,4,41.47,Other,3,4,2,1,3,2,2,1,5,1,1,0,2,4,61.43
Medicine,Financial Analyst,4.28596367742629,9,2,3,1,7,1,0,0,0,3,0,0,3,1,Science,Masters,18-24,14,0,0,Hybrid,Tier1_City,2,5,5,5,1,5,3,49.69,Tech,2,3,4,3,5,3,1,3,4,5,0,0,5,2,50.92
Finance,Dentist,3.774655846058011,8,0,4,1,8,0,0,4,3,3,1,2,2,1,Commerce,Masters,25-30,10,0,0,Office,Tier1_City,3,4,1,5,4,2,2,49.04,Education,3,5,2,5,2,4,5,4,2,5,1,0,4,4,68.24
Business,Urban Planner,3.39964667335951,5,1,4,0,5,1,0,2,1,1,4,1,2,1,Commerce,Bachelors,25-30,9,0,0,Hybrid,Tier2_City,4,3,1,4,3,4,3,34.15,Finance,3,2,3,5,2,5,1,3,1,1,0,1,1,5,47.11
Education,Data Scientist,4.8415303504457,0,0,0,0,0,1,4,0,1,1,1,4,4,1,Arts,Masters,25-30,13,0,0,Remote,Any,1,1,2,2,2,4,1,20.64,Tech,2,5,3,1,0,3,4,1,3,3,1,1,4,2,59.24
Business,Ecologist,4.189047809354714,6,0,2,1,6,1,4,1,1,3,3,2,3,1,Commerce,Bachelors,31-35,10,0,0,Flexible,Any,2,5,1,5,2,0,2,6.08,Education,2,3,3,3,3,3,5,4,1,1,0,1,1,1,54.1
Law,Astronomer,3.962821966591867,3,0,1,1,6,1,2,2,3,0,0,0,0,1,Arts,Bachelors,31-35,7,0,0,Remote,Tier3_City,5,2,2,3,3,5,5,37.69,Finance,5,1,4,4,0,4,2,1,3,5,0,1,4,5,48.86
Physics,Clinical Psychologist,4.582598212075117,2,1,0,0,9,1,3,0,1,4,1,1,4,0,Science,High School,18-24,0,0,0,Office,Tier3_City,3,4,0,1,2,1,1,48.96,Manufacturing,5,3,5,2,1,1,1,4,3,3,0,0,4,1,36.54
Engineering,Legal Analyst,3.280678358538,9,1,4,0,4,1,0,3,2,1,3,4,3,0,Science,Bachelors,18-24,11,0,0,Office,Tier2_City,3,3,4,1,1,2,3,6.2,Education,4,3,4,1,3,0,5,2,3,1,1,1,3,3,48.54
Art,Industrial-Organizational Psychologist,3.58598104189958,1,2,0,1,2,1,2,3,2,4,2,4,4,1,Arts,Bachelors,36-40,2,0,0,Remote,Tier1_City,4,2,0,1,1,3,4,3.29,Finance,3,3,4,1,0,0,4,1,1,1,1,0,2,3,37.57
Law,Human Resources Specialist,3.991348018753405,0,2,0,0,0,1,0,1,0,0,1,4,3,0,Arts,Bachelors,18-24,1,1,34,Hybrid,Tier1_City,1,1,0,2,3,5,5,42.09,Healthcare,5,1,5,4,2,0,1,1,2,1,0,1,1,2,31.76
Psychology,Architect,4.088054048256693,8,2,3,0,4,1,2,3,1,0,2,2,2,0,Arts,Masters,36-40,3,0,0,Remote,Tier1_City,2,2,0,4,5,0,2,7.81,Education,4,1,4,2,5,4,2,2,3,5,1,0,2,2,50.84
Marketing,Landscape Architect,2.6714756156194723,6,0,1,1,7,0,4,3,2,2,0,2,3,0,Commerce,Bachelors,31-35,1,0,0,Hybrid,Tier2_City,1,4,1,5,2,3,1,6.84,Finance,3,3,2,2,2,3,2,5,5,2,1,1,3,1,43.02
Engineering,Biologist,2.837420207107918,3,2,4,1,9,0,0,2,4,2,2,2,2,1,Science,Bachelors,25-30,11,0,0,Office,Tier1_City,2,5,0,3,5,2,2,45.79,Other,4,1,5,4,2,0,1,2,5,1,1,0,4,5,59.45
Music,Organic Chemist,3.4391444197394687,8,2,2,0,8,1,2,3,3,1,3,3,0,1,Arts,Bachelors,18-24,10,0,0,Remote,Tier3_City,4,1,2,3,2,5,2,6.74,Healthcare,5,4,5,1,5,5,2,2,1,3,1,1,1,1,55.73
Medicine,Financial Analyst,4.269172331947147,7,2,3,1,0,1,3,0,3,1,2,2,3,0,Science,Bachelors,18-24,7,1,58,Remote,Tier1_City,1,4,2,2,4,2,5,8.36,Healthcare,4,3,2,4,0,4,1,3,1,5,1,0,3,4,57.3
Architecture,School Counselor,3.651171503813513,3,0,1,1,1,0,1,3,1,2,3,1,0,1,Interdisciplinary,Bachelors,18-24,0,0,0,Hybrid,Tier1_City,5,3,5,1,2,5,5,29.77,Tech,2,2,5,5,0,4,4,3,5,3,0,1,3,5,48.84
Computer Science,Graphic Designer,3.748396315050515,1,0,3,0,2,1,4,0,2,2,2,0,1,0,Science,Bachelors,18-24,3,0,0,Hybrid,Any,4,2,5,2,1,5,5,38.57,Finance,4,4,5,4,0,4,1,5,2,2,0,1,1,1,40.55
Business,School Counselor,3.479691424433855,2,0,4,1,3,0,3,0,2,1,3,0,4,0,Commerce,Masters,31-35,4,0,0,Office,Tier1_City,4,2,2,4,0,2,5,21.78,Tech,1,3,2,3,4,1,1,3,2,3,1,0,4,2,45.38
Psychology,Microbiologist,3.439380008613473,0,1,1,1,6,0,0,3,2,1,2,0,1,1,Arts,Masters,18-24,13,1,8,Office,Tier2_City,3,1,5,4,0,2,4,22.77,Other,1,2,1,1,3,5,1,5,4,1,0,1,1,4,51.46
Architecture,Digital Marketing Specialist,4.155338903928461,6,0,1,1,6,0,4,1,3,4,2,3,0,1,Interdisciplinary,Masters,25-30,9,1,34,Office,Tier1_City,2,1,2,5,0,3,3,32.73,Tech,4,2,1,3,4,2,1,2,3,3,0,0,5,5,66.39
Art,Biomedical Engineer,3.2453723229701468,7,0,2,1,0,1,1,1,0,3,3,4,0,0,Arts,Bachelors,25-30,3,0,0,Office,Tier1_City,1,3,5,5,0,0,5,26.75,Manufacturing,1,5,1,1,4,1,5,3,5,3,1,0,3,5,46.4
Marketing,School Psychologist,3.0068496877471262,3,2,3,1,2,0,4,2,2,0,0,2,2,0,Commerce,Bachelors,25-30,7,1,13,Remote,Tier2_City,2,3,0,4,5,2,1,3.88,Tech,4,5,2,1,5,3,2,5,1,5,1,0,5,5,49.47
Biology,Principal,4.255265642067886,2,1,0,0,1,1,2,0,1,2,1,4,0,1,Science,Masters,18-24,1,0,0,Hybrid,Tier2_City,4,1,3,4,5,4,2,8.34,Tech,4,2,3,5,1,4,2,5,5,3,1,0,2,3,52.74
Chemistry,Lawyer,4.703469079306126,5,1,4,0,6,0,4,4,3,3,3,1,2,0,Science,Bachelors,18-24,8,0,0,Hybrid,Tier1_City,1,4,5,4,2,0,5,30.34,Manufacturing,4,3,4,4,1,1,3,3,5,4,0,1,3,1,72.32
Biology,Zoologist,2.506035365573881,6,0,3,1,6,0,1,3,2,2,1,3,1,0,Science,Bachelors,18-24,1,0,0,Flexible,Any,5,4,4,2,5,4,1,40.3,Manufacturing,1,3,5,4,2,0,5,4,1,4,0,0,4,1,43.53
Medicine,Credit Analyst,3.0431066970516785,0,1,2,0,5,1,0,3,0,4,1,0,4,0,Science,High School,31-35,1,0,0,Hybrid,Tier3_City,2,1,3,4,2,3,4,38.87,Education,3,3,2,5,5,2,2,3,5,5,0,1,3,4,40.54
Medicine,Civil Engineer,2.583560269314149,1,2,0,1,5,0,3,2,3,2,3,3,1,1,Science,Bachelors,25-30,12,0,0,Flexible,Tier1_City,2,2,1,3,4,2,1,37.78,Tech,4,3,4,5,4,4,5,5,2,4,1,1,5,5,65.18
Physics,Inorganic Chemist,4.100364265006973,8,0,4,1,4,1,0,1,3,2,3,1,3,0,Science,Bachelors,31-35,1,1,58,Office,Tier1_City,5,5,0,1,2,0,1,39.25,Healthcare,4,2,2,2,1,1,1,4,3,5,0,0,4,3,45.64
Art,Advertising Manager,3.297026754747971,0,1,2,1,9,0,3,3,4,0,3,2,2,1,Arts,Bachelors,25-30,11,0,0,Office,Tier3_City,4,3,3,4,0,2,4,5.09,Manufacturing,2,1,5,3,4,0,1,3,2,3,0,0,3,1,56.41
Biology,Artist,2.829810328268473,3,1,3,0,3,1,4,2,4,3,0,1,2,1,Science,Masters,25-30,9,0,0,Hybrid,Tier3_City,2,4,0,1,3,5,4,45.07,Finance,2,1,3,1,3,0,2,2,5,5,1,0,1,4,66.85
Architecture,Composer,2.71659112483153,2,2,1,0,7,0,4,0,1,0,0,3,4,1,Interdisciplinary,Bachelors,25-30,7,0,0,Hybrid,Tier1_City,3,5,2,2,3,2,2,44.8,Education,5,3,2,2,4,1,4,1,2,4,1,0,2,5,49.21
Computer Science,Ecologist,4.586660269081461,0,2,0,1,4,0,2,2,1,3,0,2,0,0,Science,Masters,31-35,2,0,0,Hybrid,Tier1_City,3,2,1,1,1,0,5,28.0,Education,1,5,4,4,2,1,2,3,4,1,1,0,5,5,45.6
Engineering,Marketing Manager,2.7073457173288302,4,1,3,1,1,1,1,2,3,1,0,4,4,1,Science,Masters,25-30,9,0,0,Remote,Tier1_City,1,3,3,2,1,2,1,14.68,Tech,3,2,4,2,0,5,4,3,5,1,1,0,3,2,58.08
Engineering,Game Developer,4.963642052271316,7,2,3,0,9,0,3,0,0,1,4,2,3,1,Science,Masters,18-24,10,0,0,Flexible,Tier1_City,5,4,4,3,2,2,3,30.83,Other,4,1,5,4,2,5,1,1,4,4,1,0,5,5,62.86
Biology,Clinical Psychologist,3.3442127112379216,1,0,3,1,5,1,3,4,4,2,0,1,4,0,Science,Masters,25-30,13,0,0,Office,Tier1_City,4,4,2,2,3,1,3,29.22,Healthcare,4,2,1,5,4,5,3,4,2,1,0,0,2,4,63.12
Finance,Industrial-Organizational Psychologist,3.4733891797242302,5,0,1,0,0,0,2,1,2,3,3,3,4,1,Commerce,PhD,25-30,9,0,0,Office,Any,3,2,5,2,0,1,2,13.48,Other,1,5,5,1,5,5,1,1,1,5,0,1,5,4,59.84
Architecture,Physical Chemist,4.007927915561247,2,0,2,0,1,0,3,3,2,2,3,4,3,1,Interdisciplinary,High School,25-30,14,0,0,Hybrid,Tier3_City,1,2,2,5,5,0,3,31.35,Other,5,2,5,1,4,3,5,4,3,4,0,0,1,4,66.29
Art,Animator,4.771253320119147,9,0,1,1,3,0,1,0,1,4,0,2,4,0,Arts,Bachelors,31-35,13,0,0,Remote,Tier3_City,1,4,5,4,0,0,2,40.47,Manufacturing,5,5,1,1,0,4,1,5,1,2,0,0,2,4,37.44
Marketing,Inorganic Chemist,4.416437849447499,8,2,0,1,6,1,0,4,0,3,3,0,0,0,Commerce,High School,25-30,7,0,0,Office,Tier1_City,2,4,5,4,0,5,5,40.89,Finance,2,5,3,5,2,5,1,4,4,3,0,0,1,1,46.08
Architecture,Fluid Mechanics Engineer,3.183591506284748,2,0,4,1,1,0,4,0,0,4,2,1,1,1,Interdisciplinary,Masters,31-35,6,0,0,Hybrid,Tier1_City,4,5,1,3,2,5,2,5.81,Tech,1,4,2,4,2,0,5,2,1,2,1,1,4,4,49.97
Computer Science,Biologist,3.657021022720624,0,2,0,1,9,1,0,3,1,1,1,2,4,0,Science,Masters,25-30,9,0,0,Flexible,Tier1_City,3,2,5,3,2,2,4,12.27,Healthcare,5,5,4,5,4,3,1,1,4,5,1,0,1,5,61.19
Architecture,Electrical Engineer,2.978670871061996,2,1,4,0,6,0,0,4,0,0,1,1,0,0,Interdisciplinary,Bachelors,31-35,3,0,0,Office,Tier2_City,5,2,2,4,4,4,4,34.41,Tech,5,4,2,1,3,0,2,2,1,4,1,1,5,3,34.32
Psychology,Composer,4.335460775191125,0,2,1,0,2,1,4,3,3,3,2,4,3,1,Arts,PhD,31-35,6,0,0,Remote,Tier1_City,2,5,2,5,0,0,4,43.41,Tech,3,5,2,1,5,1,1,2,3,3,0,0,5,3,61.97
Computer Science,Aerospace Engineer,4.24653601029937,6,2,4,0,0,0,4,1,1,2,4,0,2,0,Science,Bachelors,25-30,10,1,31,Hybrid,Tier1_City,3,2,5,4,0,2,4,27.5,Education,2,5,4,1,5,0,5,1,5,2,1,0,2,5,58.96
Education,Clinical Psychologist,4.678744124297005,9,2,1,1,8,0,2,0,4,4,0,0,2,1,Arts,PhD,31-35,7,1,50,Office,Tier1_City,1,1,3,5,2,4,4,36.25,Other,2,2,1,4,1,0,1,4,3,5,0,0,4,2,64.62
Business,Financial Advisor,4.164240427407635,3,2,4,0,6,0,1,4,0,1,0,3,4,1,Commerce,Bachelors,36-40,5,1,10,Hybrid,Any,5,3,2,3,2,1,4,3.99,Finance,2,4,4,4,4,4,5,2,2,5,0,0,1,4,44.12
Finance,Risk Analyst,4.754240311872074,4,2,2,0,6,0,3,1,4,4,3,2,2,0,Commerce,Bachelors,25-30,5,0,0,Hybrid,Tier2_City,1,1,1,1,4,5,4,31.6,Finance,5,1,1,2,4,1,4,2,2,1,1,0,5,2,53.93
Marketing,Financial Analyst,2.7674279335191816,7,0,2,0,8,1,0,1,0,0,0,3,1,0,Commerce,Bachelors,25-30,2,0,0,Remote,Tier1_City,2,2,5,3,4,0,4,48.21,Finance,4,1,1,2,5,0,5,4,1,3,1,0,5,1,27.5
Engineering,Biomedical Engineer,3.699510857825666,4,1,2,0,4,1,4,2,0,4,0,2,2,0,Science,Bachelors,31-35,4,0,0,Remote,Tier3_City,5,5,0,3,1,2,4,34.07,Finance,5,2,5,3,1,2,3,2,3,3,1,1,3,4,48.95
Music,Investment Banker,2.6236921760302603,6,1,0,1,5,0,3,4,1,1,2,3,3,0,Arts,Bachelors,25-30,9,0,0,Office,Tier3_City,5,4,1,2,3,1,5,46.35,Manufacturing,5,1,3,4,0,3,2,3,2,2,0,1,3,1,53.4
Music,Architect,4.334702081406926,2,2,1,0,1,0,4,3,4,1,2,0,1,1,Arts,Bachelors,18-24,1,0,0,Remote,Tier1_City,2,2,1,2,0,3,4,29.6,Manufacturing,1,1,5,5,4,5,1,1,5,3,0,0,2,2,49.77
Medicine,Electrical Engineer,2.667561544846361,9,2,4,0,3,1,0,2,3,4,2,1,0,1,Science,Masters,36-40,11,1,55,Office,Tier1_City,1,4,0,2,0,1,2,42.64,Finance,2,5,3,4,3,5,2,4,1,2,0,0,2,3,54.97
Finance,Education Administrator,4.710128828893305,0,2,4,1,3,1,3,4,1,0,0,2,0,1,Commerce,Bachelors,18-24,4,0,0,Hybrid,Tier3_City,5,3,3,2,4,2,5,8.84,Healthcare,2,3,1,2,0,0,1,3,4,4,1,0,3,2,46.77
Chemistry,Illustrator,4.978776918222882,6,2,1,0,3,0,1,1,3,3,2,2,1,0,Science,Bachelors,31-35,4,0,0,Flexible,Tier1_City,4,1,4,5,4,5,3,8.81,Manufacturing,3,3,5,1,0,0,4,3,1,4,1,1,5,4,48.26
Law,Physician Assistant,4.222147566422975,6,0,1,1,7,1,2,3,2,1,0,3,2,1,Arts,Masters,31-35,6,0,0,Flexible,Tier3_City,4,3,5,4,1,4,1,8.65,Manufacturing,2,1,2,2,0,3,2,4,3,4,0,0,4,3,51.23
Chemistry,Marketing Specialist,3.3882793391510924,5,2,0,0,1,1,1,3,3,3,1,3,1,1,Science,Masters,40+,3,0,0,Office,Tier1_City,1,4,5,1,3,3,5,25.98,Healthcare,5,2,4,2,4,0,1,5,3,2,0,1,4,3,52.5
Physics,Art Director,3.630363165399384,2,1,1,0,8,0,3,4,1,1,1,1,1,0,Science,Bachelors,18-24,13,0,0,Hybrid,Tier2_City,5,3,4,3,1,3,4,18.52,Finance,1,2,4,2,5,1,4,2,5,2,1,1,2,4,55.16
Medicine,Pharmacist,3.3214027858256845,2,1,3,1,8,0,2,1,2,0,2,4,4,1,Science,Bachelors,25-30,10,0,0,Hybrid,Tier1_City,1,4,1,5,3,5,5,36.8,Tech,3,4,4,3,0,0,3,2,1,4,0,0,2,3,52.09
Engineering,Principal,4.9642770085897485,4,1,4,0,2,0,2,3,4,2,2,1,1,1,Science,Bachelors,25-30,5,0,0,Remote,Tier2_City,4,1,3,1,5,3,1,45.42,Manufacturing,5,2,3,3,2,1,1,5,1,4,0,0,3,5,54.07
Finance,School Counselor,4.886666436779597,7,2,1,1,8,0,3,0,0,3,3,4,1,0,Commerce,Bachelors,25-30,8,1,6,Remote,Any,5,4,3,5,0,0,1,32.11,Tech,5,2,4,3,4,1,4,5,3,3,1,0,3,3,54.58
Business,Accountant,2.8932179068105097,6,2,3,0,6,1,3,4,4,4,3,1,0,0,Commerce,Masters,18-24,3,0,0,Hybrid,Tier2_City,5,1,3,5,1,2,4,13.02,Tech,3,5,3,5,4,1,3,5,1,3,0,0,4,4,57.88
Music,Physicist,3.1744458078916,5,2,0,1,1,1,4,0,0,2,2,1,0,0,Arts,Bachelors,25-30,10,1,25,Office,Tier1_City,1,2,3,3,4,3,4,46.75,Healthcare,5,5,3,3,1,5,3,2,2,2,0,0,1,3,53.65
Education,Art Therapist,2.919215889360337,3,1,3,0,6,0,2,2,1,1,0,2,2,1,Arts,Bachelors,25-30,13,0,0,Remote,Tier1_City,5,4,1,4,1,1,2,27.81,Finance,5,1,3,5,5,3,3,1,2,1,0,0,5,1,47.27
Biology,Analytical Chemist,4.892861543470483,3,1,0,1,3,0,1,2,4,3,2,0,2,0,Science,Masters,18-24,5,0,0,Hybrid,Any,1,3,5,2,5,4,1,36.84,Other,1,2,2,4,0,1,1,2,1,1,1,0,1,1,47.41
Education,Mechanical Engineer,3.0296023925795144,7,0,0,1,4,0,2,4,4,0,3,3,1,0,Arts,Bachelors,31-35,12,0,0,Hybrid,Tier3_City,3,5,2,4,1,2,4,44.85,Tech,1,3,1,4,4,0,4,1,2,3,1,1,5,2,58.53
Medicine,Biomedical Engineer,3.751194853132751,7,0,3,1,1,1,3,1,2,3,2,2,1,1,Science,Masters,31-35,11,1,26,Flexible,Tier1_City,3,3,5,3,0,5,1,49.52,Finance,1,2,2,3,5,4,1,2,3,5,1,0,4,3,63.59
Architecture,Physical Chemist,3.439304518223437,9,1,2,0,2,0,0,3,0,1,2,3,1,1,Interdisciplinary,Bachelors,31-35,8,0,0,Remote,Any,4,5,4,3,5,1,2,26.79,Education,2,2,1,4,3,1,5,1,4,1,0,1,1,2,51.81
Engineering,Teacher,4.433311240545464,9,2,0,1,2,0,2,4,1,2,4,4,0,0,Science,PhD,36-40,9,0,0,Remote,Tier2_City,4,3,4,3,4,0,3,40.98,Other,3,1,2,4,3,0,2,1,1,2,1,0,2,3,68.81
Engineering,Civil Engineer,4.223868554566787,1,2,4,1,4,1,2,2,4,0,2,4,3,1,Science,Bachelors,25-30,11,0,0,Flexible,Tier1_City,2,4,5,1,4,3,1,29.64,Other,1,3,3,1,5,0,4,3,5,5,1,1,2,2,70.5
Engineering,Mechanical Engineer,3.0167880055741456,1,2,0,0,9,0,3,4,3,0,2,0,0,1,Science,Masters,40+,0,0,0,Remote,Tier2_City,3,2,0,4,2,1,2,25.86,Other,5,1,1,3,4,2,4,2,1,2,1,1,4,3,37.99
Engineering,Risk Analyst,4.270289130032075,7,1,1,1,7,1,0,2,1,3,4,4,3,0,Science,Masters,36-40,7,0,0,Office,Tier2_City,3,4,1,4,5,2,2,28.27,Finance,2,2,4,3,4,0,1,1,3,3,0,1,4,4,63.17
Biology,Psychologist,3.2621617161691496,8,1,4,0,0,1,2,1,2,1,1,2,1,0,Science,High School,25-30,0,1,55,Hybrid,Tier3_City,2,1,4,5,2,1,2,25.76,Healthcare,3,3,2,2,3,2,5,3,5,2,0,0,1,5,33.81
Computer Science,Nuclear Physicist,4.61852884825236,0,2,0,0,4,0,3,0,2,1,2,3,2,1,Science,Masters,18-24,3,0,0,Hybrid,Tier1_City,1,2,1,5,2,0,5,22.79,Healthcare,1,2,1,2,3,0,4,2,5,1,0,1,2,2,50.93
Medicine,AI Researcher,4.226145224204535,2,2,3,0,1,1,0,3,3,3,3,2,0,0,Science,PhD,25-30,2,0,0,Hybrid,Any,3,4,5,5,0,4,4,37.01,Education,1,1,4,4,2,1,5,1,4,4,1,1,2,5,57.98
Biology,Financial Advisor,2.872586828169256,3,1,3,0,1,0,0,1,0,3,3,2,1,1,Science,Masters,25-30,3,1,38,Flexible,Tier3_City,3,2,1,3,1,3,1,14.73,Healthcare,3,1,5,2,3,5,2,3,1,2,1,0,1,3,35.16
Business,Animator,3.4492834677233937,6,0,2,1,7,0,3,0,1,0,4,0,2,0,Commerce,Masters,25-30,13,1,29,Remote,Tier2_City,4,1,5,4,4,2,5,31.97,Finance,1,5,3,1,2,2,4,5,1,1,1,0,2,2,51.54
Medicine,Chemical Engineer,4.26696940504659,1,0,0,0,9,1,4,0,0,4,3,0,2,1,Science,Masters,25-30,6,0,0,Remote,Tier1_City,2,5,3,3,4,3,1,36.51,Other,3,3,2,3,4,2,5,1,5,4,1,1,1,2,60.14
Chemistry,Risk Analyst,2.5051816612016427,8,1,2,1,5,1,3,3,3,4,4,2,2,1,Science,Bachelors,31-35,12,0,0,Hybrid,Any,2,2,0,1,1,3,5,44.93,Finance,3,5,2,1,0,2,5,3,2,2,0,0,1,5,59.06
Engineering,Manager,4.3251372795611,7,1,1,1,2,0,0,0,2,1,4,1,0,0,Science,Bachelors,25-30,13,0,0,Hybrid,Tier2_City,4,2,1,5,4,5,4,18.6,Other,5,3,5,3,5,1,5,1,1,5,0,1,4,4,54.17
Music,Brand Manager,2.87666077966295,4,2,3,0,7,1,1,4,2,0,4,1,1,0,Arts,Masters,18-24,8,1,10,Hybrid,Any,3,1,5,3,1,3,2,43.45,Finance,3,4,1,5,5,4,5,2,1,2,1,0,3,5,50.33
Physics,Musician,3.845579505344528,6,1,2,0,6,0,1,1,4,4,4,1,2,0,Science,Bachelors,36-40,8,1,7,Flexible,Tier1_City,5,4,4,3,5,1,1,47.43,Healthcare,4,3,2,3,5,1,1,3,2,2,1,1,4,3,59.96
Engineering,Physician Assistant,3.472145834247488,1,0,1,0,2,1,2,3,2,4,4,2,2,1,Science,Masters,25-30,9,1,31,Flexible,Any,2,5,4,1,0,1,2,33.49,Finance,1,2,2,1,0,4,4,2,4,2,1,0,1,4,62.05
Business,Graphic Designer,4.561071082669169,2,0,0,0,9,0,4,3,0,0,4,2,3,1,Commerce,PhD,40+,0,0,0,Remote,Tier3_City,3,2,0,2,0,4,4,39.26,Manufacturing,5,3,2,4,1,1,1,3,1,5,0,1,1,5,49.69
Art,Surgeon,3.272713653163118,3,2,2,1,9,1,3,0,4,3,2,2,2,0,Arts,Bachelors,18-24,14,0,0,Hybrid,Any,1,2,1,4,0,0,1,22.07,Other,2,5,2,2,5,0,5,1,3,2,1,1,2,1,55.39
Art,Artist,2.8056813346227854,4,1,1,0,1,0,2,3,0,4,1,0,1,1,Arts,Bachelors,40+,9,0,0,Remote,Tier1_City,2,2,3,2,1,2,3,47.75,Other,4,1,5,2,2,1,3,2,2,5,0,0,2,1,54.57
Law,Software Developer,3.004944248527894,8,1,3,1,6,1,1,2,3,4,1,2,4,0,Arts,Masters,18-24,0,0,0,Flexible,Tier2_City,4,2,0,5,1,1,3,34.53,Education,3,1,3,1,3,4,4,4,1,2,1,0,4,1,37.54
Medicine,Musician,3.890244001459372,7,0,3,1,9,0,1,1,3,4,3,4,1,1,Science,Bachelors,18-24,8,1,27,Hybrid,Tier1_City,2,1,1,3,3,3,3,17.58,Manufacturing,2,3,2,2,2,3,1,4,2,4,0,0,4,3,60.93
Physics,Financial Controller,3.395689176932321,8,1,2,1,4,0,4,0,1,3,0,1,4,0,Science,Masters,18-24,3,0,0,Hybrid,Tier1_City,4,2,0,1,4,0,4,22.0,Finance,2,4,5,4,1,0,5,4,2,4,0,1,3,3,46.17
Engineering,Zoologist,3.2762005519701414,2,1,3,0,0,1,0,1,2,1,4,2,3,0,Science,Bachelors,31-35,11,0,0,Office,Tier1_City,1,5,3,1,4,2,3,32.03,Healthcare,2,1,4,2,1,2,5,4,4,5,0,0,5,5,63.03
Biology,Advertising Manager,2.721694737771547,5,2,1,0,2,1,1,1,3,3,4,2,4,0,Science,Masters,36-40,12,1,50,Hybrid,Any,3,1,2,4,3,2,1,14.0,Education,2,1,2,5,2,1,4,3,4,4,0,1,3,2,68.65
Biology,Mechanical Engineer,4.569611515087786,3,2,0,1,8,0,2,3,2,0,1,1,0,1,Science,Bachelors,25-30,13,0,0,Remote,Tier2_City,4,2,2,2,3,2,3,38.43,Manufacturing,5,1,1,3,3,5,2,2,5,2,1,1,1,4,57.6
Law,Web Developer,3.027718543061081,4,2,4,0,4,0,3,4,0,4,2,1,3,1,Arts,Masters,36-40,2,0,0,Hybrid,Tier1_City,4,5,2,4,0,2,1,13.56,Finance,5,4,5,5,4,0,4,3,1,1,0,1,4,5,45.34
Art,Investment Banker,2.604803155795597,4,2,3,1,3,1,2,4,1,1,4,2,2,1,Arts,Bachelors,25-30,12,1,23,Hybrid,Any,1,3,3,3,3,4,4,30.81,Healthcare,2,5,1,3,4,4,1,2,4,1,1,1,4,1,57.32
Physics,Judge,3.465708351385276,0,0,1,1,9,0,2,3,2,2,4,3,0,0,Science,Masters,31-35,8,1,36,Office,Tier3_City,5,3,3,4,1,2,2,35.76,Finance,4,3,3,5,4,2,2,4,1,2,1,1,3,3,57.25
Business,Biologist,3.6468629631193776,1,2,3,1,4,0,3,2,4,2,3,3,1,1,Commerce,Bachelors,36-40,4,1,49,Hybrid,Any,2,5,0,1,2,0,5,43.41,Other,1,4,4,2,5,4,4,5,5,4,1,0,3,1,62.77
Engineering,Graphic Designer,3.5329578322137705,2,0,2,1,5,1,4,1,3,4,0,1,0,0,Science,Masters,25-30,11,0,0,Remote,Any,5,2,5,1,1,1,3,37.49,Manufacturing,1,3,1,2,1,0,4,1,4,3,0,1,2,3,64.12
Law,Digital Marketing Specialist,3.928338557204504,5,1,0,0,2,1,4,3,0,4,1,0,2,1,Arts,Masters,25-30,5,0,0,Hybrid,Tier3_City,2,2,4,5,3,0,5,40.54,Manufacturing,5,2,2,4,5,0,4,4,4,1,0,1,3,2,54.59
Business,Counselor,4.342284962016871,2,2,0,1,3,0,4,1,4,2,0,2,0,1,Commerce,Bachelors,36-40,0,0,0,Office,Tier1_City,1,1,3,5,4,3,2,45.91,Education,4,3,5,5,2,0,3,4,5,4,1,0,1,5,55.93
Art,Social Media Manager,3.2686975230111712,1,1,0,1,6,0,4,4,0,2,2,3,1,1,Arts,Bachelors,36-40,0,0,0,Flexible,Any,1,2,3,3,1,5,4,31.1,Healthcare,4,1,4,3,1,0,4,5,3,5,0,0,2,5,47.82
Education,Advertising Manager,4.229628798581821,8,0,4,1,9,1,4,3,0,2,4,0,0,0,Arts,High School,40+,12,0,0,Remote,Tier1_City,5,1,2,2,4,4,4,42.78,Tech,3,4,5,3,3,4,1,3,3,4,1,1,2,3,62.04
Architecture,Biomedical Engineer,2.955023414210028,4,2,2,1,3,0,0,2,2,1,1,1,1,1,Interdisciplinary,Masters,36-40,13,1,12,Remote,Tier2_City,1,2,2,4,1,4,2,13.9,Finance,5,4,4,2,5,3,5,3,5,1,0,1,2,1,53.64
Computer Science,Credit Analyst,3.9221921314382335,4,0,2,1,1,0,0,2,0,2,3,4,0,1,Science,Masters,18-24,6,0,0,Hybrid,Tier3_City,3,4,5,3,4,3,5,41.29,Healthcare,4,5,1,2,0,0,1,2,3,3,1,0,3,4,51.02
Engineering,Biotechnologist,3.989469039378359,6,0,4,0,7,0,0,0,4,2,1,3,0,1,Science,Bachelors,36-40,9,0,0,Hybrid,Tier1_City,5,4,2,5,5,0,3,13.42,Tech,4,2,3,2,1,2,4,1,3,3,0,1,5,1,51.84
Business,Social Media Manager,3.827745389149702,2,2,1,0,4,0,2,0,1,0,0,2,0,0,Commerce,Bachelors,25-30,14,1,12,Remote,Tier2_City,4,5,4,4,1,0,1,46.93,Healthcare,1,5,5,5,3,4,2,2,3,1,1,1,5,3,46.51
Medicine,School Psychologist,4.946131522348939,4,0,0,1,3,0,0,4,0,0,4,0,4,0,Science,Bachelors,40+,7,1,12,Hybrid,Tier1_City,4,4,2,5,4,3,4,18.51,Finance,4,5,2,3,3,1,3,4,3,2,0,1,4,5,44.96
Education,Musician,3.220163670168369,2,2,4,1,4,1,4,0,2,4,4,0,3,0,Arts,Masters,25-30,10,0,0,Flexible,Tier1_City,1,3,2,4,2,5,2,11.08,Finance,4,2,5,5,3,1,3,3,2,1,1,0,4,4,62.36
Physics,Nurse,4.23781294580691,4,1,3,0,7,0,4,2,4,2,3,3,2,0,Science,Bachelors,25-30,7,1,31,Hybrid,Tier1_City,1,3,5,2,0,2,5,9.96,Education,2,1,3,3,0,4,3,4,2,5,0,1,4,5,63.06
Law,Curriculum Developer,2.84423337465812,2,0,0,1,9,1,3,1,4,3,2,3,4,1,Arts,PhD,25-30,13,1,46,Hybrid,Any,2,1,4,3,1,2,3,11.8,Manufacturing,1,4,1,3,4,4,2,4,4,4,1,0,1,5,75.1
Business,Actuary,3.283182001019917,5,0,1,0,0,0,1,3,4,4,0,2,3,0,Commerce,Bachelors,25-30,12,1,8,Office,Tier1_City,5,3,2,4,2,1,5,24.03,Manufacturing,1,3,2,4,2,0,2,3,1,1,0,1,5,3,52.79
Finance,Counselor,2.761618293618486,8,1,2,1,5,0,2,1,3,3,2,4,3,0,Commerce,Masters,18-24,6,1,48,Remote,Any,5,2,0,1,0,0,3,27.54,Manufacturing,2,2,2,2,1,4,2,4,2,5,1,1,4,3,56.63
Music,Art Director,3.1283133898424818,8,0,1,1,0,1,3,3,0,3,3,4,3,0,Arts,Bachelors,36-40,12,1,22,Hybrid,Tier2_City,3,1,0,1,1,0,1,45.95,Education,1,5,1,5,0,2,2,4,1,2,1,1,3,3,57.56
Medicine,Fluid Mechanics Engineer,4.214990461663177,9,1,4,0,1,0,1,1,0,3,4,1,2,0,Science,Bachelors,36-40,10,0,0,Hybrid,Tier2_City,4,4,1,4,2,3,1,20.91,Manufacturing,3,3,5,5,3,1,1,1,5,3,1,1,3,1,60.27
Psychology,Musician,2.689741753129019,2,1,2,0,0,0,0,4,3,3,2,2,2,1,Arts,Masters,18-24,8,0,0,Hybrid,Tier3_City,4,4,0,4,2,3,2,13.22,Healthcare,3,2,2,2,0,2,5,2,5,2,1,1,1,3,59.67
Biology,Data Scientist,2.5995742935219144,4,0,0,0,6,0,2,3,2,0,1,0,4,0,Science,Masters,31-35,0,0,0,Flexible,Tier2_City,3,3,4,4,5,2,2,37.96,Manufacturing,5,2,5,5,1,5,2,1,5,1,0,1,5,2,44.42
Finance,Graphic Designer,2.6243290586462544,1,2,2,1,4,0,4,2,0,3,2,1,2,0,Commerce,PhD,31-35,1,0,0,Remote,Tier1_City,2,3,2,1,2,0,3,9.33,Manufacturing,1,1,5,4,2,2,5,5,1,3,1,0,2,1,48.88
Music,Credit Analyst,2.7539925587159653,7,1,2,1,1,1,3,2,1,3,3,3,1,0,Arts,Bachelors,25-30,12,0,0,Remote,Tier1_City,3,2,1,1,5,0,3,44.94,Other,1,1,1,5,1,0,4,1,5,4,0,1,2,5,74.18
Business,Market Research Analyst,4.276076605356296,7,1,1,0,8,1,2,3,0,0,0,0,2,1,Commerce,Bachelors,25-30,2,0,0,Flexible,Tier2_City,2,4,3,4,3,4,3,22.24,Finance,3,4,3,3,5,5,5,2,4,1,1,1,5,4,34.15
Computer Science,Cybersecurity Analyst,2.9880213618265152,6,1,1,1,3,1,3,0,4,2,1,2,3,0,Science,Masters,36-40,12,0,0,Remote,Tier2_City,2,3,5,5,4,1,3,31.85,Education,5,4,3,2,0,4,4,1,1,3,1,0,2,1,58.21
Music,Web Developer,2.8583763187811404,3,0,4,1,3,0,0,0,4,0,4,1,2,0,Arts,Masters,31-35,11,1,28,Hybrid,Tier1_City,2,4,5,5,0,1,1,11.75,Education,5,3,5,2,5,5,3,5,4,1,1,1,5,3,50.57
Marketing,Aerospace Engineer,4.595251973566624,4,0,0,1,3,0,3,3,2,3,1,4,1,0,Commerce,Bachelors,25-30,12,1,9,Hybrid,Tier2_City,1,4,3,2,4,2,2,9.84,Manufacturing,3,4,1,4,3,1,4,4,4,4,0,0,3,2,66.11
Education,Illustrator,3.092474261869298,9,1,0,1,8,1,3,0,0,4,2,2,0,1,Arts,Bachelors,31-35,4,0,0,Flexible,Tier2_City,1,3,0,3,4,5,2,40.55,Other,3,2,3,5,5,1,1,4,3,1,1,1,1,1,43.86
Chemistry,Geneticist,4.385302888008174,7,2,2,1,8,0,2,4,2,0,3,1,2,0,Science,Bachelors,18-24,3,0,0,Hybrid,Tier3_City,2,4,1,5,5,0,4,23.2,Tech,2,2,5,3,3,1,4,1,4,5,0,1,3,4,53.33
Chemistry,Web Developer,4.803327656638064,9,2,0,1,8,1,4,1,4,2,0,1,3,1,Science,Masters,25-30,3,1,38,Hybrid,Tier2_City,3,3,3,1,4,4,2,49.38,Finance,5,2,2,1,4,2,3,5,2,2,0,1,4,1,45.07
Finance,Digital Marketing Specialist,3.50593932739139,8,1,0,1,3,0,1,0,1,1,3,2,3,0,Commerce,Bachelors,18-24,14,1,13,Hybrid,Any,3,5,3,5,2,0,2,27.64,Manufacturing,5,2,2,3,4,5,3,2,4,1,0,0,4,5,52.01
Finance,Landscape Architect,4.211703195455547,0,1,1,0,6,0,1,0,0,4,2,3,3,0,Commerce,Bachelors,18-24,7,1,10,Flexible,Tier2_City,3,3,3,2,5,3,5,42.75,Tech,2,1,4,3,2,1,5,5,5,5,0,1,1,3,57.65
Business,Biologist,2.512484141568185,6,2,4,1,0,1,0,3,4,1,4,0,4,1,Commerce,Bachelors,31-35,7,1,38,Office,Any,1,4,0,2,4,2,5,49.06,Healthcare,3,2,4,5,2,1,5,1,3,5,0,1,1,1,59.49
Medicine,Inorganic Chemist,2.7184435992297127,5,1,1,1,4,1,1,2,1,1,1,0,1,0,Science,Bachelors,36-40,10,1,30,Remote,Tier2_City,2,5,0,3,5,5,4,16.21,Other,2,2,4,1,5,2,3,3,1,1,0,0,1,2,41.93
Medicine,Composer,2.7355092022604395,9,2,0,1,3,1,4,4,4,2,0,4,1,0,Science,Bachelors,25-30,6,0,0,Office,Tier2_City,4,4,1,5,3,1,3,40.64,Other,2,2,3,4,5,0,4,3,4,3,0,1,3,3,63.57
Architecture,Inorganic Chemist,4.603593267194736,9,0,3,0,8,0,1,2,4,2,2,0,3,1,Interdisciplinary,Bachelors,18-24,0,0,0,Office,Tier1_City,3,4,0,1,5,0,4,4.03,Finance,4,5,2,5,4,2,4,5,3,3,1,0,1,4,48.18
Medicine,Forensic Psychologist,4.178851563199715,3,0,4,0,8,1,1,0,0,4,3,2,3,0,Science,Bachelors,31-35,9,1,12,Office,Tier2_City,1,5,0,1,1,5,4,34.95,Other,5,3,2,2,4,2,2,1,4,2,1,1,3,3,48.54
Engineering,School Psychologist,3.435443378454978,8,1,2,1,0,1,3,3,1,1,3,4,1,0,Science,Masters,36-40,14,0,0,Office,Any,5,2,4,4,2,2,1,38.02,Education,3,3,3,1,1,5,1,5,4,3,0,0,4,1,64.82
Physics,Software Developer,4.338711818823066,1,0,4,1,6,1,2,1,3,0,2,2,3,0,Science,Bachelors,31-35,3,1,46,Hybrid,Tier1_City,2,5,0,1,0,1,2,25.44,Tech,4,2,2,2,1,0,4,1,5,4,1,0,2,5,45.07
Engineering,Forensic Psychologist,4.301051512609582,5,0,3,1,1,1,1,2,1,3,1,3,4,0,Science,Bachelors,36-40,0,0,0,Hybrid,Tier1_City,3,4,1,3,1,0,1,10.62,Manufacturing,4,2,2,1,5,3,3,2,2,1,1,1,2,3,31.02
Music,Judge,4.367891525485811,9,2,3,1,0,1,0,3,1,1,4,2,0,0,Arts,Masters,25-30,10,1,34,Office,Tier3_City,1,4,0,3,1,4,2,31.99,Tech,4,3,5,2,3,5,1,3,3,3,0,0,3,1,57.7
Psychology,Risk Analyst,4.089478266716293,2,0,2,0,0,1,0,1,0,0,4,0,1,0,Arts,Masters,31-35,13,0,0,Remote,Tier2_City,5,2,5,1,1,2,4,45.18,Education,3,4,2,5,5,3,5,4,3,4,0,0,4,1,56.25
Engineering,Biochemist,4.017911139399084,4,0,2,1,1,0,4,4,0,1,0,3,3,0,Science,Bachelors,18-24,4,0,0,Remote,Tier1_City,2,5,5,1,4,0,2,46.77,Healthcare,2,5,5,1,3,4,3,3,4,4,1,1,5,5,50.15
Psychology,Conductor,4.501850023013424,9,1,4,1,7,0,3,2,3,0,3,4,1,1,Arts,Bachelors,25-30,2,0,0,Remote,Tier2_City,4,3,0,4,5,1,3,38.07,Tech,3,5,4,4,4,4,3,4,3,5,1,1,5,1,56.79
Physics,Industrial-Organizational Psychologist,3.460166679503588,4,0,2,1,6,0,1,3,1,1,3,3,4,1,Science,Bachelors,25-30,2,1,37,Office,Tier2_City,2,4,4,1,5,1,3,15.39,Manufacturing,5,4,1,5,1,2,5,1,1,3,0,0,5,4,48.3
Education,Accountant,3.290131036390949,4,1,0,0,0,0,2,3,1,1,2,4,0,0,Arts,Masters,25-30,3,0,0,Office,Tier2_City,2,5,5,4,4,4,4,43.91,Tech,5,2,5,1,4,4,4,4,1,2,1,0,4,5,44.78
Physics,Physical Chemist,4.556525032737822,2,2,1,1,3,0,4,0,2,2,3,1,1,1,Science,PhD,36-40,1,1,49,Hybrid,Tier3_City,3,1,1,4,2,2,5,44.77,Other,2,3,2,2,4,3,5,2,4,4,0,0,4,4,53.99
Law,Web Developer,3.1608941810809026,7,1,2,0,4,1,3,0,2,0,3,3,1,1,Arts,Masters,36-40,6,1,34,Office,Tier1_City,2,4,5,1,4,2,3,20.26,Healthcare,3,5,4,3,2,4,3,1,3,3,0,0,1,4,56.97
Education,Artist,3.039204807334216,4,0,1,1,9,1,1,3,0,3,0,4,0,1,Arts,Masters,18-24,11,1,27,Office,Tier2_City,5,3,3,2,4,5,4,11.6,Tech,2,4,1,1,4,3,4,3,4,1,1,0,5,1,53.28
Marketing,Psychologist,3.926564404926831,5,1,2,1,0,1,1,4,0,0,0,1,0,1,Commerce,Masters,18-24,12,1,7,Flexible,Tier3_City,5,4,4,2,4,0,1,44.11,Healthcare,2,4,1,5,3,3,5,3,1,2,0,0,2,3,48.48
Engineering,Artist,2.8493277973383875,0,1,3,1,9,0,2,0,0,0,3,4,3,0,Science,Bachelors,25-30,3,0,0,Remote,Tier3_City,2,5,0,4,2,5,5,44.6,Healthcare,3,1,4,2,2,2,4,5,3,3,1,0,2,4,41.09
Psychology,Analytical Chemist,2.9151266406169976,3,0,2,0,9,0,0,2,0,0,1,1,3,0,Arts,Bachelors,25-30,4,0,0,Hybrid,Tier1_City,2,2,2,1,2,1,3,7.74,Finance,5,4,4,5,1,4,1,4,2,1,1,0,5,4,34.22
Music,Biochemist,4.462667624944514,9,1,1,1,4,1,0,1,2,1,0,4,4,1,Arts,Masters,31-35,11,0,0,Office,Tier1_City,5,1,4,2,3,1,4,48.45,Finance,3,1,1,2,3,4,4,1,4,4,1,0,3,3,59.44
Law,Acoustics Specialist,3.89696124540885,0,2,0,0,4,1,1,2,2,3,0,0,3,0,Arts,PhD,36-40,13,1,38,Remote,Tier2_City,5,3,4,1,3,4,4,28.05,Manufacturing,5,1,1,5,0,0,3,4,1,4,1,0,2,2,58.6
Engineering,Conductor,2.768780720496011,3,1,0,1,7,0,1,1,3,4,1,1,3,1,Science,Bachelors,40+,1,1,15,Hybrid,Any,3,4,1,1,3,4,1,49.71,Manufacturing,1,5,2,1,1,0,5,2,1,1,0,1,4,2,32.62
Computer Science,Legal Analyst,3.94636848351405,8,2,0,0,6,1,1,2,4,1,0,4,3,1,Science,Masters,31-35,5,0,0,Hybrid,Tier3_City,4,3,3,1,3,2,1,23.92,Manufacturing,1,2,5,1,5,3,4,2,2,3,1,0,5,5,52.49
Art,Human Resources Specialist,3.252001015046062,2,2,2,1,3,1,4,2,0,2,0,0,0,0,Arts,Bachelors,36-40,8,0,0,Office,Tier2_City,5,2,3,5,5,5,5,28.06,Healthcare,1,2,5,1,0,5,2,5,4,4,0,0,2,5,55.19
Finance,Dentist,3.109601315186037,4,0,3,1,1,0,1,3,4,4,2,1,4,1,Commerce,Bachelors,25-30,7,0,0,Hybrid,Any,4,1,3,1,1,1,3,15.51,Healthcare,4,4,1,2,3,2,5,1,5,3,1,1,1,4,56.37
Biology,Software Developer,3.549172518613492,2,0,1,1,2,0,0,4,0,0,1,3,4,1,Science,Bachelors,18-24,7,0,0,Hybrid,Tier2_City,4,3,4,5,1,0,4,45.25,Finance,5,3,1,4,1,1,5,1,5,4,1,0,1,3,50.57
Music,Doctor,3.986529563222207,4,2,2,0,0,0,4,3,2,2,3,1,2,0,Arts,Bachelors,25-30,1,0,0,Hybrid,Tier3_City,5,5,2,4,3,3,5,23.85,Other,5,3,3,5,0,4,2,4,1,5,1,0,4,3,51.28
Psychology,Special Education Teacher,4.076491801437618,7,2,3,0,3,1,2,0,2,1,4,3,2,0,Arts,Masters,25-30,14,0,0,Remote,Tier3_City,3,5,1,2,3,0,5,41.29,Healthcare,3,1,1,4,0,4,4,5,5,4,1,0,3,2,67.79
Chemistry,Physicist,3.7257927997399136,5,2,3,0,1,0,4,3,3,1,4,2,2,0,Science,Bachelors,31-35,3,0,0,Flexible,Any,2,3,2,2,0,4,1,6.75,Finance,5,4,5,4,1,3,1,3,1,4,1,1,1,1,49.61
Education,Music Therapist,2.582022327406934,0,0,3,0,2,0,0,3,1,0,0,0,1,0,Arts,Masters,18-24,7,0,0,Hybrid,Any,1,1,3,2,1,0,4,40.05,Tech,3,4,2,4,4,3,3,1,5,5,0,0,3,1,51.07
Chemistry,Fluid Mechanics Engineer,4.667926586638485,0,0,2,0,4,1,4,0,3,2,0,0,4,0,Science,Masters,25-30,10,0,0,Hybrid,Tier2_City,2,4,4,2,0,1,2,26.04,Manufacturing,4,2,3,3,3,4,1,1,1,2,1,0,3,2,50.39
Physics,Chemical Engineer,3.7981283798850063,7,2,1,0,3,0,4,3,2,4,4,3,1,1,Science,PhD,25-30,0,0,0,Remote,Tier1_City,1,5,3,2,0,5,1,3.25,Manufacturing,3,3,5,5,3,3,3,1,3,5,1,0,1,2,67.92
Engineering,Artist,2.9683655082182487,0,0,2,1,0,0,0,2,1,1,0,4,4,0,Science,Bachelors,40+,7,0,0,Hybrid,Tier2_City,5,4,2,2,4,2,4,13.63,Education,1,5,2,3,2,2,3,5,2,2,0,1,2,5,46.27
Physics,Composer,4.976706283372717,4,1,2,1,5,1,3,1,4,4,1,0,3,1,Science,Bachelors,25-30,2,0,0,Flexible,Any,2,4,3,2,5,5,5,12.11,Other,3,4,3,5,1,4,5,2,1,4,0,1,3,1,52.34
Education,Accountant,2.9334801513893707,8,0,0,0,8,1,3,2,1,1,4,4,0,0,Arts,Bachelors,31-35,7,0,0,Flexible,Tier3_City,2,3,0,4,2,3,5,38.33,Finance,3,4,3,3,3,4,3,3,5,2,1,1,2,5,60.35
Business,Marketing Specialist,3.0577446988279853,0,1,3,0,9,0,2,3,3,4,2,0,0,1,Commerce,PhD,31-35,5,0,0,Hybrid,Tier1_City,1,5,1,1,1,2,3,25.43,Education,3,2,3,5,0,0,5,2,4,1,1,0,5,2,56.37
Music,Education Administrator,4.020701942922976,2,2,3,1,8,1,0,2,3,3,0,0,2,1,Arts,PhD,25-30,6,0,0,Remote,Tier1_City,3,3,2,3,3,3,2,10.51,Manufacturing,5,5,3,1,1,3,2,4,5,1,1,1,5,2,48.35
Education,Teacher,4.427083970345526,0,1,4,0,7,1,2,0,1,0,3,3,1,1,Arts,Bachelors,25-30,1,0,0,Hybrid,Tier2_City,5,2,0,5,3,3,1,15.07,Education,2,5,3,4,5,5,3,1,2,1,0,1,3,2,32.89
Finance,Interior Designer,3.8400136496730384,3,1,4,1,0,1,4,0,3,0,4,4,0,0,Commerce,Masters,36-40,14,1,21,Hybrid,Tier2_City,5,4,3,3,2,1,3,26.69,Tech,2,5,3,2,0,0,2,4,5,5,0,0,1,3,71.18
Chemistry,Brand Manager,4.45888493470071,9,0,3,1,1,1,2,2,4,0,3,4,0,1,Science,Bachelors,25-30,0,0,0,Hybrid,Tier1_City,5,1,1,3,1,1,3,3.92,Education,2,5,4,4,1,3,1,4,5,1,0,0,4,2,46.78
Marketing,School Counselor,3.0089234749636384,6,2,2,0,9,1,2,3,4,1,2,0,3,1,Commerce,Masters,36-40,5,0,0,Hybrid,Tier3_City,2,4,1,1,3,4,2,22.93,Tech,5,3,2,5,0,1,5,1,4,3,0,0,1,1,56.19
Business,Counselor,3.9954379814923926,1,2,4,0,2,0,1,2,3,0,1,3,1,1,Commerce,Bachelors,18-24,11,0,0,Office,Tier1_City,4,1,1,1,3,4,1,34.87,Manufacturing,1,1,5,2,0,4,5,5,1,1,0,1,2,1,45.22
Architecture,Architectural Technologist,4.28740381682208,5,2,4,0,8,1,4,0,1,0,1,2,2,0,Interdisciplinary,Masters,18-24,2,0,0,Office,Tier2_City,1,3,4,1,4,3,1,27.33,Healthcare,2,5,1,4,1,0,4,4,3,4,1,1,2,2,51.46
Medicine,Doctor,2.8989408452500003,2,2,0,0,7,0,0,3,4,1,3,1,0,1,Science,Bachelors,36-40,3,1,15,Remote,Tier1_City,2,5,1,2,0,5,5,31.11,Finance,2,1,5,5,2,4,3,5,4,1,0,1,4,5,45.28
Computer Science,Chemical Engineer,3.4293055894647955,0,2,4,0,4,0,3,4,4,1,4,4,2,1,Science,Masters,36-40,12,0,0,Office,Any,3,4,0,4,3,4,1,18.35,Education,4,1,4,4,0,0,4,2,2,2,0,0,3,5,71.47
Chemistry,Ecologist,2.54232326381354,2,0,1,0,5,1,3,4,2,0,4,1,2,0,Science,Masters,40+,14,0,0,Office,Tier3_City,3,2,2,2,5,1,3,11.6,Other,4,2,4,5,1,0,4,3,4,4,1,1,5,3,73.44
Art,Actuary,4.717896005186768,5,0,0,0,1,0,2,0,0,1,4,0,1,1,Arts,Masters,31-35,8,0,0,Hybrid,Tier1_City,2,4,0,4,1,4,5,41.06,Tech,1,5,3,3,4,1,2,3,1,4,1,0,3,2,51.39
Psychology,Astronomer,3.678725986060516,1,0,2,1,3,0,2,0,4,2,3,3,1,0,Arts,High School,36-40,2,0,0,Flexible,Tier2_City,1,1,3,4,5,3,1,45.56,Other,3,3,4,3,5,4,5,3,2,1,0,1,4,4,40.0
Psychology,Curriculum Developer,3.285483601665585,5,1,0,0,9,0,3,0,0,3,4,2,4,0,Arts,Bachelors,36-40,1,0,0,Office,Tier1_City,5,1,4,3,2,2,2,27.0,Manufacturing,3,2,5,1,4,2,2,3,3,2,0,0,3,1,42.77
Marketing,Acoustics Specialist,3.2888446845055253,0,0,3,1,6,0,2,1,1,3,2,1,4,0,Commerce,Bachelors,36-40,1,0,0,Hybrid,Any,5,1,4,3,4,5,3,17.34,Other,4,2,4,2,5,3,5,5,3,4,1,0,1,5,43.39
Physics,Zoologist,4.846390371538398,0,1,1,1,2,0,3,4,3,3,1,4,0,1,Science,Bachelors,25-30,1,0,0,Flexible,Tier3_City,4,5,3,4,1,5,4,27.03,Other,4,1,5,3,2,4,5,2,5,4,0,0,1,5,58.97
Psychology,Special Education Teacher,2.933355264227245,0,2,1,0,5,1,4,1,0,2,3,4,3,1,Arts,Bachelors,25-30,5,0,0,Hybrid,Tier3_City,2,2,2,4,4,0,2,44.31,Manufacturing,1,4,3,5,1,3,4,5,5,3,1,1,4,1,61.26
Marketing,Pharmacist,4.644060521424432,9,0,1,0,4,0,1,4,3,4,3,4,2,0,Commerce,PhD,36-40,1,0,0,Hybrid,Tier1_City,4,2,4,2,0,4,2,35.5,Healthcare,1,3,3,4,5,2,2,4,2,5,0,1,1,5,59.38
Business,Mechanical Engineer,2.866556365821346,3,0,4,0,0,1,2,1,3,3,4,4,0,1,Commerce,Masters,25-30,10,1,37,Hybrid,Tier1_City,3,1,3,2,3,5,1,43.35,Other,5,5,4,1,2,5,2,1,3,2,1,0,1,4,67.03
Education,Legal Secretary,4.273911405060106,7,0,1,1,5,1,1,1,3,0,3,1,3,1,Arts,Bachelors,25-30,6,0,0,Flexible,Tier2_City,5,2,3,3,1,1,5,18.43,Other,3,5,1,4,5,5,5,4,1,1,1,1,5,1,37.47
Physics,Biologist,3.268785662707067,1,2,1,1,3,0,3,0,3,1,2,0,3,0,Science,Bachelors,25-30,6,0,0,Remote,Tier1_City,5,2,3,1,2,2,5,36.46,Other,5,3,3,4,0,2,2,5,2,4,1,1,4,4,50.95
Biology,Brand Manager,2.9634386970191136,7,2,2,0,0,0,2,0,1,2,0,2,1,0,Science,Bachelors,25-30,6,0,0,Hybrid,Tier3_City,4,3,3,4,0,1,3,33.69,Manufacturing,2,5,2,2,5,3,3,4,5,4,1,1,2,1,43.71
Business,Financial Analyst,4.4267812001498505,9,2,3,0,4,0,1,0,3,0,2,1,3,1,Commerce,Masters,25-30,13,0,0,Hybrid,Tier2_City,2,2,1,2,0,4,1,29.87,Other,1,4,2,4,5,3,2,4,5,5,0,1,3,2,59.36
Engineering,Illustrator,3.6876113931666334,3,0,0,1,1,1,1,0,2,0,0,2,1,1,Science,Bachelors,18-24,12,1,52,Hybrid,Tier1_City,4,1,2,3,4,3,5,27.83,Manufacturing,3,4,3,2,4,3,1,4,5,1,1,0,2,5,47.15
Computer Science,School Counselor,3.001976843340209,6,2,1,0,3,0,4,4,3,4,3,2,3,1,Science,PhD,36-40,1,0,0,Office,Tier1_City,3,5,5,2,0,0,4,28.9,Healthcare,3,5,4,5,2,2,2,2,4,3,0,1,2,1,62.06
Medicine,Architect,2.600658887754285,1,1,1,1,2,0,4,1,1,3,4,1,3,0,Science,Bachelors,25-30,6,0,0,Hybrid,Any,2,3,3,4,1,0,1,42.93,Manufacturing,5,2,3,4,0,2,3,2,3,3,1,0,5,3,56.66
Medicine,Construction Manager,3.320186574326004,6,1,2,1,1,0,4,1,4,4,0,2,3,1,Science,PhD,25-30,9,0,0,Remote,Any,3,2,1,4,4,2,1,46.05,Other,4,5,4,4,4,2,2,1,4,2,1,0,5,1,70.29
Psychology,Legal Consultant,4.563654495091091,1,2,0,0,1,1,1,2,4,3,1,4,2,1,Arts,Masters,18-24,7,0,0,Flexible,Tier1_City,2,3,1,5,0,5,5,8.3,Tech,4,5,5,4,2,4,3,3,2,5,0,1,1,2,61.71
Law,Human Resources Specialist,3.163090962248224,0,2,2,0,7,1,1,2,3,1,0,1,3,1,Arts,Bachelors,18-24,7,0,0,Office,Tier1_City,4,4,0,1,2,5,2,29.73,Other,1,3,1,5,0,3,1,5,4,5,0,0,2,1,52.27
Education,Principal,2.699124171856292,4,1,2,1,2,1,0,0,1,0,2,2,4,1,Arts,PhD,18-24,13,1,47,Flexible,Tier1_City,1,3,5,5,5,5,1,46.17,Education,4,4,1,3,5,4,4,5,3,4,1,1,4,1,56.54
Education,Acoustics Specialist,4.924374825702507,2,1,2,1,9,0,0,4,4,0,2,2,3,0,Arts,Bachelors,31-35,1,1,41,Remote,Tier1_City,4,3,3,3,1,0,2,9.33,Education,2,2,5,3,3,1,5,2,2,4,0,0,3,4,45.39
Education,Nuclear Physicist,4.284059662469474,6,2,4,1,2,1,4,1,0,3,2,4,1,1,Arts,Masters,18-24,4,0,0,Hybrid,Any,2,3,1,2,2,3,3,22.4,Tech,3,3,5,5,4,2,5,2,3,4,1,1,1,5,56.12
Physics,Nurse,4.050598686209977,7,1,1,1,1,1,1,3,4,1,3,1,4,1,Science,Bachelors,36-40,13,1,19,Office,Tier3_City,3,2,5,3,2,5,3,7.19,Education,4,3,5,1,0,5,5,1,3,4,0,1,4,4,61.06
Psychology,Legal Analyst,4.080632687451398,0,2,4,1,3,1,4,0,3,2,3,1,0,1,Arts,Masters,18-24,5,0,0,Hybrid,Any,4,3,0,4,4,1,5,8.33,Other,1,2,1,1,3,4,1,5,1,1,1,1,1,5,49.01
Psychology,Financial Analyst,4.297878008481188,5,2,2,1,2,0,3,2,4,4,4,3,3,1,Arts,Masters,18-24,8,1,42,Office,Any,2,5,0,5,3,5,3,45.49,Manufacturing,2,2,3,2,2,2,1,5,1,1,0,1,4,3,63.67
Business,Quantum Physicist,2.8630614430313712,6,0,2,0,6,1,0,3,4,1,2,4,4,1,Commerce,Masters,18-24,5,1,48,Remote,Tier3_City,3,2,3,5,4,3,5,23.97,Other,5,3,2,5,3,0,3,1,1,2,1,0,1,3,54.36
Education,Biologist,3.4148675769299137,7,0,1,1,9,0,2,1,2,0,2,2,0,0,Arts,Masters,18-24,9,0,0,Hybrid,Tier2_City,3,1,4,5,1,2,5,35.37,Education,5,5,4,1,5,3,1,1,5,3,1,0,3,4,55.83
Finance,Digital Marketing Specialist,2.855824521365196,8,0,4,0,6,1,0,4,3,4,4,1,2,1,Commerce,Bachelors,31-35,5,0,0,Hybrid,Any,3,4,1,3,1,2,2,9.53,Education,2,2,2,2,4,2,4,4,4,2,0,1,4,5,53.09
Business,Education Administrator,3.6311166469024094,8,2,0,0,5,1,0,0,3,3,2,0,3,0,Commerce,Bachelors,36-40,9,1,10,Hybrid,Tier2_City,2,1,4,4,4,0,2,4.03,Manufacturing,1,1,4,4,1,3,3,1,1,4,0,1,1,2,51.29
Computer Science,Chemist,4.769226454530632,7,0,4,0,1,1,0,1,4,3,0,2,3,1,Science,Bachelors,31-35,9,0,0,Hybrid,Tier1_City,3,2,0,2,3,3,3,44.85,Education,5,2,1,4,2,4,4,4,2,5,0,0,3,4,54.24
Finance,Web Developer,3.911450377077754,0,1,1,1,8,1,0,4,0,0,0,1,4,0,Commerce,Bachelors,18-24,14,0,0,Remote,Tier2_City,3,1,4,2,4,1,2,30.0,Manufacturing,3,3,3,1,3,0,4,5,5,1,0,0,3,1,46.59
Finance,Financial Advisor,4.34947137987409,2,2,4,0,4,0,3,4,4,4,4,3,0,1,Commerce,Masters,25-30,5,0,0,Office,Tier2_City,4,4,4,3,1,3,1,3.94,Healthcare,3,1,2,2,0,3,2,4,1,1,0,1,3,4,55.88
Architecture,Web Developer,4.640699345057261,9,2,2,0,3,0,3,2,3,0,4,2,2,1,Interdisciplinary,Bachelors,25-30,8,1,50,Hybrid,Any,3,3,3,5,3,1,4,49.64,Other,1,3,5,2,1,1,5,3,4,1,0,0,1,1,56.42
Education,Composer,3.8040174787672174,5,0,4,1,4,1,4,4,2,0,2,3,4,0,Arts,PhD,40+,9,1,42,Hybrid,Tier2_City,1,1,0,1,1,1,1,26.13,Healthcare,1,4,5,3,1,2,4,2,5,1,1,0,4,4,67.62
Art,Fluid Mechanics Engineer,4.37667369314969,8,0,1,0,0,0,2,3,4,3,0,1,3,1,Arts,Masters,18-24,6,0,0,Hybrid,Tier1_City,2,2,2,3,3,3,1,25.37,Education,3,4,5,1,2,3,5,4,5,5,1,0,5,5,64.87
Art,Judge,4.190820661780909,5,1,4,1,7,0,4,3,3,2,4,1,0,0,Arts,Masters,31-35,0,1,17,Hybrid,Tier1_City,3,5,1,3,3,4,5,32.18,Healthcare,1,5,2,3,3,5,3,3,2,2,1,1,5,2,51.34
Law,Sound Engineer,3.6122974290824414,7,0,1,1,0,0,4,1,4,0,3,0,0,1,Arts,Bachelors,25-30,0,0,0,Hybrid,Any,3,4,3,4,4,3,4,3.37,Education,2,2,3,5,4,5,5,1,3,1,1,0,4,2,44.77
Computer Science,AI Researcher,4.044873053309274,1,0,4,0,1,1,2,2,2,4,3,2,1,1,Science,Masters,25-30,13,1,50,Office,Any,5,1,3,2,4,1,5,29.75,Healthcare,1,3,3,2,3,1,1,1,2,4,0,0,3,1,67.28
Medicine,Legal Analyst,3.413426018303264,9,1,0,1,2,0,3,4,2,2,2,1,1,0,Science,PhD,25-30,3,0,0,Hybrid,Tier3_City,4,5,2,3,4,5,2,32.59,Education,3,1,5,3,3,3,5,1,4,4,1,1,1,2,62.09
Computer Science,Aerospace Engineer,3.58972761776442,2,1,1,1,2,0,0,2,0,0,1,2,1,1,Science,Bachelors,18-24,14,0,0,Hybrid,Tier1_City,3,4,3,3,3,2,2,16.96,Finance,4,2,2,2,2,4,1,1,4,2,0,1,2,1,43.45
Marketing,Conductor,4.639312683925111,1,2,0,1,8,0,0,2,1,4,2,2,4,1,Commerce,Masters,31-35,11,0,0,Hybrid,Tier1_City,4,1,0,5,3,2,4,37.16,Other,1,5,5,5,2,5,2,3,4,2,0,0,2,5,60.02
Biology,Financial Analyst,4.143351542083547,5,2,1,1,0,1,1,3,1,3,2,2,3,1,Science,Masters,18-24,1,0,0,Office,Tier2_City,4,2,3,5,1,0,3,20.74,Tech,5,3,4,3,0,2,2,2,5,2,1,1,3,2,45.13
Psychology,Data Scientist,3.956664540460534,0,1,3,1,5,0,0,2,0,2,1,0,3,0,Arts,Bachelors,31-35,2,0,0,Hybrid,Any,1,5,3,1,2,2,2,36.74,Other,2,3,4,5,4,2,4,4,4,2,1,0,4,2,37.73
Marketing,Financial Controller,4.304226803556084,6,1,2,0,2,1,4,3,0,0,4,4,4,1,Commerce,Bachelors,18-24,11,1,38,Hybrid,Any,2,5,2,4,4,4,1,9.76,Healthcare,2,4,2,2,2,1,1,2,2,5,1,1,1,2,66.47
Engineering,AI Researcher,4.181827441958675,0,1,1,0,5,1,3,3,3,1,4,1,0,0,Science,Bachelors,40+,6,0,0,Hybrid,Any,1,1,1,1,5,1,4,45.94,Manufacturing,2,5,4,2,0,5,1,4,5,1,1,0,4,5,61.23
Chemistry,Legal Analyst,4.755664726544346,5,2,2,1,9,1,2,4,4,4,0,0,0,1,Science,Bachelors,18-24,13,1,53,Remote,Tier2_City,2,1,5,5,1,3,4,44.33,Tech,5,3,1,4,5,5,5,2,2,5,0,0,3,1,62.11
Business,Music Therapist,3.070887152857809,5,1,0,1,5,0,1,2,2,3,3,1,1,0,Commerce,Bachelors,36-40,6,0,0,Remote,Any,5,2,1,2,1,3,2,10.08,Education,5,4,1,2,1,0,2,3,1,5,0,1,1,5,48.86
Education,Psychologist,4.871324581172059,8,0,4,0,6,1,1,4,0,3,2,1,2,1,Arts,Bachelors,36-40,13,0,0,Remote,Tier1_City,1,2,4,5,0,4,2,47.11,Tech,2,4,1,4,0,5,1,3,1,1,1,0,5,4,48.15
Computer Science,Art Director,2.9973387804128624,3,2,1,0,1,1,4,0,1,2,4,2,0,1,Science,High School,40+,11,0,0,Hybrid,Tier1_City,4,3,0,4,4,2,5,29.22,Manufacturing,2,1,4,5,4,0,3,1,1,5,0,1,4,2,62.27
Engineering,Aerospace Engineer,4.0832155273945645,9,0,4,0,8,0,0,1,3,0,2,3,3,1,Science,Bachelors,25-30,2,1,16,Remote,Any,3,1,2,5,1,1,5,35.98,Manufacturing,2,5,3,1,0,1,2,5,2,2,0,0,4,1,34.68
Art,Construction Manager,3.5193830395064296,5,2,1,0,3,0,1,3,3,1,2,2,0,0,Arts,PhD,31-35,12,0,0,Hybrid,Tier1_City,5,2,1,4,0,2,1,42.49,Other,1,5,1,5,5,3,4,3,3,3,0,1,3,1,66.14
Chemistry,Credit Analyst,4.9556636881198015,0,2,3,1,7,1,4,1,4,3,3,1,1,0,Science,Bachelors,25-30,1,1,21,Remote,Tier3_City,2,1,2,4,5,0,4,6.93,Education,5,3,5,4,0,0,4,3,2,4,1,1,4,2,52.78
Music,Legal Consultant,4.18175114870447,6,2,2,0,2,1,3,4,4,3,3,2,3,0,Arts,PhD,18-24,14,1,43,Hybrid,Tier2_City,1,2,5,4,5,2,3,10.96,Other,3,1,3,1,2,2,2,1,1,2,1,0,3,4,70.01
Physics,Quantum Physicist,3.592011934579072,5,2,2,1,7,0,4,3,1,0,1,3,2,1,Science,Bachelors,25-30,12,0,0,Remote,Tier1_City,5,4,4,4,4,0,3,16.65,Healthcare,1,2,2,4,4,1,1,5,3,2,1,1,5,1,57.04
Marketing,Biomedical Engineer,4.1602926150069415,7,0,3,0,8,1,0,4,4,4,0,1,4,1,Commerce,Bachelors,18-24,12,0,0,Hybrid,Tier1_City,1,2,1,4,3,3,4,25.43,Healthcare,3,3,4,2,0,1,4,3,5,1,0,0,3,4,59.36
Law,Clinical Psychologist,3.773944607617315,7,0,1,1,1,1,2,2,2,4,0,2,0,0,Arts,Bachelors,40+,0,1,6,Flexible,Tier1_City,4,2,2,2,0,1,1,19.26,Finance,1,4,5,4,3,2,2,3,4,3,0,0,3,4,44.51
Computer Science,Microbiologist,3.1494548694944284,0,0,4,1,9,0,1,3,2,1,1,3,2,0,Science,Bachelors,18-24,8,1,43,Hybrid,Tier3_City,1,4,5,1,3,5,5,26.77,Other,1,2,2,1,0,0,5,2,3,1,1,1,1,3,46.32
Physics,Credit Analyst,3.5131176618983035,3,0,0,1,9,0,4,3,2,1,1,3,4,0,Science,Bachelors,25-30,9,0,0,Hybrid,Tier1_City,2,4,0,3,5,0,5,11.74,Manufacturing,3,2,4,4,1,4,1,4,1,2,1,1,4,3,56.29
Medicine,Ecologist,2.7136720929739084,7,1,2,0,2,0,3,0,1,0,3,2,4,1,Science,Masters,31-35,2,0,0,Office,Tier2_City,2,3,0,1,5,2,5,35.06,Finance,2,3,4,3,1,1,2,4,3,5,1,0,3,3,50.8
Education,Biologist,3.866412508550596,9,1,4,1,1,0,1,3,4,3,0,0,0,0,Arts,Bachelors,25-30,8,0,0,Remote,Tier2_City,3,2,4,4,2,2,3,5.62,Manufacturing,3,1,5,3,0,5,5,2,4,4,1,1,3,1,58.6
Medicine,Web Developer,3.353878935680152,1,1,3,0,3,0,3,3,1,4,3,2,0,1,Science,Masters,31-35,14,0,0,Remote,Tier1_City,3,4,1,2,2,3,3,19.99,Finance,4,5,4,5,5,3,3,4,5,4,0,1,1,5,72.0
Music,Analytical Chemist,3.684836012998338,3,2,4,0,1,0,1,2,1,1,1,3,1,0,Arts,Masters,18-24,14,0,0,Remote,Tier1_City,2,3,1,5,2,4,1,11.41,Other,5,1,4,5,0,1,4,1,2,2,0,0,1,1,56.25
Engineering,Special Education Teacher,3.577932436875166,2,1,2,1,7,1,0,0,4,2,3,4,0,1,Science,Bachelors,25-30,3,0,0,Remote,Tier1_City,2,3,0,2,2,5,3,37.31,Healthcare,4,3,4,1,3,5,2,5,3,1,1,1,4,4,42.87
Engineering,Electrical Engineer,3.1793943228492045,2,1,2,1,5,0,1,3,2,1,0,2,0,0,Science,Bachelors,25-30,14,0,0,Remote,Tier1_City,2,1,5,4,1,4,2,44.53,Manufacturing,1,5,3,4,0,5,1,3,1,3,1,1,1,5,46.47
Chemistry,Landscape Architect,4.781782266481788,2,0,0,1,4,0,0,1,2,3,4,0,3,1,Science,Masters,36-40,9,0,0,Hybrid,Tier2_City,5,4,4,2,2,2,3,6.7,Other,3,2,1,2,2,4,5,4,4,3,0,0,4,1,57.31
Psychology,Art Director,4.456396830012201,4,2,1,1,5,0,4,1,4,2,1,3,4,0,Arts,Bachelors,31-35,5,1,22,Remote,Any,1,5,3,2,1,4,5,39.9,Other,2,4,5,1,4,2,2,3,3,2,0,0,4,3,47.11
Engineering,Education Administrator,4.188907950952685,8,1,3,1,2,0,1,0,3,3,0,2,3,0,Science,Bachelors,40+,12,1,21,Flexible,Tier1_City,5,4,0,4,1,5,1,45.1,Healthcare,2,1,3,1,5,5,2,2,3,3,1,0,2,3,49.98
Engineering,Web Developer,2.7436543215991978,5,2,0,0,1,0,3,2,3,4,0,3,4,1,Science,PhD,18-24,6,1,26,Flexible,Any,4,4,0,2,4,5,4,48.78,Tech,4,5,5,1,3,0,5,2,3,1,1,1,2,1,60.09
Psychology,Biomedical Engineer,4.40169082644648,2,0,2,1,6,1,4,2,0,0,2,4,4,0,Arts,Bachelors,25-30,9,1,33,Flexible,Tier2_City,3,3,2,3,1,1,4,30.23,Healthcare,4,1,3,5,0,2,2,4,1,3,0,0,3,5,53.41
Architecture,Special Education Teacher,3.181099365529532,4,0,1,1,9,1,4,1,4,2,3,2,3,1,Interdisciplinary,Masters,18-24,13,0,0,Remote,Tier2_City,1,4,4,3,1,4,1,18.39,Manufacturing,1,5,4,1,5,2,1,2,3,1,1,1,4,4,58.82
Engineering,Marketing Specialist,2.618701150527689,2,0,2,0,9,0,1,1,1,3,2,4,2,0,Science,PhD,18-24,5,1,34,Flexible,Any,3,4,3,2,2,1,2,18.13,Tech,5,4,4,4,2,0,4,4,3,2,0,1,4,2,55.48
Education,Zoologist,4.87222905764388,8,0,0,1,3,1,2,0,2,4,3,0,3,1,Arts,Bachelors,18-24,0,1,11,Office,Tier2_City,4,3,5,5,1,2,4,20.81,Finance,1,3,3,1,5,2,1,1,5,3,0,0,2,5,44.13
Medicine,School Psychologist,2.837746163211985,2,2,4,1,9,1,1,3,3,4,3,1,0,1,Science,Bachelors,31-35,5,1,35,Flexible,Tier1_City,2,3,4,4,3,2,5,31.8,Education,2,3,4,2,0,5,1,4,1,1,0,1,1,4,47.83
Music,Social Media Manager,2.9344081482970963,9,0,4,0,3,1,0,4,3,4,0,3,1,1,Arts,Bachelors,18-24,10,0,0,Hybrid,Tier1_City,3,1,4,3,2,2,4,26.04,Manufacturing,3,5,1,1,3,2,4,2,3,5,0,1,1,4,61.72
Medicine,Physicist,4.184998106178406,0,2,2,0,6,0,2,0,4,2,4,0,3,0,Science,Bachelors,25-30,13,0,0,Office,Tier3_City,2,1,0,5,0,3,4,33.72,Education,4,5,5,5,3,1,2,1,4,3,0,0,1,3,59.86
Architecture,Biochemist,4.599444805414269,6,2,3,0,8,1,3,3,4,1,1,4,1,0,Interdisciplinary,Bachelors,36-40,5,0,0,Remote,Tier1_City,3,4,0,2,2,4,5,4.85,Education,2,3,4,5,1,3,5,1,2,4,1,0,4,1,60.21
Chemistry,Biomedical Engineer,4.662093112201672,1,0,3,0,3,1,0,0,4,2,2,2,4,0,Science,Masters,31-35,4,0,0,Remote,Tier2_City,4,4,0,5,1,0,3,7.98,Tech,1,2,2,2,1,0,5,4,2,3,1,0,2,1,47.15
Law,Legal Analyst,3.689830743717141,1,2,4,0,2,1,3,4,4,4,3,2,4,0,Arts,Bachelors,25-30,2,1,28,Remote,Tier2_City,3,2,2,1,3,5,2,48.9,Finance,5,2,3,1,0,1,3,3,5,3,1,0,5,5,61.72
Computer Science,Industrial-Organizational Psychologist,4.881711268672866,0,2,4,1,5,1,1,1,0,1,3,2,2,0,Science,Bachelors,25-30,9,0,0,Flexible,Tier1_City,4,5,3,3,2,0,5,49.78,Healthcare,3,2,3,1,4,5,1,3,1,5,0,0,2,2,49.77
Finance,Accountant,3.615859794257427,9,2,1,1,0,1,3,3,1,2,2,4,3,1,Commerce,PhD,25-30,2,1,26,Remote,Tier3_City,1,2,5,2,3,2,5,38.09,Tech,5,4,4,1,2,4,4,2,4,3,1,0,3,1,58.64
Engineering,Investment Banker,4.296063993639407,1,2,2,0,8,0,4,3,2,2,3,0,4,1,Science,Masters,18-24,10,0,0,Remote,Tier3_City,5,2,5,4,0,4,1,15.05,Finance,1,5,3,5,1,1,5,4,1,3,1,0,1,1,60.53
Music,Legal Secretary,4.169384173370376,1,0,4,1,4,0,4,0,0,0,2,1,4,0,Arts,Masters,31-35,9,0,0,Flexible,Tier2_City,4,4,3,2,5,1,2,47.81,Healthcare,1,1,2,1,1,1,4,3,2,2,1,1,1,3,49.68
Engineering,AI Researcher,4.579262671872712,1,0,2,0,9,0,2,4,2,1,1,0,1,0,Science,Bachelors,25-30,12,0,0,Remote,Tier1_City,3,3,4,4,0,0,3,13.04,Healthcare,2,1,3,5,4,2,5,4,4,2,1,0,4,2,55.65
Biology,Construction Manager,3.020607298692468,6,2,1,1,2,1,3,4,3,0,2,0,3,1,Science,Masters,36-40,6,0,0,Flexible,Tier1_City,1,3,5,2,5,2,5,37.38,Finance,3,5,2,5,5,3,4,3,2,1,0,1,3,1,54.5
Computer Science,Advertising Manager,3.123323575519878,9,0,0,1,8,0,3,0,4,3,3,2,0,1,Science,Bachelors,31-35,7,0,0,Office,Tier2_City,4,5,5,5,4,0,3,8.42,Healthcare,1,3,3,4,3,1,1,1,2,4,1,0,2,2,63.32
Education,Legal Secretary,3.3693069464801626,2,2,1,0,1,1,0,2,3,2,0,3,0,1,Arts,Bachelors,31-35,13,0,0,Remote,Tier3_City,3,3,5,5,5,0,5,33.5,Manufacturing,2,5,3,3,0,4,3,4,1,3,1,1,4,4,50.62
Business,Pharmacist,3.1863536406819923,7,2,0,1,4,1,3,1,3,0,4,3,3,1,Commerce,Bachelors,25-30,2,0,0,Remote,Tier2_City,4,4,0,5,4,5,5,38.7,Manufacturing,1,2,2,5,0,2,3,3,3,2,1,1,5,4,52.84
Business,Financial Analyst,3.789056339266309,3,0,1,0,1,1,1,2,3,4,4,0,1,1,Commerce,Masters,18-24,2,1,32,Hybrid,Any,4,3,5,1,2,0,1,43.4,Tech,2,2,5,3,2,1,1,5,5,1,1,0,1,1,50.52
Education,Human Resources Specialist,4.854977937165032,9,2,1,1,5,1,3,2,4,4,1,0,0,0,Arts,Bachelors,31-35,6,0,0,Flexible,Tier1_City,2,1,4,4,4,2,4,37.51,Healthcare,5,1,1,4,4,4,2,2,4,5,0,0,5,2,63.15
Architecture,Quantum Physicist,4.358941879069756,8,0,2,1,4,0,1,3,2,2,3,4,1,1,Interdisciplinary,Bachelors,25-30,9,1,41,Flexible,Any,3,5,0,5,3,5,2,46.4,Healthcare,2,5,2,3,5,0,2,2,5,4,0,1,1,2,63.76
Psychology,Acoustics Specialist,2.8197075604715343,4,0,2,0,6,0,3,0,0,1,3,0,4,0,Arts,Bachelors,18-24,11,0,0,Hybrid,Tier2_City,5,3,4,1,4,2,1,27.48,Finance,5,1,1,3,4,5,4,4,4,5,0,1,1,1,58.73
Music,Sound Engineer,3.751859587356962,7,0,1,1,0,1,1,2,1,4,3,2,3,1,Arts,Bachelors,18-24,6,0,0,Hybrid,Tier3_City,4,3,4,4,3,3,3,34.84,Manufacturing,4,3,3,2,4,1,1,5,2,1,1,1,3,1,46.0
Law,Mechanical Engineer,3.5888725701181574,2,1,0,1,5,0,2,4,4,2,2,4,1,1,Arts,Masters,18-24,10,0,0,Hybrid,Tier1_City,1,1,2,2,5,3,5,20.37,Education,1,4,5,2,3,0,1,1,4,5,0,0,3,3,75.17
Architecture,Nurse,2.7045854289081754,6,0,3,1,8,0,1,3,4,4,4,2,3,1,Interdisciplinary,Masters,31-35,8,1,48,Office,Tier2_City,3,2,5,1,5,3,5,3.49,Tech,4,4,2,3,4,0,4,2,4,3,0,0,4,5,70.45
Finance,Financial Controller,3.325206478540307,1,1,4,0,5,0,3,2,1,4,2,3,1,0,Commerce,Masters,18-24,13,0,0,Hybrid,Tier3_City,5,4,2,3,5,0,2,38.56,Other,3,3,5,5,3,4,4,4,1,5,1,0,3,1,67.77
Chemistry,Social Media Manager,3.6013212499698994,8,1,4,1,6,0,1,1,2,2,0,1,3,0,Science,High School,25-30,5,0,0,Remote,Tier3_City,3,3,5,1,4,4,1,43.88,Manufacturing,4,2,2,1,0,2,5,2,5,2,0,1,1,2,39.83
Engineering,Education Administrator,3.561468567988896,7,0,2,0,3,0,1,1,1,4,0,4,4,0,Science,Bachelors,25-30,14,1,46,Office,Tier1_City,5,1,4,1,5,2,1,11.17,Finance,2,2,4,1,3,3,3,4,5,2,1,0,2,2,57.91
Engineering,Principal,4.683824746628639,2,0,4,0,1,1,3,2,1,3,4,1,2,1,Science,Bachelors,25-30,12,0,0,Hybrid,Tier1_City,5,1,0,4,4,3,3,4.35,Tech,2,2,2,4,0,3,5,5,4,5,0,1,1,4,67.19
Medicine,Principal,4.835760275225864,1,0,2,0,3,1,4,4,3,0,2,2,2,0,Science,High School,36-40,6,0,0,Remote,Tier2_City,4,2,4,2,4,4,1,10.73,Education,3,1,1,5,2,1,4,3,3,4,1,0,2,1,57.62
Biology,Surgeon,3.69313874152439,1,2,1,0,7,0,1,0,1,0,1,1,0,1,Science,Bachelors,36-40,10,1,14,Office,Any,2,3,0,3,1,3,1,45.08,Other,3,1,4,3,4,5,4,3,3,2,0,1,3,3,43.03
Engineering,Chemical Engineer,3.136637923866418,5,2,1,1,2,1,3,1,1,3,2,3,2,1,Science,Masters,25-30,9,0,0,Hybrid,Tier2_City,3,2,1,5,1,3,4,16.89,Tech,1,4,3,2,2,4,4,3,5,5,1,0,5,3,68.29
Computer Science,Special Education Teacher,2.652002041534256,5,2,4,1,0,1,1,0,0,4,3,0,4,1,Science,Bachelors,18-24,0,0,0,Hybrid,Tier1_City,1,5,3,5,4,4,2,13.98,Manufacturing,2,2,2,1,4,0,5,3,4,3,0,1,5,5,38.9
Finance,Marketing Manager,3.03441438832913,5,1,3,1,7,1,0,1,1,3,0,2,0,1,Commerce,Bachelors,25-30,6,0,0,Office,Any,1,1,4,1,3,3,1,3.69,Education,3,2,1,3,5,1,3,1,5,2,1,1,3,3,47.61
Marketing,Biomedical Engineer,3.701279199650676,0,2,4,1,6,0,2,2,4,3,4,1,0,1,Commerce,Bachelors,31-35,1,0,0,Hybrid,Tier2_City,2,4,1,4,2,0,3,16.96,Other,4,3,3,1,2,2,4,4,1,2,1,1,5,5,39.59
Psychology,Clinical Psychologist,4.511479516231512,6,1,3,0,7,1,3,0,1,4,4,3,4,1,Arts,High School,25-30,6,0,0,Hybrid,Tier1_City,1,1,4,4,0,0,5,36.64,Finance,2,4,1,2,1,5,2,1,2,5,0,0,2,1,48.95
Education,AI Researcher,4.501157125843531,4,0,1,0,5,1,1,3,4,2,1,4,3,0,Arts,Bachelors,31-35,2,0,0,Flexible,Tier1_City,3,2,2,5,1,5,1,48.08,Tech,3,1,3,2,1,5,3,3,1,5,0,0,5,2,49.3
Art,Cybersecurity Analyst,2.609289792295168,8,2,2,0,5,1,3,1,4,1,2,1,1,1,Arts,PhD,18-24,8,1,34,Hybrid,Tier3_City,1,4,3,3,4,0,1,17.7,Manufacturing,1,4,2,5,3,3,2,3,2,5,1,1,2,1,69.72
Computer Science,Advertising Manager,2.857596834638076,0,1,2,1,8,0,1,0,2,3,2,2,0,1,Science,Masters,31-35,12,0,0,Office,Tier1_City,3,4,4,2,0,1,5,14.31,Finance,5,2,5,3,5,5,2,5,4,4,0,1,3,5,59.3
Engineering,Financial Advisor,4.714814517029889,2,1,0,0,6,0,0,2,2,0,1,0,0,0,Science,PhD,18-24,4,0,0,Hybrid,Tier1_City,5,1,5,3,1,5,4,44.74,Education,2,2,3,3,2,3,3,2,4,2,1,0,3,2,43.68
Music,Civil Engineer,3.343711875492046,9,1,1,0,9,0,0,1,0,3,3,4,3,1,Arts,Bachelors,31-35,6,1,9,Hybrid,Tier2_City,4,4,2,2,2,3,2,43.07,Tech,2,1,5,4,4,0,2,3,1,3,1,0,5,1,46.99
Architecture,Construction Manager,4.073400849157312,3,0,4,1,8,0,4,0,0,4,2,1,3,1,Interdisciplinary,Bachelors,25-30,7,0,0,Remote,Tier1_City,2,3,2,5,3,1,4,18.42,Healthcare,2,1,3,4,0,5,1,1,1,3,0,1,1,1,51.57
Finance,Entrepreneur,3.5739771145320853,2,0,3,1,8,0,0,4,3,3,1,1,0,1,Commerce,Bachelors,31-35,12,1,13,Hybrid,Tier1_City,2,1,1,2,4,2,3,6.23,Manufacturing,2,4,5,2,3,1,5,1,3,1,1,0,4,4,53.37
Architecture,Psychologist,3.00497854549844,0,2,1,1,5,0,3,4,0,1,3,1,1,1,Interdisciplinary,Bachelors,18-24,11,1,40,Office,Tier2_City,1,2,5,4,2,4,1,49.62,Manufacturing,5,5,2,5,5,5,4,1,1,5,1,0,5,5,56.8
Finance,Counselor,3.500990428768413,5,1,2,1,9,1,4,1,2,0,2,4,4,0,Commerce,Masters,25-30,1,0,0,Hybrid,Tier3_City,3,5,2,1,1,2,4,34.99,Healthcare,5,2,1,3,3,1,1,5,5,1,1,0,3,2,50.54
Education,Artist,3.821855957409977,4,0,1,1,7,0,2,4,3,0,4,0,2,1,Arts,Bachelors,31-35,10,0,0,Hybrid,Tier1_City,4,2,5,1,4,1,2,46.55,Finance,1,2,2,5,5,3,4,1,2,1,0,1,3,3,56.92
Psychology,Electrical Engineer,4.9777761268067655,8,0,3,1,6,0,0,3,4,2,1,2,1,0,Arts,Bachelors,18-24,0,1,33,Office,Tier1_City,1,3,1,5,0,0,3,19.07,Manufacturing,2,5,3,2,1,2,4,4,3,4,0,1,3,4,42.93
Marketing,Aerospace Engineer,4.8834321412511,7,0,2,0,6,1,1,4,2,1,2,1,3,0,Commerce,Bachelors,31-35,6,1,16,Remote,Tier2_City,4,5,0,4,5,3,4,33.44,Finance,3,4,4,2,5,4,1,4,5,4,1,1,4,4,58.95
Chemistry,Sound Engineer,3.0384858539626185,6,2,3,1,4,0,1,0,3,4,1,4,4,1,Science,Bachelors,31-35,14,0,0,Office,Tier1_City,3,5,0,3,3,5,1,34.7,Education,4,3,1,4,2,5,4,5,5,5,0,0,4,1,66.78
Business,Chemist,4.47149158289508,7,1,0,0,4,1,2,0,3,4,3,0,0,0,Commerce,Masters,25-30,5,0,0,Hybrid,Tier2_City,1,2,0,4,1,3,2,44.03,Healthcare,2,3,5,4,2,0,3,4,1,5,0,0,1,2,51.75
Biology,Psychologist,4.873943518818958,9,0,1,1,1,1,3,4,3,2,4,1,0,1,Science,Bachelors,25-30,5,0,0,Hybrid,Any,1,1,0,1,3,0,1,49.67,Finance,5,2,1,3,5,3,5,5,3,5,0,1,4,2,62.47
Chemistry,Digital Marketing Specialist,2.937262693949153,7,1,2,1,7,0,3,4,4,4,4,1,4,1,Science,Bachelors,25-30,1,0,0,Hybrid,Tier2_City,4,1,4,1,4,3,1,8.11,Education,1,3,1,5,3,3,4,5,4,3,0,0,3,4,59.07
Psychology,Web Developer,3.4334152947411383,1,2,3,1,1,1,1,1,0,4,2,4,4,0,Arts,Bachelors,25-30,2,0,0,Remote,Tier1_City,1,5,5,4,5,4,3,32.66,Tech,2,4,2,2,1,1,5,5,4,5,1,0,5,3,53.72
Law,Marketing Specialist,4.131093916167301,2,1,0,1,3,1,3,0,0,1,3,4,1,1,Arts,Bachelors,25-30,3,0,0,Hybrid,Tier1_City,4,2,1,4,2,4,2,18.81,Manufacturing,1,3,3,4,0,0,2,4,1,3,1,0,4,4,39.59
Chemistry,Biologist,3.931691097151729,1,2,4,0,3,0,4,4,3,2,1,3,3,0,Science,Masters,31-35,2,1,44,Hybrid,Tier1_City,3,2,0,1,3,4,5,41.15,Healthcare,3,1,2,5,1,3,4,3,2,1,0,1,3,1,55.49
Medicine,Composer,2.838416054782376,2,0,1,0,3,0,0,4,3,3,1,0,1,1,Science,Masters,25-30,1,0,0,Hybrid,Tier1_City,4,1,2,3,0,2,1,38.44,Tech,3,4,3,2,2,3,2,4,1,5,1,1,5,3,42.15
Chemistry,Manager,3.798401581854948,8,0,4,1,8,0,2,0,4,3,1,1,0,0,Science,PhD,18-24,2,1,45,Office,Tier1_City,3,3,5,5,1,0,2,44.95,Tech,3,5,4,5,0,5,5,5,2,2,1,1,4,5,48.56
Chemistry,Brand Manager,4.106263631941777,4,0,4,0,4,0,2,2,3,0,4,1,3,1,Science,Masters,18-24,13,0,0,Hybrid,Tier1_City,3,1,1,5,0,4,1,19.15,Tech,3,2,2,1,3,3,1,2,5,3,1,1,4,2,64.06
Art,Organic Chemist,3.092197583681473,2,2,2,0,8,1,2,2,1,2,0,3,0,0,Arts,Bachelors,18-24,5,0,0,Office,Any,5,1,5,4,3,1,4,11.67,Finance,4,4,4,1,0,5,5,4,3,5,1,0,2,2,49.03
Chemistry,Biomedical Engineer,4.125664823368376,5,0,2,1,8,0,3,1,3,4,4,0,1,0,Science,Masters,25-30,8,0,0,Hybrid,Any,4,3,5,5,5,4,4,4.02,Manufacturing,1,3,3,4,3,0,3,2,4,3,0,1,4,5,68.7
Marketing,Marketing Specialist,4.397857494597441,4,1,0,1,2,0,0,0,3,0,1,4,0,1,Commerce,Bachelors,31-35,3,0,0,Remote,Tier2_City,2,1,5,1,2,5,2,15.01,Healthcare,2,4,1,1,1,5,3,4,5,3,0,1,4,5,40.89
Engineering,Financial Controller,4.815548513507949,4,2,0,0,2,1,3,3,4,4,3,2,4,0,Science,Bachelors,31-35,5,0,0,Remote,Tier1_City,5,5,4,1,2,2,3,20.26,Other,4,5,4,2,0,3,5,5,1,5,1,1,1,3,60.29
Engineering,Financial Analyst,2.598803120940278,5,1,2,0,3,0,1,1,3,4,1,0,0,0,Science,Masters,18-24,0,1,23,Remote,Tier3_City,5,5,0,4,0,1,5,47.47,Other,2,4,4,4,4,3,5,4,3,1,0,1,3,2,37.83
Business,Nurse,3.1563529508642003,7,1,2,1,1,0,4,3,0,4,3,3,3,1,Commerce,High School,40+,11,0,0,Flexible,Tier1_City,4,5,1,4,4,0,4,26.09,Manufacturing,5,5,3,5,2,5,2,1,4,5,0,0,2,1,69.95
Marketing,Aerospace Engineer,3.72037157022524,7,0,1,1,1,1,4,1,2,4,1,0,0,1,Commerce,PhD,25-30,5,1,14,Flexible,Tier1_City,5,5,3,4,4,0,3,29.15,Manufacturing,4,5,3,3,3,1,2,1,5,1,1,0,4,2,57.94
Physics,School Counselor,4.401133351990871,5,0,3,1,6,0,2,1,1,2,0,3,2,1,Science,Bachelors,36-40,11,0,0,Remote,Tier1_City,5,5,0,3,5,5,5,44.37,Manufacturing,4,4,2,1,0,2,4,5,1,1,0,1,3,3,42.86
Psychology,Civil Engineer,4.7620916709206895,4,0,3,0,5,0,1,4,0,2,3,0,1,1,Arts,Masters,31-35,2,0,0,Hybrid,Tier2_City,1,2,1,5,2,4,4,44.6,Education,5,2,2,1,0,4,2,3,2,5,1,0,4,4,44.31
Medicine,Market Research Analyst,3.890753904787108,4,0,1,0,9,1,1,0,0,4,0,2,4,1,Science,Masters,31-35,8,0,0,Flexible,Tier1_City,3,2,0,4,0,1,5,27.81,Education,4,2,3,4,5,5,1,2,3,2,1,0,1,3,48.25
Business,Judge,2.645028261023705,4,2,3,0,5,1,1,2,1,4,0,0,2,1,Commerce,Masters,18-24,3,1,11,Office,Tier1_City,2,3,3,2,0,5,1,8.34,Education,1,3,4,2,4,0,1,4,2,2,0,0,1,5,37.34
Chemistry,Architect,3.7708138715481545,7,1,3,1,0,0,4,1,4,3,1,0,3,0,Science,Masters,18-24,6,0,0,Hybrid,Tier1_City,4,4,2,2,0,1,2,15.71,Education,3,4,5,1,5,4,2,5,3,1,0,1,3,3,48.36
Physics,Microbiologist,2.911518915646209,0,1,2,0,3,1,2,4,0,0,4,1,2,1,Science,Masters,18-24,3,0,0,Remote,Any,1,5,2,1,3,4,4,24.47,Manufacturing,2,4,2,5,5,3,5,2,2,3,0,0,5,4,48.77
Art,Risk Analyst,4.466813739694427,3,0,0,1,5,1,2,2,4,4,3,3,2,1,Arts,Bachelors,31-35,10,1,41,Remote,Tier1_City,2,4,3,5,5,4,4,38.3,Manufacturing,5,1,3,2,5,2,5,4,5,2,0,0,4,3,66.77
Computer Science,Legal Analyst,3.327635683765989,1,2,3,0,5,1,4,3,3,1,3,0,1,0,Science,Bachelors,25-30,5,1,14,Office,Tier1_City,2,4,1,4,4,3,1,36.45,Other,3,2,5,1,1,1,1,4,4,5,1,1,5,1,56.85
Chemistry,Counselor,3.642056826326425,3,0,1,0,0,1,3,3,4,2,1,0,2,0,Science,Bachelors,31-35,13,0,0,Office,Tier2_City,1,5,4,2,4,3,4,33.21,Healthcare,4,5,5,1,4,1,5,3,1,2,1,0,3,5,52.97
Physics,Digital Marketing Specialist,4.420586481460862,7,0,4,0,5,1,2,0,0,4,0,2,4,0,Science,Masters,25-30,6,1,8,Hybrid,Tier1_City,4,1,0,5,3,4,4,44.37,Other,1,1,5,5,0,0,3,2,4,3,0,0,2,4,51.62
Law,Analytical Chemist,3.3788277206785224,7,1,2,1,2,0,3,2,3,2,2,4,3,0,Arts,Bachelors,36-40,1,0,0,Remote,Tier2_City,3,3,4,1,1,2,4,40.72,Other,4,4,5,1,2,2,5,4,3,2,1,0,2,3,46.95
Psychology,Data Scientist,3.764081254761936,2,0,3,1,9,1,2,1,1,0,3,2,1,0,Arts,Masters,18-24,9,1,34,Flexible,Tier1_City,1,4,0,3,3,5,4,49.16,Healthcare,5,1,1,2,0,5,1,3,2,5,1,1,4,1,57.84
Psychology,Psychologist,2.794573449391348,5,2,4,1,2,1,0,4,4,1,2,4,1,1,Arts,High School,18-24,5,0,0,Office,Tier2_City,5,1,4,5,5,3,4,44.79,Healthcare,4,2,2,3,0,0,4,1,4,5,0,0,4,2,60.91
Music,Marketing Specialist,4.321827162931902,5,0,4,1,4,0,3,2,3,4,4,2,3,0,Arts,Bachelors,25-30,7,0,0,Remote,Tier2_City,2,1,0,5,0,4,3,12.2,Other,1,4,5,3,0,1,2,3,1,1,1,1,2,3,49.89
Engineering,Surgeon,4.904612300205086,4,1,4,0,4,0,4,0,0,1,3,3,0,0,Science,Masters,25-30,14,0,0,Remote,Tier3_City,5,5,2,3,3,1,4,5.71,Other,4,2,5,1,5,3,2,2,1,4,0,1,1,3,54.65
Medicine,Pharmacist,4.3485532240498825,5,1,2,0,7,1,1,1,3,2,2,2,2,0,Science,Bachelors,25-30,12,0,0,Hybrid,Tier1_City,4,3,0,5,0,5,1,22.48,Other,4,1,3,4,4,0,4,3,4,3,1,0,4,2,58.75
Art,Civil Engineer,3.148146784457194,9,0,4,1,5,1,4,2,3,4,0,4,3,1,Arts,Bachelors,31-35,12,0,0,Remote,Tier2_City,3,5,0,1,5,3,4,32.02,Healthcare,4,3,3,2,4,2,3,1,2,2,1,0,3,2,62.32
Art,Marketing Specialist,3.6117518177022494,5,0,3,1,6,1,4,0,1,1,1,0,0,1,Arts,High School,18-24,14,1,40,Remote,Any,3,3,3,1,5,2,5,33.23,Healthcare,4,5,1,3,3,5,3,1,3,1,1,0,4,1,47.26
Biology,Market Research Analyst,2.680021763397304,1,2,3,0,1,0,0,0,4,3,3,3,4,0,Science,PhD,25-30,11,1,24,Remote,Tier3_City,3,5,3,3,2,5,5,15.57,Education,1,5,5,4,3,0,4,2,5,4,0,0,3,4,73.48
Psychology,Composer,2.9710333160358315,6,1,1,1,0,1,2,0,0,4,4,0,1,0,Arts,Masters,36-40,5,0,0,Flexible,Any,5,3,0,4,0,5,1,43.41,Manufacturing,2,3,1,3,5,5,5,5,2,4,1,0,2,3,47.89
Business,Pharmacist,2.706051931583816,5,2,2,1,4,0,3,2,3,4,3,4,2,1,Commerce,Bachelors,18-24,1,0,0,Office,Any,4,2,0,2,4,0,3,18.47,Healthcare,3,3,3,4,5,1,1,3,5,1,0,1,4,5,55.23
Finance,Legal Secretary,4.805917146717892,9,1,2,0,0,1,3,0,3,1,4,4,3,1,Commerce,Bachelors,36-40,3,0,0,Remote,Tier2_City,5,1,1,4,3,1,1,46.2,Finance,5,3,2,1,3,0,3,2,4,5,0,0,1,3,54.49
Art,Entrepreneur,4.999629449418585,6,2,3,1,1,0,1,1,2,4,2,4,1,1,Arts,Bachelors,40+,0,0,0,Flexible,Tier1_City,2,1,2,5,5,2,3,25.17,Healthcare,2,2,4,4,0,3,3,4,4,5,1,0,3,4,51.56
Business,Human Resources Specialist,3.4139287270562275,6,1,1,1,9,1,4,0,3,4,1,2,2,0,Commerce,Masters,18-24,14,1,7,Office,Tier3_City,3,1,0,2,0,2,2,3.49,Healthcare,1,4,4,1,3,5,4,3,4,3,0,0,1,2,61.78
Psychology,Geneticist,2.950010018763785,2,2,0,1,1,1,0,0,1,1,1,4,4,0,Arts,Masters,25-30,6,0,0,Hybrid,Tier2_City,4,3,0,3,1,2,5,10.62,Manufacturing,5,3,1,4,3,1,4,1,3,3,1,1,3,1,45.59
Finance,School Counselor,2.551745558868097,4,2,4,0,1,1,3,2,2,4,2,4,1,0,Commerce,Bachelors,25-30,7,0,0,Flexible,Tier2_City,5,1,2,3,2,1,5,7.81,Other,5,2,3,4,1,5,3,3,4,5,1,1,5,3,66.64
Law,Legal Secretary,4.715697698268308,0,2,1,1,7,0,0,2,2,4,1,1,2,0,Arts,Bachelors,31-35,9,0,0,Hybrid,Tier2_City,5,2,1,2,1,2,5,5.07,Education,4,1,4,4,5,0,5,2,2,3,0,0,1,2,51.0
Biology,Geneticist,3.603774972153488,1,2,1,0,3,1,4,3,0,2,4,4,1,0,Science,Bachelors,25-30,1,0,0,Office,Tier2_City,5,2,5,1,5,0,3,36.56,Tech,3,1,5,2,5,4,2,5,2,3,1,0,1,4,51.51
Physics,Financial Controller,2.854529245296532,6,2,2,1,7,0,2,0,4,1,4,1,4,1,Science,Masters,31-35,9,0,0,Hybrid,Tier2_City,5,4,3,2,1,3,1,12.04,Other,3,3,2,3,4,5,2,5,3,2,0,0,1,5,60.22
Chemistry,Risk Analyst,3.828850976005637,2,0,2,1,7,1,0,4,3,1,3,1,0,0,Science,Masters,31-35,14,0,0,Hybrid,Tier2_City,5,1,3,5,1,1,3,42.42,Other,1,1,3,4,3,4,2,4,1,3,1,1,1,5,58.16
Computer Science,Data Scientist,2.831345231378122,3,0,2,0,5,0,0,4,3,4,4,2,4,1,Science,Bachelors,18-24,4,0,0,Remote,Tier1_City,2,5,2,1,2,2,5,15.43,Manufacturing,2,3,1,1,4,1,2,2,5,5,1,1,1,5,60.03
Finance,Aerospace Engineer,4.129048133022382,5,2,0,1,2,0,2,0,2,1,3,4,1,1,Commerce,High School,36-40,10,0,0,Hybrid,Any,3,5,0,3,2,4,5,4.52,Education,4,1,3,4,2,3,3,3,2,1,0,1,2,2,47.83
Engineering,Composer,4.442276975319755,2,0,2,0,6,0,0,2,2,2,3,0,2,1,Science,Bachelors,31-35,7,0,0,Hybrid,Any,5,5,5,2,2,3,5,41.57,Finance,3,1,2,2,5,2,3,1,2,4,1,1,4,3,44.7
Medicine,Biotechnologist,2.7286670701230302,5,2,4,0,1,1,4,4,3,0,2,0,4,1,Science,PhD,25-30,10,0,0,Flexible,Tier2_City,2,2,3,4,2,5,5,24.91,Tech,4,4,3,2,1,3,2,3,4,5,1,0,1,2,72.31
Medicine,Investment Banker,3.944937523634622,9,2,0,0,7,1,1,0,4,3,0,4,2,0,Science,Bachelors,36-40,7,0,0,Hybrid,Tier1_City,4,4,0,4,1,1,2,31.18,Education,2,4,1,2,2,0,2,3,1,3,0,0,5,4,47.15
Law,Software Developer,4.517755120192739,1,2,1,0,2,0,2,1,3,0,2,3,1,0,Arts,Masters,31-35,14,1,6,Remote,Tier1_City,4,4,4,5,4,4,5,18.8,Other,5,1,5,4,5,1,5,1,4,5,1,0,3,4,67.83
Chemistry,Aerospace Engineer,2.599770366698224,0,2,2,1,1,1,4,2,2,1,4,3,4,0,Science,Masters,18-24,4,0,0,Remote,Tier1_City,2,2,0,4,4,5,3,5.16,Education,2,4,3,4,4,4,5,4,3,5,1,1,2,3,67.5
Computer Science,Psychologist,2.653479256572488,1,1,3,0,1,0,3,4,1,0,3,2,1,0,Science,Bachelors,25-30,7,1,35,Flexible,Tier1_City,2,4,3,2,2,4,5,20.4,Manufacturing,5,3,1,4,4,2,5,5,5,4,0,0,4,5,60.34
Business,Interior Designer,4.2356868084064345,8,2,4,0,5,0,1,2,3,3,0,3,3,1,Commerce,Bachelors,25-30,13,0,0,Hybrid,Tier1_City,2,5,0,2,3,2,4,27.36,Education,2,5,5,3,2,1,1,5,5,3,0,1,2,4,60.31
Marketing,Advertising Manager,2.8958917584960457,5,0,0,1,4,1,4,4,0,3,0,2,2,0,Commerce,Bachelors,18-24,5,0,0,Hybrid,Tier1_City,4,5,5,4,0,1,2,3.55,Healthcare,4,3,4,4,3,1,5,3,4,1,1,0,2,5,45.82
Business,Ecologist,2.6839792820909376,2,0,0,0,9,1,4,1,4,2,4,2,4,0,Commerce,Masters,40+,14,0,0,Office,Tier1_City,5,2,0,2,5,2,5,29.99,Education,2,4,3,5,1,1,5,2,5,1,0,1,5,1,72.06
Marketing,Doctor,3.979787096667773,1,2,4,0,1,0,2,0,3,0,3,3,4,1,Commerce,Masters,18-24,14,0,0,Flexible,Tier2_City,3,5,5,5,3,5,4,44.97,Tech,3,2,5,2,4,0,3,5,5,2,1,1,4,5,65.29
Chemistry,Biochemist,3.4902128155401893,3,0,2,1,6,0,1,0,2,3,1,1,4,0,Science,Masters,31-35,4,1,22,Office,Any,5,3,1,1,5,0,3,13.24,Education,3,1,4,4,0,4,2,4,1,4,1,0,5,2,47.82
Music,Actuary,3.908091197701526,2,0,2,1,2,0,1,4,3,1,4,3,2,1,Arts,Bachelors,25-30,12,0,0,Remote,Tier1_City,1,5,1,5,3,4,2,46.56,Finance,1,4,3,3,1,5,5,4,2,5,1,1,5,2,68.47
Biology,Brand Manager,4.982804833179735,5,1,1,1,6,1,0,4,1,1,1,3,4,1,Science,High School,18-24,13,0,0,Hybrid,Tier2_City,2,1,5,5,3,0,5,7.59,Healthcare,3,4,3,1,2,4,5,1,3,4,0,0,4,1,50.53
Computer Science,Artist,4.917026366420945,3,2,0,1,9,0,1,4,1,0,0,0,2,1,Science,PhD,36-40,10,1,32,Office,Any,5,2,0,2,4,5,3,41.8,Tech,3,4,2,2,4,4,5,2,1,4,0,0,2,3,56.54
Psychology,Paralegal,2.84671545805296,5,1,3,1,0,0,0,2,4,0,4,4,1,0,Arts,Masters,36-40,3,0,0,Flexible,Any,3,2,2,1,0,2,4,42.5,Tech,5,3,3,4,4,2,3,5,1,1,0,0,2,1,45.2
Medicine,Urban Planner,3.2290942064753327,0,1,1,1,0,0,4,1,2,2,0,1,3,0,Science,Bachelors,25-30,4,0,0,Flexible,Tier1_City,5,4,2,2,3,3,2,15.11,Other,4,1,3,4,5,5,1,2,4,4,0,1,2,2,52.39
Physics,Biotechnologist,3.180716461367737,8,1,2,1,1,0,1,1,2,3,3,0,2,0,Science,PhD,18-24,11,0,0,Hybrid,Tier1_City,1,4,2,3,2,4,5,48.02,Manufacturing,4,5,5,1,2,5,4,5,4,4,1,1,5,2,66.7
Computer Science,Chemist,2.8182649639240984,2,2,3,1,6,0,2,2,3,4,0,2,1,0,Science,Masters,18-24,3,0,0,Office,Tier1_City,1,4,2,2,5,3,3,22.58,Manufacturing,5,4,1,3,0,5,2,1,4,5,0,1,4,2,61.66
Marketing,Quantum Physicist,2.856584210315704,7,2,2,1,3,0,0,1,3,0,4,1,1,0,Commerce,Masters,25-30,0,0,0,Remote,Tier1_City,5,1,3,2,4,1,2,9.64,Healthcare,3,2,2,5,5,0,3,2,3,2,1,0,2,3,42.49
Business,Digital Marketing Specialist,3.299466477477449,8,2,3,1,8,0,0,3,2,0,0,0,1,1,Commerce,Masters,25-30,2,0,0,Remote,Tier2_City,3,5,2,2,5,4,4,30.81,Tech,2,1,3,1,0,3,3,2,4,5,1,1,3,3,46.28
Finance,Graphic Designer,3.4938312949009025,1,0,0,0,4,1,1,1,0,3,1,4,3,1,Commerce,Masters,25-30,7,1,43,Hybrid,Tier1_City,5,2,3,1,2,0,5,49.84,Other,5,5,5,3,4,4,3,5,2,4,0,1,5,5,51.12
Education,Data Scientist,4.131627991399905,0,0,2,1,9,0,1,3,3,3,4,2,1,1,Arts,Masters,40+,6,1,16,Flexible,Tier3_City,2,5,2,2,2,3,2,45.27,Finance,4,2,5,3,3,3,5,3,3,2,1,1,1,4,58.02
Music,Forensic Psychologist,4.411590841477517,8,2,4,1,8,0,0,3,1,1,3,3,1,0,Arts,Bachelors,25-30,11,0,0,Remote,Tier1_City,3,4,5,1,3,5,4,16.09,Education,1,5,1,4,0,1,3,5,5,4,0,0,2,4,65.13
Physics,Music Teacher,2.9381673735670404,4,2,4,1,8,0,1,2,0,2,0,3,3,0,Science,Bachelors,36-40,14,0,0,Hybrid,Tier3_City,4,2,0,4,2,1,4,30.12,Education,4,5,4,4,0,5,4,2,3,3,0,1,5,2,53.04
Computer Science,Astronomer,2.981926589393482,8,0,2,0,6,0,4,2,3,1,0,0,3,1,Science,PhD,31-35,6,0,0,Flexible,Tier1_City,3,4,5,3,0,4,3,8.42,Education,2,1,3,2,3,1,3,1,5,3,1,1,4,4,56.54
Business,Artist,2.637974867073095,8,1,0,0,8,0,3,2,4,0,0,4,2,0,Commerce,Bachelors,25-30,10,0,0,Hybrid,Tier2_City,5,1,2,1,2,5,4,24.71,Manufacturing,4,3,4,4,5,1,1,1,1,3,1,1,4,4,58.11
Engineering,Astronomer,3.368486057891089,0,1,4,0,7,0,1,3,4,1,2,3,3,0,Science,Bachelors,36-40,2,0,0,Remote,Tier2_City,5,2,0,4,3,1,4,27.58,Tech,5,2,1,4,0,4,2,3,5,2,0,1,1,1,51.76
Art,Digital Marketing Specialist,4.980223053382797,7,2,4,0,0,0,1,0,2,2,2,0,0,0,Arts,Bachelors,25-30,8,1,58,Office,Tier2_City,4,4,5,1,5,0,1,17.82,Tech,1,4,5,3,3,5,5,3,3,5,1,0,2,3,53.05
Biology,Market Research Analyst,4.386123618894105,9,1,3,0,6,0,0,3,3,0,0,2,3,0,Science,Bachelors,36-40,14,1,51,Office,Tier1_City,1,4,0,1,2,5,4,25.76,Finance,4,5,4,4,2,1,2,2,2,2,1,1,1,4,45.01
Law,Teacher,4.520606538690467,1,0,1,0,5,0,1,2,3,4,4,4,0,0,Arts,Masters,25-30,5,0,0,Hybrid,Tier1_City,5,4,5,3,4,4,5,46.24,Manufacturing,5,2,1,4,5,0,2,3,2,4,1,1,4,1,63.44
Architecture,Zoologist,4.115685278657767,5,2,4,1,0,0,3,3,1,0,3,0,4,0,Interdisciplinary,PhD,18-24,7,0,0,Flexible,Tier1_City,1,1,1,5,4,1,2,26.51,Finance,5,1,4,4,1,5,3,1,5,5,1,1,2,5,70.52
Medicine,Geneticist,3.7731246960058913,9,0,2,1,9,1,2,2,0,1,4,3,1,1,Science,Bachelors,36-40,7,0,0,Remote,Tier2_City,1,5,5,5,4,2,5,42.06,Tech,5,2,5,5,1,1,3,2,3,1,1,0,3,5,52.38
Business,Artist,3.249030685970696,6,0,0,1,9,0,0,4,3,3,0,0,4,1,Commerce,Bachelors,25-30,2,0,0,Flexible,Tier1_City,2,5,5,1,5,4,5,17.92,Education,1,4,3,5,2,4,5,3,5,5,1,1,3,5,52.54
Art,Social Media Manager,3.583884333911045,7,2,0,0,3,0,3,0,2,2,4,1,3,0,Arts,Bachelors,36-40,3,0,0,Office,Tier2_City,1,5,4,2,1,4,3,48.66,Manufacturing,5,4,2,2,0,0,5,1,5,5,1,1,3,5,53.61
Art,Advertising Manager,3.1369172634415663,8,1,1,0,9,1,0,0,1,4,3,2,1,0,Arts,Masters,36-40,13,0,0,Hybrid,Tier1_City,3,1,5,4,4,4,1,7.39,Manufacturing,1,1,5,1,1,4,2,3,1,2,1,1,1,4,53.87
Business,Market Research Analyst,2.506227142742325,0,1,0,0,6,1,2,4,2,1,0,0,4,1,Commerce,Masters,18-24,5,0,0,Office,Tier1_City,1,5,4,2,4,4,1,30.52,Manufacturing,2,2,4,3,2,1,5,1,3,3,1,1,2,3,49.42
Finance,Advertising Manager,2.9118051185678064,6,1,2,0,7,1,1,3,3,2,0,3,0,0,Commerce,Bachelors,25-30,1,0,0,Remote,Tier2_City,2,5,5,2,1,2,5,40.12,Other,2,3,3,2,1,0,3,2,5,2,0,1,3,2,43.79
Architecture,Principal,3.1992745706536145,1,0,0,1,8,1,4,4,1,4,4,4,0,1,Interdisciplinary,Masters,25-30,11,0,0,Remote,Tier2_City,5,1,0,1,5,5,2,41.26,Other,2,3,2,3,0,1,4,1,4,1,0,0,1,2,72.05
Education,Sound Engineer,4.6240522329088565,7,2,4,0,9,0,1,2,1,2,1,3,2,1,Arts,Masters,31-35,11,1,55,Flexible,Tier1_City,5,2,5,1,4,5,1,12.32,Education,5,5,1,1,5,0,3,4,4,3,1,1,2,2,61.24
Medicine,Civil Engineer,3.670248918147821,0,0,1,1,7,1,3,4,2,0,1,0,0,1,Science,Masters,31-35,10,0,0,Remote,Tier2_City,4,4,4,1,3,5,1,21.88,Other,1,5,3,1,3,3,2,5,4,5,1,1,4,1,63.3
Computer Science,Aerospace Engineer,4.837364600212494,9,2,3,0,3,0,3,1,1,0,2,3,3,0,Science,PhD,25-30,11,0,0,Remote,Tier3_City,1,4,4,1,5,0,5,32.34,Manufacturing,2,2,5,2,2,0,3,1,5,2,0,1,3,1,64.71
Music,Clinical Psychologist,3.535382546968054,2,2,1,0,8,0,2,3,1,4,1,1,4,0,Arts,Bachelors,25-30,6,0,0,Hybrid,Tier1_City,3,1,2,5,4,2,1,17.85,Other,3,5,4,5,5,3,1,4,3,1,0,0,3,5,52.28
Education,Artist,2.794176826104886,6,1,4,0,1,0,3,3,0,4,3,0,3,1,Arts,Masters,31-35,1,0,0,Remote,Tier1_City,4,5,4,1,4,2,3,33.94,Other,2,4,2,5,1,1,4,3,1,2,0,1,1,1,44.35
Chemistry,Curriculum Developer,4.03365963827343,3,1,3,0,2,1,1,4,1,4,1,0,4,1,Science,Bachelors,18-24,10,1,8,Flexible,Tier2_City,4,3,4,5,1,1,5,20.8,Healthcare,5,1,3,5,0,0,4,5,4,5,1,0,1,4,60.62
Computer Science,Surgeon,3.6734153732862542,5,0,1,0,9,1,1,0,2,0,3,0,3,0,Science,Masters,36-40,4,0,0,Flexible,Any,2,5,4,5,3,3,1,19.49,Manufacturing,3,5,2,4,5,4,3,1,5,4,0,0,3,3,50.26
Law,Music Therapist,2.77038461182087,7,0,3,1,5,1,2,0,1,2,1,1,2,1,Arts,Masters,31-35,11,1,12,Hybrid,Tier1_City,5,3,5,1,5,5,1,8.08,Other,4,3,2,4,1,5,5,1,5,2,0,1,4,3,61.9
Business,Brand Manager,4.997616473497516,9,0,4,0,5,1,2,0,4,1,4,4,0,0,Commerce,Masters,36-40,3,0,0,Hybrid,Tier2_City,1,4,1,3,2,3,1,4.84,Education,3,4,3,2,0,0,2,2,3,2,0,0,1,1,52.29
Engineering,Organic Chemist,2.509920015462761,8,0,3,1,4,1,3,1,3,1,3,4,1,0,Science,Masters,25-30,8,0,0,Hybrid,Any,1,1,4,4,0,1,5,42.26,Other,4,3,4,4,0,0,5,1,5,4,1,1,1,5,66.51
Education,Clinical Psychologist,2.7106769313715064,0,2,2,1,0,0,3,1,4,3,1,3,4,1,Arts,Bachelors,18-24,12,0,0,Remote,Tier2_City,5,5,2,2,3,2,2,26.01,Other,3,5,1,3,0,5,3,5,3,2,0,0,3,3,62.72
Education,Fluid Mechanics Engineer,4.387230242586024,7,0,0,0,7,1,2,2,0,1,4,2,0,1,Arts,Bachelors,25-30,12,0,0,Remote,Tier1_City,2,1,3,5,2,1,4,29.46,Manufacturing,1,5,3,2,0,0,2,3,1,1,1,1,1,2,49.17
Business,Risk Analyst,4.749691221023401,6,2,4,1,8,1,0,1,0,4,2,1,3,1,Commerce,PhD,18-24,14,0,0,Remote,Tier2_City,2,5,1,4,3,4,1,20.49,Other,3,4,1,2,2,2,4,2,1,3,1,0,3,4,51.42
Chemistry,Composer,4.364772826784512,4,1,3,0,0,1,2,2,0,3,1,4,4,1,Science,PhD,40+,1,1,46,Hybrid,Tier1_City,2,5,2,3,2,1,4,9.43,Healthcare,2,3,2,1,5,4,2,5,5,1,1,0,3,1,48.36
Physics,Microbiologist,4.240683757334905,9,0,4,1,6,1,2,3,2,2,4,2,4,1,Science,High School,18-24,6,0,0,Hybrid,Tier1_City,3,5,0,2,2,1,4,24.13,Healthcare,4,1,2,1,3,0,1,1,2,4,1,0,2,1,50.16
Art,Physical Chemist,2.85561107566539,8,2,2,0,7,1,1,0,2,3,3,4,4,1,Arts,Bachelors,31-35,12,0,0,Flexible,Tier1_City,1,3,2,2,3,4,1,13.76,Other,4,1,4,2,2,0,3,5,1,1,1,0,1,1,52.25
Engineering,Marketing Specialist,4.167480745170616,0,2,1,1,6,0,3,0,2,2,2,3,1,1,Science,Bachelors,25-30,6,0,0,Office,Tier1_City,2,1,3,5,1,3,1,42.37,Manufacturing,2,4,3,5,1,1,3,5,3,1,1,1,3,4,48.45
Art,Judge,4.250657292407697,2,1,2,0,8,1,2,2,1,1,2,1,2,0,Arts,Masters,25-30,6,0,0,Office,Tier1_City,2,4,1,1,3,4,4,49.38,Tech,1,5,3,1,2,5,5,3,5,5,0,0,1,4,55.14
Art,Geneticist,3.0419351089125217,4,2,1,0,8,1,0,4,3,1,4,2,4,1,Arts,Masters,18-24,0,0,0,Hybrid,Tier3_City,5,2,3,3,3,0,2,44.79,Tech,3,4,5,4,2,5,1,1,2,4,1,0,5,1,53.5
Music,Digital Marketing Specialist,3.3461787787109283,3,1,4,0,2,1,3,3,0,0,2,2,4,1,Arts,Bachelors,31-35,7,0,0,Flexible,Any,4,3,5,5,2,1,4,27.83,Finance,1,3,4,2,1,4,5,4,1,3,0,0,5,4,44.87
Finance,Nuclear Physicist,4.511285523067123,4,1,3,1,5,1,2,4,0,0,4,2,3,0,Commerce,Bachelors,25-30,1,0,0,Flexible,Tier1_City,4,4,0,3,0,1,2,32.52,Healthcare,2,1,3,3,3,0,1,2,3,3,1,1,5,2,42.32
Art,Architect,4.226862351168775,9,1,4,1,0,0,2,4,1,0,1,0,1,0,Arts,Masters,25-30,14,0,0,Flexible,Tier1_City,4,1,0,1,2,3,3,47.56,Tech,3,5,2,2,2,0,4,3,5,2,0,1,2,3,53.23
Business,Accountant,3.1621894076123427,4,2,1,0,2,1,3,3,4,0,0,1,4,1,Commerce,Masters,36-40,14,1,48,Remote,Tier3_City,1,2,5,1,4,2,2,28.32,Finance,2,3,4,3,0,0,2,2,3,4,0,1,2,5,65.72
Education,Zoologist,3.152715765798666,6,2,3,0,1,0,2,2,3,1,2,1,3,0,Arts,Bachelors,25-30,4,1,42,Hybrid,Tier2_City,3,2,0,5,3,4,5,33.01,Tech,4,1,5,1,2,3,4,1,5,4,1,0,5,4,54.59
Finance,Game Developer,4.882681920423856,6,0,2,1,6,1,4,1,1,0,0,3,4,0,Commerce,Masters,25-30,1,0,0,Hybrid,Tier3_City,1,1,5,1,5,2,1,32.57,Manufacturing,4,1,5,5,1,2,2,2,2,3,0,0,4,2,44.82
Law,Judge,4.734042937659631,6,1,1,0,0,0,0,4,3,2,4,3,2,0,Arts,Bachelors,25-30,12,1,8,Remote,Tier2_City,5,3,5,4,3,0,3,36.28,Other,4,2,2,3,3,4,5,5,3,2,0,0,1,2,60.14
Marketing,Nuclear Physicist,3.280555668259069,9,1,0,1,8,1,4,0,0,2,0,0,4,1,Commerce,Bachelors,18-24,4,1,57,Flexible,Any,2,5,5,2,1,4,4,33.09,Healthcare,5,5,3,5,2,3,1,5,3,1,0,1,2,1,34.89
Engineering,Analytical Chemist,2.9814719160917,1,0,1,1,0,1,1,3,0,2,2,4,4,1,Science,Masters,36-40,6,0,0,Remote,Tier1_City,1,5,2,5,5,0,2,34.52,Tech,5,4,2,3,2,0,2,5,1,3,1,0,3,5,52.77
Music,Organic Chemist,4.751464630745659,1,0,3,0,6,0,3,2,1,1,4,0,3,0,Arts,Masters,25-30,5,0,0,Remote,Tier1_City,4,5,2,3,2,0,3,37.12,Manufacturing,4,2,5,5,1,5,4,4,3,4,1,0,1,3,53.96
Marketing,Urban Planner,4.346198930710019,7,1,2,1,1,0,0,3,4,4,4,0,3,1,Commerce,Masters,18-24,12,0,0,Hybrid,Tier1_City,3,4,4,4,1,0,5,41.03,Finance,5,1,4,3,4,4,3,5,1,3,0,1,3,4,58.1
Psychology,Marketing Manager,3.556266755928988,3,0,2,1,6,1,1,1,0,4,1,2,1,1,Arts,Masters,25-30,14,0,0,Hybrid,Tier2_City,5,1,0,5,3,5,2,21.94,Manufacturing,5,5,3,2,4,3,3,5,3,5,1,1,4,4,60.0
Music,Pharmacist,4.080234603771957,2,0,0,0,2,0,1,3,1,3,0,3,0,1,Arts,Masters,31-35,11,1,38,Flexible,Any,2,3,3,1,2,4,4,38.05,Finance,2,5,2,2,5,2,3,1,3,5,0,1,2,1,60.74
Finance,Organic Chemist,3.1342690406537503,5,2,4,1,9,1,4,3,4,1,1,3,2,1,Commerce,Bachelors,25-30,4,1,22,Hybrid,Any,3,1,0,1,2,4,4,7.71,Tech,3,2,3,1,2,3,5,5,1,3,1,0,3,2,49.72
Business,Pharmacist,4.342714169651584,4,1,3,0,3,0,3,2,0,4,1,3,4,1,Commerce,Bachelors,31-35,3,1,11,Hybrid,Any,1,2,1,1,4,5,2,44.18,Other,4,3,4,2,5,1,4,4,1,5,1,0,5,5,49.37
Music,Investment Banker,4.80010467199932,4,0,0,1,5,1,3,4,4,3,4,1,1,1,Arts,High School,18-24,7,0,0,Hybrid,Tier1_City,1,4,2,1,4,3,5,16.63,Education,5,3,5,4,0,0,2,4,1,5,0,1,2,3,62.19
Medicine,Art Director,3.5650448363214973,1,0,3,1,8,1,1,1,4,2,2,2,1,0,Science,Bachelors,25-30,10,0,0,Remote,Tier3_City,3,3,0,3,0,5,1,21.96,Other,2,4,2,1,2,3,4,3,2,3,0,1,3,2,52.47
Biology,Psychologist,3.820906209297071,4,0,0,0,8,0,1,2,1,2,0,0,0,0,Science,Masters,36-40,13,0,0,Office,Tier1_City,3,2,4,4,4,1,1,40.77,Manufacturing,2,5,5,2,5,5,4,4,5,1,1,0,2,3,54.74
Art,Illustrator,2.742564865158517,6,1,4,0,4,0,3,3,0,0,0,2,1,0,Arts,PhD,18-24,7,0,0,Office,Any,2,5,0,2,5,2,4,32.94,Education,3,2,2,2,4,2,5,5,4,5,1,0,3,3,62.33
Medicine,Analytical Chemist,3.381795832869264,3,1,4,1,4,1,4,2,4,0,1,4,1,0,Science,Bachelors,36-40,0,0,0,Hybrid,Tier1_City,4,5,4,3,2,2,5,17.51,Healthcare,2,1,3,4,2,5,2,2,5,4,1,0,5,5,56.81
Architecture,Nurse,2.873641681292688,6,2,0,1,0,1,2,4,1,2,2,4,2,1,Interdisciplinary,Bachelors,18-24,9,0,0,Flexible,Tier1_City,3,5,2,3,4,0,4,13.59,Education,1,3,1,5,0,5,2,3,5,4,0,1,5,2,71.8
Biology,Legal Analyst,3.188348939749292,7,0,4,0,0,0,4,0,4,1,3,1,0,0,Science,Masters,36-40,1,0,0,Hybrid,Tier3_City,2,1,2,2,0,4,1,48.01,Other,1,2,2,2,3,0,4,4,5,4,1,1,3,5,53.66
Engineering,Musician,3.032887919032264,5,0,2,0,9,1,4,1,1,1,0,0,3,1,Science,Bachelors,25-30,2,0,0,Office,Tier3_City,3,2,4,2,3,4,4,7.13,Healthcare,4,4,2,3,2,1,4,3,2,3,0,0,3,1,35.9
Psychology,Financial Controller,3.232024319673911,4,0,3,1,8,1,1,3,2,3,0,3,0,0,Arts,Masters,31-35,12,1,18,Flexible,Tier3_City,3,3,5,1,5,0,2,3.2,Tech,3,4,5,5,1,5,3,1,5,1,0,1,2,1,66.23
Law,Brand Manager,3.327196891816479,5,0,1,1,7,0,0,0,0,2,3,1,1,0,Arts,Masters,18-24,0,0,0,Office,Tier1_City,4,2,1,3,4,1,2,34.63,Tech,1,5,1,3,0,1,4,5,2,4,0,0,3,1,37.04
Architecture,Risk Analyst,2.60849032398806,5,1,1,1,0,1,2,1,3,0,3,4,0,0,Interdisciplinary,Masters,18-24,10,1,45,Hybrid,Any,2,3,5,5,2,2,5,31.88,Manufacturing,3,4,1,5,2,3,1,5,4,2,0,0,5,3,66.48
Law,Interior Designer,2.851483404793901,3,0,4,1,4,0,3,1,0,2,0,4,2,0,Arts,Bachelors,18-24,2,1,27,Remote,Tier2_City,1,4,5,2,3,5,1,37.67,Education,4,4,1,3,4,0,3,3,4,5,1,1,3,2,47.91
Chemistry,Zoologist,2.924034286527061,7,0,2,1,3,0,3,2,2,0,1,2,2,0,Science,Bachelors,18-24,9,1,6,Office,Tier2_City,2,4,2,2,2,3,5,37.39,Healthcare,2,3,1,2,5,3,1,4,1,3,1,1,2,4,49.67
Engineering,Teacher,3.6000148996974484,6,1,1,0,6,0,2,0,1,4,4,3,3,1,Science,Masters,25-30,11,1,18,Flexible,Tier2_City,2,3,4,4,3,1,5,43.57,Healthcare,2,3,4,3,2,1,4,2,5,5,0,1,2,4,71.45
Biology,Aerospace Engineer,2.6449274159025378,2,1,0,0,8,1,4,0,0,0,2,2,0,0,Science,Masters,25-30,7,0,0,Hybrid,Tier3_City,2,2,2,5,5,4,1,46.34,Education,2,4,3,2,5,4,4,4,5,1,1,0,3,1,52.98
Architecture,Financial Analyst,4.813679723094269,4,2,2,1,8,1,0,2,2,4,2,3,0,1,Interdisciplinary,High School,25-30,3,0,0,Hybrid,Tier2_City,4,3,0,5,2,0,3,39.43,Other,1,5,2,4,4,3,5,3,1,1,0,1,4,1,38.18
Biology,Surgeon,2.572360042845001,4,1,4,0,3,1,2,2,3,1,2,3,1,1,Science,Masters,31-35,12,1,10,Hybrid,Tier1_City,4,3,3,2,4,2,3,13.92,Tech,3,3,3,3,1,4,4,4,2,4,0,0,1,4,63.45
Chemistry,Nurse,4.279025678483511,0,1,1,1,7,1,1,2,0,1,3,0,3,0,Science,High School,31-35,12,1,25,Office,Tier2_City,5,5,1,1,4,0,4,24.78,Other,1,3,3,1,3,0,5,3,5,2,0,0,5,1,47.61
Finance,Dentist,2.634731042881784,6,1,2,1,2,1,0,2,2,1,4,0,1,0,Commerce,Masters,31-35,6,0,0,Remote,Tier3_City,1,3,3,4,0,4,3,33.16,Tech,5,4,3,1,4,1,5,5,5,2,1,1,2,1,49.45
Architecture,Curriculum Developer,4.349439853228859,5,1,0,0,5,0,3,4,4,2,3,2,3,0,Interdisciplinary,Bachelors,25-30,6,1,42,Flexible,Tier1_City,4,5,1,5,3,0,2,28.35,Healthcare,3,5,3,3,2,3,2,5,4,4,1,1,2,1,66.02
Finance,Geneticist,4.486786873832187,0,0,0,1,8,0,3,1,4,2,0,0,3,1,Commerce,PhD,25-30,10,0,0,Flexible,Tier1_City,4,5,0,2,0,5,5,10.47,Manufacturing,4,4,4,2,1,3,5,5,2,3,0,0,4,1,55.55
Law,School Counselor,3.417802148003992,3,2,4,0,8,0,3,2,4,0,1,2,2,0,Arts,Bachelors,25-30,4,0,0,Hybrid,Tier2_City,2,3,4,5,1,2,4,30.7,Tech,1,1,5,5,0,3,2,3,2,5,1,1,4,3,52.5
Business,Social Media Manager,3.483753906985961,2,2,2,1,6,1,4,0,4,1,4,2,1,1,Commerce,Bachelors,36-40,11,0,0,Remote,Tier1_City,2,1,5,4,4,0,5,44.67,Finance,2,1,4,4,2,0,2,5,4,4,1,0,2,1,70.14
Education,Lawyer,4.888272590910981,3,1,2,1,0,1,1,1,0,3,2,4,1,1,Arts,Bachelors,18-24,0,0,0,Office,Tier1_City,3,2,4,4,3,2,1,22.67,Healthcare,2,5,2,3,5,5,3,1,2,3,1,1,3,4,40.24
Architecture,Actuary,3.983963627579707,9,0,2,0,6,1,0,3,1,1,1,1,1,0,Interdisciplinary,Bachelors,18-24,9,0,0,Remote,Any,3,3,4,3,5,0,3,34.44,Education,2,1,1,4,5,5,2,2,1,1,1,0,3,2,44.5
Chemistry,Social Media Manager,2.810553575134094,4,2,1,0,3,1,1,2,0,0,1,1,4,1,Science,Masters,31-35,3,0,0,Hybrid,Tier1_City,3,4,0,2,0,0,1,31.95,Education,1,5,5,2,5,0,3,3,5,1,0,1,5,5,36.83
Finance,Pharmacist,3.027279872485604,7,2,1,0,7,1,0,0,0,0,3,2,3,1,Commerce,PhD,18-24,6,0,0,Remote,Tier1_City,4,3,5,4,5,2,4,20.72,Other,1,1,2,1,0,5,3,5,3,1,1,0,1,4,47.66
Finance,Composer,2.8525635820125155,5,0,1,0,1,0,1,4,1,1,3,2,0,1,Commerce,Bachelors,36-40,13,1,39,Hybrid,Tier2_City,3,3,3,3,5,5,2,29.57,Other,2,2,1,2,5,5,3,1,1,3,1,1,4,2,55.18
Chemistry,Analytical Chemist,4.705130249342204,3,1,0,1,2,1,3,4,0,2,3,2,4,0,Science,Bachelors,36-40,4,0,0,Hybrid,Tier2_City,1,4,2,3,5,0,3,12.88,Healthcare,2,3,4,2,5,2,4,4,4,3,0,1,2,4,54.31
Law,Software Developer,3.102673382637702,6,2,2,1,3,0,3,1,0,4,1,4,4,0,Arts,Masters,18-24,1,0,0,Office,Tier1_City,3,5,5,5,0,5,1,28.67,Other,2,4,3,3,4,5,5,2,4,5,0,0,5,1,49.84
Medicine,Risk Analyst,2.525414087007442,0,2,4,0,3,0,1,0,2,3,3,1,0,1,Science,Masters,18-24,13,0,0,Office,Any,5,5,5,5,1,1,3,40.54,Other,5,5,2,4,5,3,5,2,4,1,0,1,5,4,54.49
Finance,Civil Engineer,2.9056238459911063,4,1,0,0,9,1,2,4,2,0,4,3,1,1,Commerce,Masters,25-30,7,0,0,Flexible,Tier2_City,5,1,4,3,0,3,5,38.67,Healthcare,1,1,3,5,1,0,1,5,3,4,1,0,1,1,60.72
Music,Architectural Technologist,4.189384451695313,5,2,4,0,8,0,4,2,2,1,2,4,0,0,Arts,Bachelors,31-35,1,0,0,Remote,Tier1_City,2,3,2,5,2,1,2,19.82,Tech,2,2,3,4,3,1,1,3,1,3,0,1,4,5,47.02
Music,Fluid Mechanics Engineer,2.7090049439401267,8,2,1,0,5,0,0,4,2,3,0,4,2,1,Arts,Bachelors,25-30,10,0,0,Remote,Tier1_City,4,3,3,4,4,3,3,8.27,Healthcare,4,1,3,5,2,0,4,3,3,2,1,0,3,4,55.8
Business,Urban Planner,3.508877127638612,0,2,2,1,5,1,3,1,0,0,2,4,0,1,Commerce,Masters,31-35,7,1,29,Hybrid,Tier2_City,5,2,2,1,0,1,2,40.6,Healthcare,2,2,5,1,1,0,2,1,5,5,1,1,3,4,60.14
Business,Judge,2.631774546291908,4,2,3,1,3,0,1,3,0,1,4,3,2,1,Commerce,High School,25-30,12,0,0,Remote,Tier1_City,1,5,2,4,0,3,5,15.46,Other,1,4,1,4,1,3,1,3,4,1,0,1,4,5,50.38
Art,Industrial-Organizational Psychologist,2.610538664236397,7,1,3,0,1,0,2,3,2,0,0,2,2,1,Arts,Masters,25-30,10,0,0,Remote,Any,2,3,5,3,1,0,5,5.49,Finance,4,3,3,5,3,4,1,5,3,4,0,0,5,3,56.84
Marketing,Landscape Architect,3.093218491305209,7,1,3,0,2,0,2,1,3,2,2,4,1,1,Commerce,Bachelors,18-24,1,1,13,Hybrid,Tier1_City,5,2,2,3,2,2,1,23.92,Education,1,3,2,4,5,1,3,2,5,5,1,1,5,2,57.29
Law,Teacher,4.1177312234481285,9,0,1,0,9,0,0,1,2,0,3,0,4,0,Arts,Masters,31-35,10,1,55,Hybrid,Tier2_City,3,1,0,4,0,2,4,37.76,Other,1,2,5,2,4,4,1,2,5,1,0,0,5,5,52.09
Finance,Electrical Engineer,4.283958320939876,7,1,2,0,2,1,0,0,2,4,4,4,4,1,Commerce,Bachelors,18-24,4,0,0,Remote,Tier3_City,5,2,3,5,4,4,1,41.0,Tech,1,1,1,1,5,2,5,2,5,4,0,1,2,4,55.71
Marketing,Psychologist,4.266623132859751,4,2,2,1,2,1,0,3,4,3,1,2,0,0,Commerce,Masters,36-40,3,0,0,Hybrid,Tier3_City,5,5,2,5,4,3,2,49.16,Manufacturing,3,3,2,4,5,3,3,5,4,3,1,1,3,1,55.26
Engineering,Risk Analyst,2.978314432113432,6,1,1,1,2,1,2,4,2,1,2,0,3,0,Science,Bachelors,25-30,0,0,0,Hybrid,Tier1_City,2,5,4,3,0,4,1,11.9,Tech,4,1,5,2,3,5,4,4,2,2,1,0,2,2,35.83
Business,Aerospace Engineer,4.265048247127545,8,1,2,0,3,1,3,4,3,1,2,2,1,1,Commerce,Masters,25-30,13,0,0,Remote,Tier2_City,4,1,4,2,5,5,3,16.81,Education,5,5,5,2,3,4,4,5,5,1,1,0,1,5,67.24
Computer Science,Digital Marketing Specialist,3.894623600133464,7,2,2,0,2,0,0,1,3,3,0,1,1,1,Science,Bachelors,36-40,11,0,0,Flexible,Tier1_City,3,3,5,5,5,5,1,31.65,Manufacturing,5,1,1,1,3,0,4,2,2,5,1,1,3,4,53.82
Chemistry,Advertising Manager,3.148277230900425,5,1,1,1,9,0,0,0,1,3,2,1,2,1,Science,Masters,36-40,7,1,33,Remote,Tier3_City,3,2,3,4,2,4,4,41.13,Healthcare,3,5,3,4,5,0,3,2,5,5,0,1,4,3,60.1
Biology,Conductor,4.431856164024552,4,1,0,1,4,1,0,0,4,3,0,1,1,1,Science,Masters,25-30,9,0,0,Remote,Tier2_City,3,3,5,5,4,3,4,14.0,Finance,1,5,2,3,0,2,1,3,3,4,0,1,5,2,55.19
Architecture,Music Therapist,3.8139655826423695,8,0,3,1,0,0,2,4,3,1,2,4,2,1,Interdisciplinary,Masters,18-24,11,0,0,Remote,Tier1_City,3,3,0,4,5,2,2,22.27,Finance,5,3,4,3,5,2,1,2,5,5,0,0,1,2,79.48
Engineering,Acoustics Specialist,2.6468602881011867,4,1,4,0,6,0,2,0,1,0,4,2,2,0,Science,Masters,31-35,2,0,0,Remote,Tier3_City,4,3,2,3,4,3,5,22.19,Education,4,5,3,3,2,1,5,1,4,5,0,1,4,4,55.98
Art,Civil Engineer,3.75875224121416,5,2,1,0,8,0,1,4,2,0,3,1,3,0,Arts,Masters,25-30,12,1,54,Flexible,Tier1_City,3,4,0,5,2,5,4,39.33,Other,2,1,4,2,3,1,3,5,4,3,0,1,2,5,57.58
Business,Market Research Analyst,3.110637464320054,7,0,2,1,2,1,2,4,2,1,1,3,1,0,Commerce,Masters,18-24,3,0,0,Remote,Tier1_City,4,1,3,4,2,0,2,14.32,Education,4,4,2,4,2,3,3,3,2,1,0,0,2,2,47.18
Business,Web Developer,4.982822306018287,5,2,2,1,7,1,4,4,3,2,2,0,3,0,Commerce,Bachelors,36-40,3,0,0,Office,Tier2_City,2,3,1,3,5,4,4,48.53,Finance,1,1,4,5,5,2,5,3,2,3,1,0,5,5,53.19
Psychology,Psychologist,3.5307390022149887,6,1,2,0,2,0,3,0,1,4,3,1,3,1,Arts,Masters,18-24,4,0,0,Hybrid,Tier1_City,1,1,4,2,0,4,4,26.99,Manufacturing,4,2,4,4,5,3,1,4,1,5,1,0,4,4,51.55
Chemistry,Conductor,3.0630689651114684,4,0,3,0,5,1,3,1,0,1,4,0,4,0,Science,Bachelors,18-24,2,0,0,Hybrid,Any,4,3,2,4,3,5,5,16.26,Manufacturing,1,2,1,1,3,4,1,4,3,2,0,0,3,2,39.56
Psychology,Financial Advisor,2.846188998266876,3,2,1,0,4,0,4,1,2,2,1,4,4,1,Arts,Bachelors,18-24,8,1,46,Flexible,Tier1_City,3,2,2,2,1,3,3,16.36,Other,4,1,1,5,4,1,2,2,1,1,1,0,5,2,50.42
Engineering,Human Resources Specialist,4.083537767771675,6,0,3,0,5,0,3,3,0,4,0,1,1,1,Science,Bachelors,31-35,3,0,0,Office,Tier2_City,2,2,3,2,3,4,2,3.86,Tech,3,2,1,1,4,3,2,1,5,2,1,0,3,2,46.07
Business,Psychologist,2.7480193949557967,4,1,1,1,4,0,0,4,2,1,2,1,3,1,Commerce,Bachelors,31-35,13,0,0,Remote,Any,2,1,3,1,3,2,4,35.54,Healthcare,4,4,4,4,3,2,2,1,2,5,0,0,1,1,58.01
Music,Judge,3.774584494567032,5,0,4,1,9,1,1,2,4,2,0,2,1,0,Arts,Masters,25-30,9,0,0,Office,Tier1_City,5,3,5,5,4,4,4,39.47,Other,5,2,4,1,1,4,2,3,4,1,1,0,5,3,57.03
Biology,Risk Analyst,3.93815463933962,1,2,2,0,2,1,0,1,3,1,4,2,0,0,Science,Masters,25-30,14,1,45,Hybrid,Tier1_City,5,1,5,4,2,3,1,4.52,Manufacturing,2,3,5,2,2,1,1,5,3,2,0,1,4,4,57.14
Business,Industrial-Organizational Psychologist,2.738134479408348,0,1,0,1,4,0,0,3,1,0,2,3,3,1,Commerce,Masters,25-30,10,0,0,Hybrid,Tier1_City,1,1,5,2,4,5,3,30.54,Healthcare,3,4,5,3,4,3,4,4,4,2,0,1,3,4,55.97
Engineering,Accountant,4.881622636171698,6,2,3,1,3,0,0,3,0,4,4,3,4,1,Science,Bachelors,31-35,10,1,28,Office,Any,1,4,0,1,5,2,5,39.74,Education,4,3,1,4,0,5,3,3,2,4,0,1,5,1,60.86
Computer Science,Chemical Engineer,4.467467283377776,6,2,3,1,3,0,0,0,3,1,4,1,2,0,Science,Bachelors,18-24,3,0,0,Flexible,Tier3_City,5,3,5,3,1,2,2,20.68,Manufacturing,1,3,5,5,1,2,2,4,1,1,1,0,3,2,37.07
Finance,Fluid Mechanics Engineer,3.3040112535998016,2,1,0,0,4,0,4,0,3,3,2,4,2,0,Commerce,Bachelors,36-40,5,0,0,Remote,Tier1_City,5,4,4,4,5,4,4,23.34,Manufacturing,3,4,3,5,4,3,4,4,3,2,0,0,1,5,58.8
Art,Biochemist,3.2000890349189373,1,0,4,1,4,0,4,4,3,1,0,3,3,0,Arts,Bachelors,18-24,14,0,0,Office,Tier1_City,2,3,0,2,0,3,2,20.0,Manufacturing,5,3,5,1,1,1,2,1,2,1,1,1,1,1,50.32
Computer Science,Market Research Analyst,2.809210576186561,6,0,2,1,5,1,4,0,0,0,4,2,2,1,Science,Bachelors,40+,7,0,0,Remote,Any,4,5,3,5,1,4,5,17.84,Tech,2,2,5,3,5,4,5,3,4,4,0,1,1,2,54.24
Computer Science,Psychologist,3.3193089319706823,6,2,0,1,8,0,2,2,3,2,3,3,0,0,Science,Bachelors,18-24,12,1,40,Hybrid,Tier2_City,5,5,4,1,4,0,3,26.08,Other,2,1,3,4,2,0,2,1,5,1,0,1,4,1,67.51
Art,Biologist,4.150735824408959,5,2,2,1,0,0,4,3,1,0,2,4,0,0,Arts,Bachelors,31-35,6,1,8,Flexible,Tier2_City,3,4,3,2,4,5,1,10.81,Education,4,4,3,2,5,5,5,1,5,2,0,0,1,3,57.7
Law,Nuclear Physicist,3.650513145354191,8,1,0,1,8,1,3,0,1,2,4,0,1,0,Arts,Masters,18-24,3,0,0,Hybrid,Tier2_City,4,5,5,5,5,0,3,23.71,Finance,5,1,2,1,5,4,3,3,5,2,0,0,1,1,52.75
Architecture,Music Teacher,4.909391279543764,2,1,0,1,8,1,3,1,4,0,2,4,0,0,Interdisciplinary,Masters,18-24,3,0,0,Remote,Tier3_City,4,4,0,2,4,2,1,47.27,Tech,5,4,4,4,1,3,2,5,1,4,1,1,5,1,56.01
Physics,Actuary,4.017480289464604,9,1,3,1,4,0,0,4,4,3,0,1,3,1,Science,PhD,36-40,4,0,0,Hybrid,Any,3,5,5,4,4,4,2,4.29,Tech,2,4,4,4,0,3,5,4,4,3,1,0,2,2,60.84
Chemistry,Mechanical Engineer,3.556771594717387,7,2,2,1,3,1,0,3,3,2,4,0,4,1,Science,PhD,36-40,9,1,51,Office,Tier3_City,3,4,0,4,3,0,3,10.74,Manufacturing,2,3,1,3,1,0,3,1,3,5,1,0,5,2,66.59
Medicine,Aerospace Engineer,4.449576151898769,1,1,2,1,1,1,3,1,1,1,0,0,4,1,Science,Masters,25-30,4,0,0,Hybrid,Any,3,5,0,4,0,1,3,39.55,Tech,5,1,2,5,5,3,2,5,2,5,1,0,4,4,43.2
Art,Architect,4.159892479316327,1,1,0,0,3,1,1,0,0,2,4,3,3,1,Arts,Bachelors,31-35,11,0,0,Remote,Tier3_City,2,1,1,1,3,0,3,9.21,Other,2,2,2,3,4,5,2,2,5,2,0,1,4,3,58.76
Architecture,Nurse,3.797067885782344,6,2,0,1,8,0,3,3,2,1,4,0,4,0,Interdisciplinary,Masters,25-30,0,0,0,Hybrid,Tier1_City,5,1,0,4,4,4,5,15.75,Other,1,1,2,1,0,4,1,3,5,1,1,0,1,3,46.69
Chemistry,Legal Analyst,4.309782431367799,6,1,0,1,8,1,3,3,1,1,4,3,4,1,Science,Masters,36-40,12,0,0,Flexible,Tier1_City,5,1,2,5,2,4,2,24.38,Other,2,4,2,1,5,1,4,2,1,3,0,1,4,4,56.39
Physics,Brand Manager,3.180974281673384,1,1,4,0,5,0,3,3,3,4,4,3,2,0,Science,Bachelors,25-30,7,1,42,Office,Any,2,3,0,2,3,5,1,47.33,Finance,1,2,5,3,2,4,4,2,5,4,1,1,3,4,69.96
Education,Nuclear Physicist,4.730461989621327,3,1,0,1,9,0,4,1,0,1,0,2,0,0,Arts,Bachelors,25-30,9,1,59,Office,Tier1_City,4,2,5,3,4,0,3,11.62,Tech,2,3,2,4,4,4,3,3,1,5,0,1,3,4,52.45
Marketing,Advertising Manager,2.924448820004714,6,1,1,1,5,0,4,3,0,3,1,4,4,0,Commerce,Masters,25-30,12,0,0,Office,Tier3_City,2,4,3,5,4,4,2,46.38,Other,3,2,1,5,2,5,5,4,1,3,1,1,3,2,62.7
Biology,Brand Manager,4.215821939493732,7,2,0,1,5,1,3,4,4,1,4,2,0,1,Science,Bachelors,25-30,4,0,0,Remote,Tier3_City,5,2,5,5,0,4,5,36.77,Tech,3,2,4,1,5,5,4,5,1,4,0,0,5,3,49.14
Education,Social Media Manager,2.980074831938245,4,1,2,1,4,1,3,4,0,3,3,1,4,0,Arts,Masters,36-40,2,0,0,Hybrid,Tier2_City,1,1,0,4,5,5,5,34.54,Manufacturing,3,1,2,3,3,5,5,2,5,2,1,0,2,1,54.76
Finance,Manager,2.558688943977684,8,1,3,0,7,0,4,3,2,4,3,1,1,1,Commerce,Masters,18-24,2,1,49,Hybrid,Tier1_City,2,4,3,1,1,5,2,37.01,Education,1,4,4,1,4,5,5,2,5,4,0,0,2,2,56.73
Art,Organic Chemist,3.9106321002887774,3,2,3,0,4,1,4,1,0,0,1,4,1,1,Arts,Bachelors,18-24,3,0,0,Remote,Tier1_City,1,4,3,2,3,5,1,4.47,Other,1,4,3,5,1,4,4,5,3,3,0,1,2,1,46.8
Medicine,Curriculum Developer,2.7544865789475765,3,0,4,1,1,0,2,2,4,4,4,0,2,0,Science,Bachelors,25-30,11,0,0,Remote,Tier1_City,1,3,5,1,3,5,2,7.65,Finance,4,4,1,2,2,1,4,2,1,4,1,1,5,5,62.78
Medicine,Conductor,4.237860341685552,5,0,4,1,1,0,4,0,3,2,0,0,0,0,Science,Bachelors,31-35,6,0,0,Office,Tier3_City,3,2,4,2,3,1,2,18.74,Manufacturing,4,5,3,2,1,3,5,3,2,1,1,1,5,2,42.94
Medicine,Landscape Architect,2.830014033187957,9,0,1,0,2,1,3,3,2,3,3,3,2,1,Science,High School,18-24,4,0,0,Remote,Tier1_City,3,2,1,2,4,2,4,6.48,Tech,2,3,2,4,5,4,5,5,4,3,0,0,3,5,58.07
Music,AI Researcher,3.850648458586577,6,1,0,0,1,1,1,4,1,1,1,3,2,0,Arts,High School,25-30,0,0,0,Hybrid,Any,3,5,3,1,0,4,5,49.42,Other,1,1,5,4,0,1,2,1,1,5,0,1,1,1,32.06
Music,Musician,2.99497157880886,5,0,3,1,6,1,3,2,2,2,4,0,1,1,Arts,Masters,36-40,13,0,0,Remote,Tier1_City,1,4,3,5,4,3,1,30.28,Finance,3,4,5,2,2,3,2,1,2,5,0,1,5,3,67.71
Art,Illustrator,4.71216285712778,7,2,3,1,5,0,0,1,3,3,1,2,3,0,Arts,Bachelors,18-24,11,1,28,Remote,Tier3_City,5,1,2,2,4,5,4,25.91,Healthcare,3,2,1,5,2,1,5,4,1,2,1,1,4,2,53.14
Computer Science,Human Resources Specialist,4.639007936017261,8,1,0,0,6,1,3,1,1,3,1,1,4,0,Science,Bachelors,31-35,12,0,0,Hybrid,Tier1_City,3,5,0,1,5,2,2,39.92,Other,3,5,2,3,0,1,4,2,5,3,1,0,1,3,61.13
Law,Web Developer,3.976833508003385,1,1,1,0,6,0,3,4,0,2,3,0,2,0,Arts,Bachelors,31-35,4,0,0,Office,Tier2_City,3,5,1,2,2,5,5,48.92,Other,2,3,2,3,0,4,2,3,5,1,1,0,4,5,48.61
Chemistry,Interior Designer,4.532586016855321,3,0,0,1,8,0,1,0,1,4,2,1,0,1,Science,PhD,25-30,13,0,0,Remote,Tier1_City,4,4,1,3,0,2,4,47.89,Tech,1,4,2,5,0,0,5,5,3,5,0,1,4,4,64.98
Psychology,Accountant,3.217067650141065,9,1,4,0,0,1,4,3,0,4,2,1,3,0,Arts,Bachelors,36-40,4,0,0,Remote,Tier1_City,1,5,5,5,3,3,4,40.27,Education,2,5,2,3,5,4,5,2,3,1,1,0,4,3,47.48
Biology,Urban Planner,4.673782699641756,0,1,1,0,2,0,2,1,4,2,3,3,0,1,Science,Bachelors,31-35,5,0,0,Office,Tier2_City,1,4,4,4,1,0,1,20.73,Tech,5,3,1,4,0,1,3,3,1,3,1,0,2,2,53.45
Marketing,Education Administrator,3.969304946393804,2,0,2,0,4,0,0,3,0,3,2,2,0,0,Commerce,Masters,25-30,13,0,0,Hybrid,Any,3,4,3,2,3,1,2,6.1,Education,5,2,1,3,3,1,3,3,5,3,0,0,1,4,58.88
Education,Counselor,3.4374021383070428,9,2,2,0,2,1,1,3,3,4,0,3,4,1,Arts,Masters,25-30,6,0,0,Office,Tier1_City,4,5,3,3,4,4,1,7.62,Healthcare,4,5,1,3,2,1,5,1,1,1,1,0,5,3,48.1
Music,Illustrator,4.514109589326605,6,0,1,1,4,0,1,3,3,1,3,3,3,0,Arts,Bachelors,31-35,4,0,0,Remote,Tier1_City,4,1,2,4,0,0,4,3.05,Manufacturing,1,1,5,4,5,2,5,1,2,5,0,1,2,2,50.57
Chemistry,Game Developer,3.272219351582312,1,2,1,1,6,1,3,3,3,1,0,2,3,1,Science,Masters,25-30,14,0,0,Office,Tier3_City,2,5,1,4,0,3,4,3.09,Manufacturing,3,3,2,1,5,5,5,3,1,2,1,1,5,4,51.19
Art,Biochemist,4.821881518127282,3,2,3,1,0,0,1,2,1,2,3,2,4,0,Arts,Bachelors,36-40,12,0,0,Hybrid,Any,2,2,0,2,0,1,1,47.01,Other,1,5,3,2,3,4,2,2,3,5,1,0,5,5,58.87
Law,Accountant,2.796539388304212,4,2,3,1,2,0,0,1,3,4,0,0,2,0,Arts,Bachelors,25-30,10,1,10,Hybrid,Tier1_City,3,4,4,1,2,1,4,46.57,Manufacturing,4,5,4,3,3,0,1,5,4,4,1,0,1,5,57.53
Medicine,Biomedical Engineer,2.9410622075738333,4,1,1,1,7,1,1,1,2,2,4,3,4,1,Science,Bachelors,25-30,13,0,0,Remote,Tier1_City,1,1,4,2,3,1,3,34.38,Finance,3,3,1,2,1,5,2,4,2,4,0,1,2,3,61.44
Engineering,Landscape Architect,2.9148463540012424,3,1,3,0,3,1,0,2,1,4,1,4,4,1,Science,Bachelors,18-24,1,0,0,Remote,Tier1_City,4,3,4,3,2,3,5,37.15,Education,2,5,1,2,2,3,5,2,3,3,1,0,3,1,43.55
Biology,Principal,4.729220501156281,3,1,4,0,8,0,0,1,4,4,2,1,3,0,Science,Masters,18-24,13,0,0,Office,Tier1_City,4,3,4,4,5,5,2,27.12,Tech,3,5,5,5,2,0,2,3,5,2,1,0,4,2,69.92
Art,AI Researcher,3.8206869294804,6,1,2,0,1,1,1,1,3,1,2,3,3,1,Arts,Bachelors,18-24,1,0,0,Remote,Tier1_City,4,5,5,2,1,5,5,14.18,Finance,5,3,5,5,5,5,1,5,1,4,1,0,3,3,41.45
Biology,AI Researcher,2.65447256950714,5,2,0,0,7,0,1,4,2,2,2,0,4,1,Science,Bachelors,36-40,12,1,32,Remote,Tier1_City,1,3,1,1,5,5,2,45.98,Finance,2,2,4,5,2,0,1,4,3,1,1,1,4,3,57.37
Computer Science,Electrical Engineer,4.823882481969986,6,0,0,0,9,0,1,3,3,2,4,4,4,1,Science,Masters,31-35,3,0,0,Hybrid,Tier2_City,2,2,3,2,4,0,4,16.05,Tech,3,1,5,1,2,2,1,3,3,5,0,1,4,1,58.47
Medicine,Paralegal,3.492819072114401,3,0,2,1,7,1,0,2,4,0,3,1,4,1,Science,Masters,31-35,0,1,33,Hybrid,Tier2_City,3,5,1,5,2,4,1,37.76,Healthcare,2,3,1,1,0,1,5,5,5,2,0,1,3,3,40.84
Chemistry,Accountant,2.507418123958122,7,2,2,0,8,1,2,0,3,3,4,1,4,1,Science,Bachelors,31-35,6,0,0,Hybrid,Tier1_City,2,5,5,1,2,1,1,14.54,Manufacturing,5,4,2,2,4,0,4,5,4,2,1,0,5,4,54.73
Chemistry,Marketing Specialist,3.0514495733292835,2,1,3,1,7,0,3,1,3,0,4,2,0,0,Science,Masters,36-40,12,1,57,Hybrid,Tier2_City,4,1,0,3,5,1,4,43.9,Healthcare,5,5,2,2,1,5,4,4,5,2,1,1,2,4,66.87
Medicine,Counselor,4.352011296418995,2,1,2,1,2,1,1,1,2,4,2,0,1,0,Science,Bachelors,25-30,0,1,7,Hybrid,Tier1_City,4,4,4,4,4,0,2,33.61,Healthcare,1,1,5,2,1,1,4,3,1,3,0,0,4,5,35.33
Art,Chemist,3.4464308209063814,9,2,1,0,9,1,2,1,3,3,0,1,1,0,Arts,Masters,36-40,2,0,0,Hybrid,Tier1_City,1,5,5,2,0,5,4,33.21,Manufacturing,5,1,4,2,0,4,3,1,5,3,0,1,2,1,44.98
Business,School Counselor,4.588548653607576,1,0,2,0,4,1,2,1,4,4,4,1,1,0,Commerce,Masters,25-30,9,1,17,Flexible,Tier1_City,1,5,1,1,4,1,2,7.58,Healthcare,5,3,2,4,3,1,4,2,1,1,1,0,1,5,59.48
Law,Judge,3.037556419450557,1,0,4,0,9,0,0,0,2,0,3,0,0,0,Arts,PhD,36-40,6,0,0,Hybrid,Tier1_City,1,5,0,5,3,1,4,22.72,Finance,5,4,1,2,4,5,5,4,5,1,1,0,2,4,50.59
Architecture,Web Developer,4.071551991661943,9,1,4,0,5,1,1,1,2,2,4,2,0,0,Interdisciplinary,Bachelors,31-35,10,1,18,Hybrid,Tier3_City,3,1,2,1,5,3,4,27.67,Other,4,4,2,5,1,1,5,2,4,3,0,1,1,4,66.59
Education,Illustrator,2.983298577344534,0,0,0,0,1,1,2,1,0,4,4,1,4,1,Arts,Bachelors,25-30,11,1,27,Remote,Tier1_City,5,5,4,5,4,2,4,16.82,Tech,5,2,4,2,3,4,3,4,1,4,0,0,4,5,55.26
Art,Forensic Psychologist,2.520756646319596,0,2,2,0,3,0,4,3,3,4,2,2,1,0,Arts,Bachelors,25-30,11,1,45,Flexible,Tier3_City,5,4,5,3,0,0,1,44.41,Other,1,4,5,5,2,4,5,1,1,5,0,0,5,3,66.73
Psychology,Credit Analyst,3.524353663346018,4,0,3,1,3,0,2,1,3,0,4,1,2,1,Arts,Bachelors,25-30,5,0,0,Remote,Tier2_City,3,4,3,4,4,0,2,42.37,Finance,2,3,3,5,5,5,5,2,3,5,1,0,5,5,58.89
Biology,Marketing Manager,4.727064512859634,6,0,1,1,8,1,0,3,1,2,3,2,4,0,Science,Bachelors,18-24,14,1,36,Hybrid,Tier2_City,3,5,3,3,2,5,4,26.2,Other,4,1,2,2,4,5,3,5,5,2,1,0,5,2,56.01
Computer Science,Ecologist,3.879674951879985,7,1,1,1,8,0,1,3,1,2,2,3,1,1,Science,PhD,25-30,14,0,0,Hybrid,Tier2_City,3,1,3,2,1,0,5,18.98,Finance,2,1,1,2,4,0,3,5,3,1,0,0,1,5,57.06
Architecture,Social Media Manager,4.760738149940348,6,2,4,1,4,1,2,4,1,4,4,1,4,1,Interdisciplinary,Bachelors,25-30,6,0,0,Hybrid,Tier1_City,2,3,0,1,2,5,5,40.67,Education,2,4,4,3,5,2,3,2,2,4,1,0,2,4,57.03
Chemistry,Music Teacher,3.4256791571933496,6,1,2,0,5,1,0,3,0,0,4,0,4,1,Science,Bachelors,18-24,4,0,0,Hybrid,Tier1_City,3,5,1,5,1,3,1,12.25,Manufacturing,1,5,2,5,2,5,5,3,1,5,0,1,4,4,42.3
Business,Clinical Psychologist,4.109692361805275,5,1,4,1,5,0,1,2,3,2,3,3,0,0,Commerce,Masters,36-40,7,1,56,Office,Tier1_City,2,5,4,5,4,3,3,6.36,Manufacturing,4,2,3,2,1,3,3,5,4,2,1,0,5,4,59.09
Finance,Teacher,4.667361894248769,2,2,4,0,9,0,4,3,0,0,4,3,1,0,Commerce,Bachelors,31-35,5,0,0,Remote,Tier2_City,1,2,4,1,3,4,1,5.15,Other,3,4,5,2,4,4,1,4,4,2,0,1,4,2,51.85
Education,Legal Analyst,3.5575184915429965,7,2,1,0,8,1,2,1,0,2,2,3,3,0,Arts,Masters,36-40,11,0,0,Hybrid,Tier2_City,4,1,5,1,4,5,3,4.82,Finance,5,3,2,3,0,4,2,3,1,1,1,0,4,1,49.61
Computer Science,Judge,3.015186173194394,5,0,2,1,1,0,4,4,2,2,2,3,3,0,Science,Bachelors,31-35,3,0,0,Office,Tier2_City,5,4,4,2,0,3,1,25.98,Manufacturing,2,2,4,4,0,3,3,4,3,5,0,0,4,3,56.99
Medicine,Acoustics Specialist,2.8614629276253547,9,0,0,1,5,1,1,4,4,3,1,3,3,0,Science,Bachelors,25-30,13,0,0,Remote,Tier1_City,4,1,4,3,4,5,5,15.0,Education,2,4,2,5,0,1,3,1,1,5,1,0,1,5,68.63
Marketing,Urban Planner,3.004503230683547,0,1,1,0,6,1,0,0,0,2,0,2,3,0,Commerce,High School,25-30,10,1,39,Remote,Any,5,1,2,5,1,0,4,35.45,Other,1,2,5,5,5,4,3,5,2,4,0,1,2,3,40.79
Psychology,Analytical Chemist,3.4633422772521865,4,1,0,1,8,0,0,0,4,1,2,1,1,1,Arts,Bachelors,31-35,0,1,44,Hybrid,Tier1_City,1,5,5,2,2,4,2,33.73,Tech,1,5,4,3,4,3,3,1,2,1,1,0,5,2,32.03
Physics,Credit Analyst,3.2624541356183223,9,0,1,0,0,0,4,0,3,4,3,1,4,1,Science,PhD,40+,1,0,0,Flexible,Tier1_City,5,2,4,3,3,2,4,28.47,Healthcare,1,3,3,4,1,0,2,3,2,1,0,1,2,5,54.36
Medicine,Quantum Physicist,3.022744340835975,9,0,0,0,7,0,0,0,4,3,1,3,3,1,Science,Bachelors,25-30,11,0,0,Remote,Any,1,5,2,2,4,1,5,19.58,Manufacturing,4,4,1,1,5,5,5,4,1,3,1,1,5,1,54.12
Engineering,Special Education Teacher,3.058901580654333,7,0,3,0,3,0,1,3,1,3,3,0,4,0,Science,Bachelors,36-40,5,0,0,Remote,Tier1_City,4,1,1,5,4,1,2,42.97,Finance,5,1,5,3,3,2,4,5,5,5,1,0,1,4,59.66
Chemistry,Electrical Engineer,4.834773078465494,8,1,2,1,7,1,3,4,1,1,0,0,0,0,Science,Bachelors,36-40,3,0,0,Hybrid,Any,2,5,3,1,2,4,3,36.36,Manufacturing,4,3,2,2,1,4,1,2,3,3,1,0,3,4,38.49
Chemistry,AI Researcher,4.358123916151674,9,0,2,0,5,0,3,3,0,2,2,1,2,1,Science,Bachelors,31-35,2,0,0,Remote,Tier1_City,5,1,2,1,3,5,3,15.76,Finance,1,5,3,2,3,3,5,1,4,4,0,0,1,2,44.77
Computer Science,Teacher,3.808329948834704,3,2,4,1,7,0,2,0,0,4,4,2,4,0,Science,Masters,36-40,6,0,0,Hybrid,Tier1_City,3,4,3,3,5,5,5,26.58,Other,1,5,4,2,4,4,3,5,5,2,0,1,2,5,60.04
Business,Physicist,3.0100130366067464,2,2,3,1,2,1,2,3,2,0,1,2,4,1,Commerce,High School,25-30,6,0,0,Office,Tier1_City,2,5,3,4,4,5,2,10.34,Other,2,1,4,1,2,1,5,2,1,1,0,1,5,2,37.71
Business,Organic Chemist,4.421951230450883,7,0,1,1,8,1,1,2,4,3,3,2,1,0,Commerce,Masters,40+,1,0,0,Remote,Tier2_City,2,5,0,3,4,2,4,18.45,Healthcare,4,3,4,2,3,4,1,3,3,5,0,1,2,4,59.11
Psychology,Graphic Designer,3.9587316212797496,5,0,3,1,7,0,1,0,3,3,2,4,1,0,Arts,PhD,31-35,7,0,0,Office,Tier2_City,1,4,2,4,5,1,5,49.87,Manufacturing,4,4,2,1,3,4,5,2,1,3,0,1,2,1,59.99
Architecture,Fluid Mechanics Engineer,3.201470293434604,8,0,3,1,6,1,2,0,0,4,3,3,1,1,Interdisciplinary,Masters,18-24,14,0,0,Hybrid,Tier1_City,4,5,4,2,1,4,3,13.52,Healthcare,5,1,5,3,1,1,5,3,4,2,1,0,1,5,59.88
Computer Science,Nurse,4.304304795653708,7,0,4,0,4,0,3,4,2,3,2,2,2,0,Science,PhD,36-40,14,0,0,Flexible,Tier1_City,3,1,5,2,1,5,5,35.82,Finance,4,4,3,1,4,4,3,1,1,4,1,0,2,3,66.12
Psychology,Manager,2.835205305884371,1,2,1,0,1,1,1,2,3,2,0,0,2,0,Arts,Bachelors,25-30,10,0,0,Flexible,Tier1_City,4,3,0,5,0,3,4,14.21,Education,5,2,4,2,1,5,2,2,1,5,0,1,1,1,48.84
Medicine,Biotechnologist,2.7890869026765626,5,2,4,0,1,0,3,4,2,3,2,4,1,1,Science,Bachelors,25-30,0,1,12,Hybrid,Tier1_City,4,5,4,4,2,0,1,47.09,Education,3,4,1,5,4,1,4,4,5,5,1,0,2,1,62.33
Biology,Microbiologist,4.346938417069612,9,1,0,1,0,1,3,3,3,0,0,2,3,1,Science,Bachelors,25-30,10,0,0,Hybrid,Any,2,4,5,5,3,2,1,17.58,Tech,5,2,5,2,3,3,5,4,1,1,1,1,3,2,47.46
Psychology,Surgeon,3.352602252390004,3,2,0,1,0,0,2,2,0,4,2,3,3,1,Arts,Masters,18-24,9,0,0,Office,Tier1_City,3,4,3,1,4,5,4,19.29,Finance,1,4,3,1,2,2,2,4,4,1,1,1,4,2,55.75
Finance,Principal,3.759824932477408,5,1,4,0,5,1,4,4,1,0,1,4,1,1,Commerce,PhD,25-30,6,0,0,Hybrid,Tier3_City,5,3,0,4,4,1,2,30.91,Finance,3,2,3,1,5,2,4,3,5,3,0,0,3,3,63.11
Chemistry,Marketing Manager,3.11178863025665,3,1,4,1,8,1,2,1,4,2,0,3,1,1,Science,Bachelors,36-40,9,1,27,Remote,Tier1_City,3,1,4,3,0,0,5,30.64,Finance,2,3,4,4,4,3,1,2,1,3,1,1,5,5,47.62
Business,Investment Banker,4.520968462808569,2,1,3,1,6,1,0,4,3,4,1,1,3,1,Commerce,Masters,18-24,11,1,53,Flexible,Tier1_City,1,2,4,1,4,4,4,30.22,Other,2,5,1,4,3,0,1,5,1,4,1,0,1,4,64.07
Psychology,Zoologist,4.627172968761242,4,2,3,1,7,0,1,0,0,3,1,4,4,1,Arts,Bachelors,25-30,0,1,56,Hybrid,Tier2_City,2,1,1,1,2,5,1,29.94,Other,2,3,4,4,5,0,5,2,2,2,0,0,4,4,34.09
Computer Science,Chemical Engineer,3.8319138623569176,1,1,2,0,5,1,1,3,4,3,4,3,2,0,Science,Masters,18-24,12,0,0,Remote,Tier3_City,3,5,0,3,0,1,3,17.67,Education,1,1,5,2,5,5,4,2,2,4,0,0,2,2,66.28
Psychology,Acoustics Specialist,2.874979064002326,3,0,2,1,9,0,2,2,1,1,3,2,1,0,Arts,Bachelors,25-30,11,0,0,Office,Any,1,4,0,1,2,0,4,23.42,Education,2,3,2,1,2,2,1,1,5,5,0,0,1,4,63.21
Physics,Zoologist,2.553185303073075,5,2,4,1,4,1,2,1,0,3,4,4,3,1,Science,PhD,31-35,14,1,36,Hybrid,Tier2_City,5,4,3,4,0,3,4,30.89,Education,5,3,5,4,1,3,3,5,4,3,0,1,5,1,66.9
Architecture,Physical Chemist,3.881541731873488,0,1,3,0,6,1,4,1,4,1,4,0,2,1,Interdisciplinary,Masters,31-35,13,0,0,Remote,Tier1_City,4,1,5,5,4,2,4,34.55,Manufacturing,1,5,1,5,1,4,2,4,1,4,1,0,3,1,69.13
Engineering,Biotechnologist,3.578770870322686,0,2,3,1,4,0,1,0,4,2,1,1,0,0,Science,Bachelors,36-40,2,1,38,Remote,Tier1_City,4,1,3,1,0,4,1,14.9,Manufacturing,4,3,2,3,4,3,5,3,3,4,1,1,2,5,43.39
Physics,Education Administrator,2.7764162227038813,0,2,1,1,6,1,4,4,0,4,4,0,4,1,Science,Bachelors,31-35,2,0,0,Remote,Tier2_City,1,5,0,4,1,1,1,35.97,Education,1,1,3,3,4,1,1,5,5,1,1,1,5,5,50.53
Psychology,Illustrator,2.544326411105763,8,0,3,1,2,0,4,4,4,2,0,0,0,0,Arts,Bachelors,25-30,9,0,0,Flexible,Tier1_City,2,1,1,2,3,3,4,46.39,Healthcare,1,3,4,4,4,3,2,4,5,4,0,0,1,1,69.66
Finance,Physicist,3.758160178865833,2,0,4,0,6,1,2,4,2,2,0,1,0,0,Commerce,Bachelors,36-40,13,1,25,Flexible,Tier3_City,4,3,1,4,4,2,4,38.62,Manufacturing,4,3,5,4,1,5,3,3,1,2,0,0,5,5,53.32
Education,Civil Engineer,3.003302716097512,6,2,0,1,6,0,0,2,0,3,3,1,3,0,Arts,Bachelors,31-35,1,0,0,Hybrid,Tier2_City,2,3,5,5,5,2,2,6.96,Other,5,3,4,4,4,0,5,5,5,4,0,0,4,4,48.13
Engineering,Acoustics Specialist,2.756981957208264,1,0,1,0,8,0,0,4,0,3,0,2,0,0,Science,Masters,25-30,13,0,0,Office,Any,2,2,3,4,3,3,3,25.05,Manufacturing,3,3,5,3,3,4,5,3,3,2,1,0,4,3,54.25
Education,Biomedical Engineer,3.0196461283989207,0,2,0,0,6,0,4,1,4,1,2,3,0,1,Arts,Masters,31-35,9,0,0,Hybrid,Tier2_City,4,4,2,3,4,1,5,23.46,Manufacturing,4,5,4,4,5,4,1,3,5,2,0,0,2,1,67.39
Biology,Cybersecurity Analyst,4.167306921603433,4,2,3,1,0,0,3,3,3,2,2,1,3,0,Science,Bachelors,36-40,12,1,43,Office,Tier3_City,5,5,4,5,3,2,5,18.82,Manufacturing,1,5,2,5,0,2,5,4,4,5,1,0,5,2,71.81
Biology,Special Education Teacher,2.5509486529605416,9,0,2,1,0,1,4,0,2,4,3,3,3,0,Science,Bachelors,31-35,4,0,0,Hybrid,Tier1_City,3,5,3,2,1,4,5,26.09,Tech,2,1,4,5,0,1,2,1,3,4,1,0,2,5,58.15
Medicine,Aerospace Engineer,3.322155988761476,5,0,2,1,3,0,3,2,1,1,1,4,2,1,Science,Masters,25-30,3,0,0,Hybrid,Tier2_City,4,1,1,3,3,0,1,23.66,Manufacturing,4,1,1,5,4,4,4,4,4,3,1,0,1,1,54.3
Business,Architectural Technologist,2.9997173041064267,3,1,4,0,2,0,1,3,0,2,2,4,0,0,Commerce,Masters,31-35,12,0,0,Remote,Tier1_City,3,4,0,4,0,4,1,3.29,Healthcare,4,1,1,5,3,2,2,5,2,5,1,1,5,3,63.62
Music,School Counselor,4.021820440544316,9,0,2,1,1,1,1,3,2,3,4,2,0,0,Arts,Bachelors,18-24,5,1,53,Remote,Tier2_City,2,2,1,5,3,5,2,14.12,Tech,3,3,4,1,3,4,3,4,2,1,0,0,1,2,44.03
Finance,Art Therapist,3.8525568647995527,8,2,0,1,0,0,0,0,0,3,4,1,0,0,Commerce,Masters,25-30,1,1,54,Remote,Tier2_City,5,2,0,2,4,2,1,13.05,Other,1,4,3,4,3,0,5,4,1,4,0,0,1,4,42.61
Education,Chemist,2.892368555945895,4,0,0,0,0,0,1,1,4,2,4,0,0,1,Arts,Bachelors,25-30,13,0,0,Remote,Tier3_City,2,2,3,3,5,0,4,19.42,Other,2,3,1,2,5,4,3,4,1,5,1,1,5,4,61.71
Chemistry,Acoustics Specialist,4.794168487646193,2,2,2,1,2,1,0,3,4,3,2,2,3,0,Science,Bachelors,18-24,3,0,0,Flexible,Tier3_City,5,4,4,2,5,3,3,11.2,Manufacturing,2,4,5,1,2,0,3,5,5,1,1,0,1,4,51.22
Business,Animator,3.5254418009884505,7,1,3,0,4,0,3,0,3,4,1,0,3,1,Commerce,Bachelors,18-24,11,0,0,Flexible,Tier2_City,1,2,5,4,2,0,3,6.19,Finance,3,1,4,2,5,5,5,5,2,5,1,1,4,4,54.27
Biology,Astronomer,3.0823718761940047,6,2,3,1,0,0,4,0,0,4,2,1,3,0,Science,Bachelors,18-24,6,0,0,Office,Tier1_City,5,3,4,2,3,0,3,12.24,Tech,2,3,4,2,3,3,4,3,5,5,0,0,2,2,56.11
Music,Conductor,4.406322718929984,7,2,2,0,5,1,1,3,0,2,3,0,4,0,Arts,Bachelors,31-35,0,1,52,Remote,Any,5,1,3,1,5,0,3,43.15,Other,5,1,1,1,1,0,2,3,5,5,1,1,2,3,48.58
Education,Actuary,4.640361086461209,4,0,4,1,7,1,2,2,4,2,2,0,0,1,Arts,PhD,36-40,12,0,0,Hybrid,Tier1_City,2,2,4,3,3,2,5,40.46,Manufacturing,4,5,3,4,1,5,3,5,4,2,1,1,2,5,65.89
Psychology,Risk Analyst,4.926866664054952,5,2,1,1,0,1,0,0,4,0,4,0,2,0,Arts,Masters,40+,10,0,0,Hybrid,Tier3_City,4,3,4,2,5,5,5,23.78,Healthcare,4,1,5,1,3,0,2,3,3,4,0,0,2,3,59.46
Medicine,Fluid Mechanics Engineer,3.9550198918073214,9,0,1,1,3,0,0,4,2,3,4,1,2,1,Science,Masters,25-30,2,0,0,Hybrid,Tier2_City,4,3,5,4,3,5,4,44.26,Education,2,3,1,3,0,0,3,4,4,1,0,0,4,2,53.18
Law,Data Scientist,3.298334502281568,4,0,4,1,2,0,3,1,1,1,1,2,2,0,Arts,Bachelors,25-30,0,0,0,Remote,Tier3_City,3,5,2,4,4,1,2,13.94,Other,2,5,1,5,2,5,5,2,4,4,0,1,5,2,46.42
Education,Ecologist,3.1041202069985654,9,0,4,0,9,0,0,2,1,2,0,3,2,1,Arts,Bachelors,36-40,1,0,0,Hybrid,Tier2_City,1,1,2,2,3,5,1,30.46,Manufacturing,2,5,2,1,5,4,5,2,4,5,1,1,5,4,41.76
Medicine,Brand Manager,4.469908411984536,8,1,4,0,2,1,1,0,1,3,0,1,2,1,Science,Masters,18-24,8,0,0,Remote,Tier2_City,5,5,2,4,4,2,1,9.72,Finance,4,4,1,1,1,5,5,3,3,2,0,1,1,4,47.06
Computer Science,Risk Analyst,4.709117821825675,1,2,1,0,6,0,2,4,3,3,2,3,0,0,Science,Bachelors,31-35,9,1,40,Office,Tier1_City,3,4,0,5,4,1,5,42.17,Healthcare,2,2,5,3,1,1,5,3,4,3,1,1,1,5,64.24
Education,Curriculum Developer,3.372014000332408,3,1,4,1,9,1,2,0,1,2,3,2,2,1,Arts,Bachelors,31-35,4,0,0,Office,Tier3_City,5,3,2,5,2,3,3,9.14,Other,5,5,2,5,1,5,5,1,1,5,1,0,4,3,48.63
Music,Manager,4.967653710344649,6,2,4,0,8,1,3,3,2,1,4,4,3,1,Arts,Bachelors,18-24,12,0,0,Hybrid,Tier1_City,5,5,3,5,5,3,4,4.5,Tech,5,2,3,2,5,0,2,4,5,3,1,0,3,5,67.64
Biology,Industrial-Organizational Psychologist,3.5391153755104576,1,1,4,0,6,0,4,0,1,0,1,4,4,1,Science,Masters,36-40,3,0,0,Hybrid,Tier3_City,1,1,5,1,0,3,2,15.85,Healthcare,4,1,3,3,2,2,3,4,4,2,0,0,5,5,44.69
Art,Marketing Specialist,3.908583235033264,3,0,0,1,3,1,4,4,0,3,0,1,2,1,Arts,Bachelors,36-40,11,1,30,Remote,Tier1_City,1,3,2,2,4,3,5,45.34,Manufacturing,1,1,1,4,3,4,1,1,2,2,1,1,1,1,54.02
Medicine,Pharmacist,3.3438936574688807,5,1,4,0,7,1,2,0,0,2,3,2,1,1,Science,Bachelors,18-24,3,0,0,Remote,Tier3_City,3,2,5,1,5,3,4,9.08,Other,1,5,5,1,2,1,4,1,3,3,1,0,4,1,40.78
Finance,Doctor,3.444000787083106,4,2,0,1,3,0,1,1,0,1,1,3,0,1,Commerce,Masters,18-24,7,1,45,Hybrid,Tier1_City,4,1,3,4,1,4,4,18.54,Other,1,4,3,1,3,1,1,2,5,2,0,1,5,1,46.35
Business,Financial Controller,3.063349984720501,4,2,2,0,7,0,4,1,3,0,0,2,0,0,Commerce,Bachelors,18-24,11,1,45,Office,Tier1_City,5,2,2,1,3,2,5,17.87,Finance,5,1,5,3,4,4,3,4,4,3,0,0,4,3,58.53
Computer Science,Music Therapist,4.627043028491245,7,2,0,0,7,1,3,4,3,3,1,3,2,1,Science,Bachelors,25-30,2,1,22,Remote,Tier3_City,2,4,4,4,1,1,4,40.68,Other,3,2,5,1,1,2,2,4,3,2,0,0,5,4,45.93
Finance,Social Media Manager,3.365971090389722,1,1,2,0,1,0,4,3,3,3,3,3,0,1,Commerce,Bachelors,25-30,14,0,0,Hybrid,Tier3_City,3,2,2,4,3,3,3,22.81,Healthcare,1,5,2,5,5,3,3,5,3,3,0,1,4,3,67.54
Architecture,Artist,3.147207252498608,1,0,2,0,4,0,4,0,1,4,3,0,0,0,Interdisciplinary,Bachelors,25-30,11,0,0,Remote,Tier2_City,5,2,3,3,2,4,4,31.74,Other,3,5,1,5,0,4,4,4,2,3,0,1,2,1,58.59
Chemistry,Legal Analyst,4.240834101091355,9,1,2,1,7,1,4,2,4,1,1,1,0,1,Science,Masters,25-30,11,0,0,Remote,Any,1,4,3,5,4,5,2,22.01,Healthcare,4,4,5,3,2,1,3,2,3,4,0,0,3,2,66.08
Music,Cybersecurity Analyst,4.85097408772836,9,2,2,0,5,0,1,0,2,0,3,1,3,0,Arts,Bachelors,36-40,3,0,0,Remote,Tier1_City,1,4,5,4,0,4,4,28.92,Education,5,5,5,3,5,3,5,2,5,2,0,0,3,4,43.24
Marketing,Art Director,2.501194700011117,6,0,2,1,4,0,3,0,3,3,2,3,1,1,Commerce,Bachelors,25-30,1,1,20,Hybrid,Tier1_City,1,2,3,3,4,4,1,5.93,Education,1,3,5,3,2,1,1,1,3,4,1,0,5,3,53.23
Physics,Biologist,2.9827348336825152,8,0,2,0,9,1,0,3,3,2,4,0,2,1,Science,Masters,18-24,5,0,0,Hybrid,Tier1_City,1,3,2,5,3,2,4,20.58,Manufacturing,5,2,1,4,5,0,4,2,4,4,0,0,4,1,59.59
Business,Biochemist,4.155559840210962,4,0,2,1,5,1,0,0,4,4,2,1,3,1,Commerce,Masters,25-30,11,0,0,Office,Tier1_City,4,3,0,4,0,3,5,43.19,Tech,4,3,2,1,1,3,4,2,1,3,0,0,5,1,50.71
Finance,Lawyer,4.383147820460978,5,0,0,0,2,0,0,1,4,0,3,0,1,1,Commerce,Masters,25-30,8,0,0,Remote,Tier1_City,4,5,3,4,4,4,1,35.48,Tech,5,3,5,2,1,5,1,5,3,5,0,1,4,2,55.58
Chemistry,Marketing Specialist,4.692227009206199,0,0,3,0,2,1,4,0,0,3,1,2,4,0,Science,Bachelors,25-30,11,1,45,Remote,Tier2_City,5,5,5,1,0,4,5,49.15,Finance,2,2,4,2,5,4,2,2,5,3,0,1,2,4,52.09
Medicine,Chemist,2.754063641096805,5,2,1,0,3,1,4,2,0,1,3,1,2,0,Science,Bachelors,25-30,3,0,0,Office,Tier1_City,5,4,0,1,3,3,2,40.03,Manufacturing,1,5,2,2,0,4,1,3,4,2,0,0,5,1,47.46
Education,Special Education Teacher,4.342718748383698,9,0,3,1,2,1,2,3,2,1,2,0,1,1,Arts,PhD,18-24,10,0,0,Remote,Tier1_City,3,1,2,5,2,2,3,24.22,Tech,5,5,1,3,0,2,1,3,3,3,1,0,4,2,61.95
Business,Microbiologist,2.629890958266906,9,0,1,0,1,0,0,2,4,4,4,4,4,0,Commerce,Masters,36-40,5,0,0,Remote,Tier2_City,1,2,5,4,2,4,2,34.79,Other,5,3,3,4,1,3,1,1,3,1,1,1,4,2,57.49
Education,Credit Analyst,3.439962027460469,0,1,3,1,6,0,0,4,4,1,2,3,0,1,Arts,High School,40+,3,1,28,Hybrid,Tier1_City,1,4,0,2,4,1,1,39.47,Healthcare,5,2,5,4,5,2,2,4,4,2,1,1,3,4,48.67
Architecture,Psychologist,4.716178171231075,2,0,4,1,7,1,1,3,0,1,2,2,3,0,Interdisciplinary,Bachelors,25-30,13,0,0,Office,Tier1_City,2,4,0,1,1,0,3,15.68,Manufacturing,4,1,4,2,3,4,4,4,3,5,0,0,1,1,52.83
Biology,Judge,3.603804118487324,0,0,4,1,2,1,3,2,3,0,4,2,0,0,Science,Bachelors,25-30,1,0,0,Hybrid,Tier1_City,2,4,3,5,3,5,4,5.82,Healthcare,1,2,3,2,1,2,3,5,4,1,0,1,1,1,44.97
Architecture,Human Resources Specialist,3.369121112393042,8,2,3,1,4,1,2,2,0,1,4,0,0,0,Interdisciplinary,PhD,31-35,12,0,0,Remote,Any,1,3,5,4,4,0,1,22.07,Finance,1,3,3,4,0,3,1,2,2,3,0,1,1,4,59.19
Biology,Zoologist,2.7445575143141627,7,1,0,0,8,1,1,4,3,0,4,2,3,0,Science,Bachelors,31-35,13,1,15,Hybrid,Tier1_City,2,1,2,4,4,0,3,9.8,Other,2,2,5,3,1,4,2,2,1,3,0,1,2,4,57.99
Law,Illustrator,4.958501525417027,1,0,3,0,9,1,1,1,4,4,4,4,4,1,Arts,Bachelors,25-30,5,0,0,Office,Any,2,3,3,2,2,2,5,16.03,Manufacturing,2,2,5,3,0,1,3,2,3,5,1,1,4,5,60.1
Education,Investment Banker,4.64407203606002,4,0,3,0,5,1,0,2,2,1,3,3,2,1,Arts,Bachelors,36-40,11,1,33,Hybrid,Tier2_City,1,5,4,5,0,4,3,47.5,Other,5,1,3,2,4,4,3,2,2,3,1,1,1,2,49.92
Physics,Nuclear Physicist,2.968270033797618,3,0,0,1,8,1,4,2,3,1,0,3,1,0,Science,Masters,25-30,6,0,0,Remote,Tier1_City,4,4,1,4,3,0,5,42.81,Other,1,4,4,5,3,2,4,2,4,5,0,1,5,4,67.07
Physics,Biologist,4.194044972969287,7,1,4,1,3,1,1,1,4,0,0,2,4,0,Science,Masters,25-30,3,0,0,Office,Tier1_City,4,3,0,1,0,0,5,30.85,Other,1,4,2,3,5,2,5,3,1,1,1,1,2,4,33.25
Law,Counselor,3.948539174914419,4,1,0,0,8,0,3,0,2,0,0,2,1,1,Arts,Bachelors,31-35,11,0,0,Hybrid,Tier2_City,5,4,2,2,5,5,3,21.86,Finance,5,1,5,5,0,4,3,5,3,5,1,0,5,4,57.71
Marketing,Legal Analyst,3.408436885061294,4,0,1,0,5,0,2,1,4,4,1,2,1,0,Commerce,Masters,40+,10,0,0,Remote,Any,4,1,0,5,5,3,2,15.42,Education,3,2,5,1,5,0,1,1,2,5,0,0,2,2,67.93
Marketing,Acoustics Specialist,3.61268727005097,9,2,1,1,7,1,0,4,1,1,0,0,3,0,Commerce,PhD,31-35,6,0,0,Office,Tier1_City,1,2,2,2,3,4,2,29.86,Finance,1,3,1,3,2,0,3,1,4,2,0,1,5,4,50.14
Music,Clinical Psychologist,4.462512491457924,7,0,0,0,0,1,3,0,2,0,1,3,1,1,Arts,Bachelors,18-24,12,0,0,Hybrid,Tier1_City,2,3,3,1,1,4,5,28.06,Other,5,1,5,5,2,0,5,3,3,4,0,1,1,2,55.77
Physics,Organic Chemist,3.465059465409435,4,2,4,1,3,0,2,1,0,0,2,1,4,0,Science,Bachelors,25-30,10,0,0,Office,Tier1_City,1,1,1,5,5,5,1,39.7,Education,5,4,1,1,5,1,5,2,2,2,1,0,2,2,42.96
Psychology,School Psychologist,4.252733349123462,1,0,4,0,9,0,3,2,3,3,4,1,0,1,Arts,Bachelors,25-30,7,0,0,Remote,Tier1_City,3,2,1,2,2,3,3,46.62,Manufacturing,3,4,3,1,3,1,4,2,1,4,0,0,4,3,54.99
Marketing,Quantum Physicist,4.458588888100413,3,1,1,1,6,0,2,4,1,4,1,3,4,0,Commerce,Masters,25-30,10,0,0,Remote,Tier3_City,2,4,1,3,1,4,1,18.46,Healthcare,2,1,4,2,3,1,2,4,1,1,0,1,2,5,53.12
Physics,Legal Analyst,4.470762081234277,5,1,4,1,7,0,3,3,0,3,1,2,4,0,Science,Masters,31-35,2,1,28,Hybrid,Tier2_City,1,1,1,1,4,1,2,12.7,Healthcare,5,2,1,5,2,4,4,1,2,1,1,0,1,5,43.89
Art,Geneticist,3.5522366497580533,5,1,1,0,0,1,3,2,3,3,1,4,3,0,Arts,Masters,36-40,14,1,7,Hybrid,Tier1_City,5,5,0,1,5,5,1,21.93,Healthcare,1,5,1,2,5,5,5,4,1,3,0,0,3,5,66.75
Chemistry,Organic Chemist,3.219050941156408,7,1,4,0,9,0,3,0,3,1,3,0,2,1,Science,Masters,31-35,1,0,0,Hybrid,Any,5,2,2,1,2,2,4,23.56,Finance,2,3,2,1,5,4,2,1,1,2,1,1,4,4,37.44
Chemistry,Market Research Analyst,2.9342652728318623,1,2,1,1,6,0,2,1,0,0,1,4,2,1,Science,Bachelors,40+,4,0,0,Office,Tier1_City,2,2,4,3,4,3,4,4.87,Manufacturing,2,5,3,3,5,3,4,4,2,3,0,1,1,5,38.75
Physics,Social Media Manager,4.7160347726119065,6,2,1,1,8,0,4,2,2,2,0,0,1,0,Science,PhD,25-30,1,1,14,Hybrid,Tier2_City,4,4,2,3,1,5,2,43.5,Manufacturing,2,3,1,3,5,0,1,2,4,3,1,0,2,3,52.31
Medicine,Industrial-Organizational Psychologist,3.9395064561061104,6,2,2,0,5,0,1,4,3,2,0,1,2,1,Science,Bachelors,36-40,9,1,38,Office,Tier2_City,5,5,0,4,3,0,1,49.79,Education,5,5,1,3,5,3,3,2,5,4,1,1,1,2,60.21
Engineering,Chemist,4.727272239201383,4,0,0,1,2,1,2,1,1,3,3,0,2,1,Science,Bachelors,31-35,4,1,53,Remote,Tier1_City,3,3,5,2,4,4,3,46.39,Manufacturing,1,5,3,5,4,0,1,2,3,2,0,0,2,4,48.24
Computer Science,Organic Chemist,3.679858838448209,5,0,4,1,8,0,1,0,0,4,0,1,2,0,Science,Masters,25-30,9,0,0,Office,Tier1_City,2,1,3,4,0,1,2,43.45,Healthcare,3,3,5,4,4,2,1,5,1,2,1,0,2,4,41.98
Marketing,Urban Planner,4.970798802843218,0,1,0,1,1,1,2,0,0,2,0,0,0,1,Commerce,Masters,31-35,14,0,0,Hybrid,Tier1_City,3,4,4,2,3,1,4,49.65,Manufacturing,4,3,4,2,0,3,3,4,4,3,1,1,4,3,52.78
Biology,Artist,3.4713108773133907,2,0,1,1,2,1,2,1,2,4,0,1,0,1,Science,Bachelors,18-24,12,0,0,Remote,Any,2,5,4,3,3,2,2,45.67,Education,4,4,3,4,3,4,3,5,4,3,1,0,2,2,56.53
Marketing,Pharmacist,2.576006206620837,4,2,4,0,2,0,2,1,3,0,4,1,3,0,Commerce,Masters,31-35,5,0,0,Remote,Tier3_City,4,2,5,3,1,5,1,35.35,Manufacturing,2,2,2,4,2,2,5,5,5,3,0,0,3,5,56.97
Chemistry,Biomedical Engineer,4.89170155047689,6,2,1,1,6,0,1,4,3,2,2,4,0,1,Science,PhD,25-30,7,0,0,Remote,Tier1_City,1,2,4,4,1,1,1,10.84,Manufacturing,4,2,2,1,5,3,3,4,2,4,1,0,1,2,61.55
Marketing,Surgeon,4.280137407947622,0,2,1,1,0,0,2,3,2,1,1,3,0,0,Commerce,Bachelors,25-30,5,0,0,Hybrid,Tier2_City,2,2,0,5,2,5,1,10.35,Healthcare,4,4,4,2,5,2,1,2,1,4,1,0,1,2,45.69
Computer Science,Landscape Architect,4.972047066851035,9,0,4,1,0,1,3,4,2,2,0,0,1,1,Science,PhD,31-35,3,0,0,Hybrid,Tier2_City,1,5,1,4,2,4,5,5.29,Manufacturing,5,5,2,1,3,5,3,3,3,5,1,0,2,1,55.1
Education,Industrial-Organizational Psychologist,4.038841437627115,0,1,0,1,4,1,0,2,0,3,0,4,3,0,Arts,Bachelors,31-35,2,0,0,Flexible,Tier1_City,2,5,5,2,0,4,1,22.36,Finance,3,3,3,4,2,5,5,1,1,1,1,1,2,5,31.48
Medicine,Counselor,4.670667773465988,6,0,0,0,4,1,0,4,3,2,0,1,1,0,Science,Bachelors,18-24,13,0,0,Flexible,Tier2_City,4,3,1,4,3,1,4,41.01,Education,4,1,5,1,2,5,2,4,3,2,0,0,4,4,49.6
Computer Science,Conductor,2.5084784009790773,4,2,0,0,2,1,4,0,3,1,0,0,1,1,Science,Bachelors,18-24,13,0,0,Office,Tier3_City,3,1,1,1,0,4,4,26.04,Education,3,5,2,1,0,2,4,2,3,2,0,0,4,3,47.19
Psychology,Astronomer,3.608529438681362,6,1,4,0,3,1,1,2,1,3,2,2,2,0,Arts,Masters,25-30,1,1,52,Hybrid,Tier1_City,1,2,2,2,0,5,5,20.22,Education,4,2,3,5,3,2,1,5,5,1,1,1,2,2,42.55
Biology,Advertising Manager,3.623110502089848,5,1,0,0,5,1,2,2,4,3,1,1,1,1,Science,Masters,25-30,12,1,51,Office,Any,3,3,1,2,1,4,4,8.13,Manufacturing,2,3,2,2,4,4,3,2,3,3,0,1,5,1,57.85
Finance,Education Administrator,2.888889115646535,7,2,4,1,4,1,3,3,0,4,3,4,0,0,Commerce,Bachelors,36-40,0,0,0,Remote,Tier2_City,2,5,4,5,0,0,4,5.43,Finance,2,4,1,2,3,2,2,4,2,2,1,0,2,4,38.89
Biology,Biotechnologist,3.928075868230458,1,1,1,1,9,1,3,1,4,3,2,2,1,0,Science,Bachelors,36-40,1,1,18,Hybrid,Tier1_City,2,3,1,3,0,5,2,21.76,Other,3,5,1,4,2,4,4,4,3,2,0,0,3,3,43.87
Business,Education Administrator,3.4201321249051206,0,2,3,0,4,0,3,1,0,0,1,0,2,0,Commerce,Masters,25-30,1,0,0,Hybrid,Any,4,2,5,2,4,3,1,7.7,Other,3,1,5,3,4,1,4,1,4,3,1,1,1,5,39.73
Finance,Analytical Chemist,3.240091063330143,9,2,1,0,0,0,4,3,2,2,3,2,0,0,Commerce,Bachelors,31-35,14,0,0,Remote,Tier1_City,2,1,5,3,2,4,2,7.87,Education,3,5,1,1,2,2,4,1,4,2,1,1,5,4,61.12
Physics,Judge,4.760904286329405,4,0,2,1,2,1,4,1,2,4,2,4,4,1,Science,Masters,25-30,4,1,30,Remote,Any,4,3,4,4,2,4,2,21.58,Tech,3,4,1,2,3,0,1,4,1,4,0,0,5,5,54.43
Biology,Legal Consultant,2.5932630948558284,1,0,1,0,1,1,4,0,2,1,3,0,1,1,Science,Masters,31-35,8,0,0,Hybrid,Tier1_City,2,5,4,1,3,5,4,26.63,Other,1,1,2,3,2,4,4,1,3,1,0,1,5,5,54.62
Education,Physicist,4.213066875770274,8,0,2,0,8,1,0,3,1,3,0,1,3,0,Arts,Bachelors,18-24,0,0,0,Remote,Tier2_City,3,4,2,5,2,2,3,11.77,Other,2,5,2,2,5,1,1,5,5,4,1,1,1,1,41.59
Art,Acoustics Specialist,4.303591566504537,3,1,4,0,8,0,4,3,1,4,0,3,1,1,Arts,PhD,25-30,3,0,0,Office,Tier3_City,2,4,5,3,5,3,1,35.18,Healthcare,4,4,4,4,1,4,1,2,3,4,0,0,4,2,62.75
Finance,Dentist,4.384376714103824,7,2,3,1,9,0,0,3,2,4,3,2,2,0,Commerce,Bachelors,31-35,9,0,0,Flexible,Tier1_City,1,3,1,2,3,3,3,22.68,Tech,1,5,5,1,4,2,5,3,3,2,0,0,5,5,56.89
Architecture,Human Resources Specialist,4.44911211277212,1,2,1,0,4,1,4,2,0,2,4,2,3,0,Interdisciplinary,PhD,18-24,6,0,0,Remote,Tier1_City,5,5,3,3,4,3,4,7.32,Tech,3,3,1,5,5,4,4,2,3,4,1,0,3,1,68.35
Business,Architectural Technologist,3.1581422864284168,6,1,1,1,1,1,2,2,3,1,4,4,2,0,Commerce,Masters,31-35,10,0,0,Hybrid,Tier2_City,1,3,1,2,2,1,5,32.94,Education,4,5,4,4,0,3,3,2,5,5,1,1,2,1,78.26
Computer Science,Artist,3.8446255667915294,8,0,0,0,2,1,3,2,2,1,1,0,1,0,Science,Masters,36-40,13,0,0,Office,Tier2_City,1,3,3,3,4,0,2,19.78,Tech,2,4,2,4,1,3,2,4,1,4,1,0,5,3,57.79
Architecture,Data Scientist,4.898526765740003,9,2,4,0,9,0,3,2,4,4,4,2,4,0,Interdisciplinary,Bachelors,25-30,9,1,41,Remote,Tier1_City,4,4,5,2,2,0,4,5.46,Tech,3,2,4,4,5,0,1,3,3,2,0,0,1,1,64.39
Computer Science,Psychologist,4.385504157482529,8,2,0,1,2,1,4,1,1,1,2,1,0,0,Science,Masters,25-30,2,0,0,Flexible,Any,2,3,2,4,2,2,4,47.56,Other,5,4,1,3,2,4,1,1,1,3,1,1,1,4,42.88
Computer Science,Forensic Psychologist,3.172219469930344,9,0,1,0,8,1,0,3,2,0,4,1,3,1,Science,Bachelors,36-40,7,0,0,Flexible,Tier3_City,3,4,0,2,4,3,3,29.85,Finance,3,5,4,4,3,2,5,1,5,3,0,1,3,5,56.31
Physics,Biologist,4.010855687349907,9,0,4,0,3,0,3,1,2,0,2,0,2,0,Science,Bachelors,31-35,2,0,0,Remote,Tier1_City,2,5,2,2,0,3,5,25.45,Healthcare,4,3,3,5,2,2,1,2,1,2,1,1,5,1,33.33
Marketing,Marketing Manager,4.246518810413242,9,0,2,1,4,0,2,0,3,0,3,1,3,1,Commerce,High School,25-30,7,1,40,Remote,Tier2_City,5,5,2,1,0,4,2,43.38,Manufacturing,2,2,5,1,0,5,1,4,1,4,1,0,4,5,37.47
Computer Science,Marketing Specialist,2.690099705847375,4,1,1,1,0,1,4,4,2,3,3,1,3,1,Science,Masters,25-30,12,1,51,Flexible,Tier2_City,2,5,3,2,0,5,5,47.03,Education,3,4,1,2,3,5,3,3,2,1,0,1,1,5,59.08
Physics,Digital Marketing Specialist,2.799586607210279,5,0,3,1,9,0,0,2,0,4,4,1,4,1,Science,Bachelors,31-35,1,1,41,Flexible,Any,5,4,2,1,5,1,5,13.36,Other,2,2,3,3,4,3,1,4,3,4,1,1,1,2,47.25
Business,Landscape Architect,4.50748202985929,4,1,1,0,0,1,4,1,1,3,3,0,4,0,Commerce,Masters,25-30,4,0,0,Hybrid,Tier1_City,5,2,4,5,0,1,5,41.08,Other,1,3,4,4,4,4,2,3,1,4,1,0,3,4,51.36
Education,Curriculum Developer,2.6008786973531945,1,1,3,1,7,1,2,2,3,1,2,2,1,0,Arts,Masters,18-24,3,0,0,Remote,Tier1_City,1,2,2,1,2,2,1,42.06,Education,5,1,1,2,2,2,2,3,3,1,0,0,5,1,47.88
Medicine,Manager,4.942261412806778,4,1,3,0,1,0,2,3,2,3,2,4,1,0,Science,Bachelors,25-30,10,0,0,Hybrid,Tier1_City,5,2,5,4,1,0,5,5.56,Tech,1,2,4,4,1,1,3,1,2,4,1,0,3,5,60.02
Finance,Lawyer,4.687245012511792,8,1,1,1,9,0,4,2,0,3,3,0,3,0,Commerce,Masters,36-40,8,0,0,Remote,Any,5,2,2,1,4,3,4,36.46,Manufacturing,5,4,5,1,3,2,5,2,2,4,1,1,4,4,57.48
Music,Art Therapist,3.605517768876924,6,0,0,0,8,0,4,0,3,3,3,2,4,0,Arts,Bachelors,31-35,2,0,0,Flexible,Tier1_City,3,5,3,5,1,5,1,5.96,Other,1,3,5,5,5,4,3,1,1,5,1,0,1,2,52.08
Biology,Landscape Architect,4.918188112717126,4,0,1,0,4,1,1,2,4,1,2,1,4,0,Science,Masters,40+,11,1,15,Office,Tier1_City,4,2,5,4,5,2,1,30.95,Manufacturing,2,4,2,5,1,3,2,4,1,5,0,0,2,3,65.73
Engineering,Web Developer,4.567984697752685,3,2,3,0,6,0,4,1,2,0,3,4,3,0,Science,Masters,31-35,10,0,0,Hybrid,Tier2_City,2,3,2,3,1,1,5,34.45,Manufacturing,2,3,3,3,2,1,3,1,2,2,0,1,2,2,61.72
Biology,Advertising Manager,4.587254671750596,3,2,3,1,3,1,3,0,0,3,0,3,2,0,Science,Bachelors,36-40,4,1,36,Remote,Tier1_City,3,4,2,3,3,1,4,20.25,Education,1,4,5,2,5,2,3,2,4,4,0,0,2,1,47.11
Psychology,Microbiologist,4.971217353134168,3,0,3,0,4,0,3,0,2,3,3,1,0,0,Arts,Masters,18-24,9,0,0,Office,Tier1_City,4,2,5,1,0,1,2,44.4,Education,4,3,3,2,5,5,4,5,1,3,0,0,3,1,53.35
Medicine,Quantum Physicist,3.264979675727705,3,2,3,1,4,0,1,3,2,3,3,3,4,1,Science,Bachelors,31-35,8,1,37,Remote,Tier2_City,1,5,5,1,5,3,5,40.62,Other,1,5,4,5,3,0,4,1,4,3,0,0,4,5,63.9
Marketing,Architect,4.682896061405751,4,0,0,0,0,1,4,2,1,2,1,3,4,0,Commerce,Bachelors,18-24,12,0,0,Remote,Tier1_City,3,2,5,5,2,3,1,46.52,Other,3,4,3,1,4,0,3,4,5,2,1,1,2,4,60.99
Finance,Astronomer,3.4996531952706182,7,1,3,1,8,0,2,3,4,0,4,2,1,1,Commerce,Masters,31-35,5,1,54,Hybrid,Tier2_City,3,4,1,5,0,3,2,17.8,Other,4,3,1,3,4,3,1,2,5,5,1,0,1,2,62.95
Marketing,Animator,3.5585903160431207,9,0,2,1,9,1,0,2,2,4,0,0,4,0,Commerce,Bachelors,25-30,1,0,0,Hybrid,Tier1_City,1,1,5,2,0,4,2,4.01,Finance,2,1,2,4,2,1,3,4,5,2,0,0,5,4,39.19
Psychology,Nuclear Physicist,3.792758869505248,6,0,2,0,1,1,2,2,2,0,0,1,4,0,Arts,Bachelors,25-30,0,1,21,Office,Tier2_City,5,1,4,5,1,0,1,41.14,Education,1,3,3,3,3,0,5,3,1,2,0,0,3,5,28.06
Law,Market Research Analyst,2.663077661880987,6,1,4,0,1,0,2,4,0,2,1,0,0,0,Arts,Bachelors,36-40,11,0,0,Flexible,Tier1_City,1,5,4,2,3,1,2,13.48,Education,4,1,3,5,5,0,3,2,1,3,1,0,4,3,49.6
Law,Art Therapist,3.466934257397813,8,2,0,0,2,0,0,0,1,4,3,0,0,0,Arts,Masters,36-40,10,0,0,Hybrid,Tier2_City,2,5,4,4,0,1,4,24.96,Finance,3,2,5,4,2,2,2,3,5,5,0,1,4,1,60.11
Psychology,Analytical Chemist,3.38670697266924,6,0,0,1,7,0,3,0,0,1,0,0,0,0,Arts,Bachelors,18-24,0,0,0,Hybrid,Tier1_City,1,5,2,1,4,4,4,41.41,Education,5,3,1,3,4,4,5,2,4,5,0,1,2,4,39.27
Marketing,Actuary,4.4782994221544135,9,2,2,0,6,1,1,2,1,1,2,2,2,0,Commerce,Bachelors,31-35,6,0,0,Hybrid,Tier1_City,3,2,4,4,4,1,5,13.16,Tech,2,2,5,1,5,2,2,5,1,4,1,1,2,1,41.69
Biology,Sound Engineer,4.574918712137292,5,0,4,0,7,0,4,1,2,3,1,4,1,0,Science,Masters,25-30,13,0,0,Hybrid,Tier1_City,1,4,1,5,0,1,5,17.66,Tech,4,2,3,2,5,2,5,5,1,2,0,0,1,5,58.65
Law,Chemist,3.290613239185544,1,2,3,0,0,0,0,4,3,2,4,3,0,1,Arts,Masters,25-30,11,1,39,Office,Tier2_City,2,4,0,4,1,3,2,23.64,Finance,4,5,4,4,0,3,5,2,3,4,1,0,4,3,67.22
Physics,Web Developer,4.048657025573789,6,0,4,1,8,0,1,4,0,0,1,3,4,1,Science,Bachelors,36-40,1,0,0,Hybrid,Tier1_City,5,4,0,4,1,3,1,15.78,Other,4,3,5,3,1,2,2,3,3,1,1,0,5,2,36.07
Computer Science,Marketing Specialist,3.992053972639813,2,2,3,0,5,0,0,4,0,0,4,3,4,1,Science,Bachelors,25-30,6,1,53,Flexible,Tier2_City,5,1,1,4,2,0,4,24.68,Finance,1,5,5,1,2,5,3,3,3,3,0,1,4,4,47.28
Computer Science,Aerospace Engineer,4.203568806762459,3,2,3,0,9,0,3,4,0,2,1,1,0,0,Science,Bachelors,36-40,0,0,0,Office,Tier2_City,4,4,0,5,5,1,3,3.45,Tech,2,5,1,3,5,1,5,4,2,1,0,1,3,1,35.77
Biology,Accountant,3.80909767859208,2,2,3,1,1,1,3,0,2,3,0,4,1,0,Science,Bachelors,18-24,3,0,0,Remote,Tier2_City,4,5,0,4,5,2,5,12.97,Manufacturing,2,2,5,4,0,1,1,2,1,1,0,1,3,3,40.46
Psychology,Game Developer,3.76382057848078,1,1,4,1,3,0,3,1,4,2,2,4,2,1,Arts,Bachelors,31-35,9,0,0,Remote,Tier1_City,2,2,3,2,5,1,4,42.13,Education,1,4,5,1,4,4,2,3,5,1,0,1,4,1,64.35
Medicine,Financial Advisor,4.180120747047621,7,2,3,0,4,0,3,4,3,1,4,2,2,0,Science,Masters,31-35,14,1,7,Hybrid,Tier2_City,4,1,2,5,3,1,2,22.43,Healthcare,1,2,2,2,2,0,2,2,2,5,1,1,2,1,67.99
Music,Landscape Architect,4.2652157312248775,5,2,3,1,6,0,2,1,3,1,0,1,2,0,Arts,Masters,25-30,14,0,0,Hybrid,Any,5,2,3,4,1,0,4,32.91,Healthcare,1,2,3,1,4,0,3,5,2,4,0,0,2,5,54.01
Business,Market Research Analyst,3.933638351760388,0,0,4,0,2,1,2,3,1,1,2,0,3,0,Commerce,Masters,25-30,12,0,0,Hybrid,Tier1_City,5,3,3,5,2,2,4,13.92,Finance,3,1,1,3,4,4,3,3,2,4,0,0,2,3,57.38
Engineering,Market Research Analyst,3.178910963325567,0,1,3,1,9,0,0,4,2,2,2,3,0,0,Science,Bachelors,36-40,10,0,0,Remote,Tier1_City,4,5,1,3,4,1,2,33.54,Healthcare,4,4,5,3,2,5,5,3,5,2,0,0,2,5,60.5
Computer Science,Digital Marketing Specialist,3.3372402340659253,9,0,0,0,0,1,3,0,2,4,3,3,0,0,Science,Masters,31-35,3,0,0,Flexible,Tier1_City,1,1,0,2,5,5,5,50.0,Manufacturing,3,2,3,3,0,4,2,5,2,2,1,0,2,5,54.25
Architecture,Graphic Designer,4.226541620578239,4,2,0,1,2,1,2,4,1,1,4,2,1,1,Interdisciplinary,Bachelors,25-30,14,0,0,Remote,Tier2_City,5,5,1,4,4,5,5,30.98,Healthcare,2,4,1,3,2,2,3,4,3,2,1,0,1,4,62.23
Business,Clinical Psychologist,4.458511665072523,6,2,1,0,5,1,2,0,2,4,2,2,1,1,Commerce,PhD,25-30,4,0,0,Office,Tier1_City,4,2,4,3,4,2,3,32.53,Tech,1,1,5,3,5,5,2,2,2,1,0,0,5,2,54.19
Finance,Music Therapist,3.0868718038122656,9,2,0,1,3,0,3,2,4,1,1,2,4,1,Commerce,Masters,18-24,13,0,0,Remote,Tier3_City,4,4,3,3,0,5,3,8.24,Finance,4,4,4,5,4,3,1,2,4,3,1,1,4,2,67.44
Engineering,Architectural Technologist,4.461253315847155,9,1,4,1,3,1,1,0,4,3,2,2,0,0,Science,Bachelors,18-24,13,0,0,Hybrid,Tier2_City,2,3,0,5,3,3,5,21.96,Other,5,3,2,1,3,0,2,2,3,3,0,0,3,5,56.5
Law,Construction Manager,2.8073169880648745,5,1,1,1,7,0,4,3,3,0,4,2,4,1,Arts,Masters,25-30,9,1,47,Hybrid,Tier1_City,2,5,2,3,2,3,5,43.45,Healthcare,4,1,1,1,4,0,5,2,1,3,1,0,3,5,60.86
Education,Acoustics Specialist,4.952435542191332,0,0,1,0,7,0,3,2,1,3,3,4,2,0,Arts,Bachelors,18-24,14,0,0,Hybrid,Any,5,3,3,2,3,2,5,42.21,Education,5,4,4,1,5,4,1,1,1,4,0,1,5,1,57.51
Chemistry,School Counselor,4.804945169239442,2,0,3,1,5,1,2,2,0,4,3,3,0,0,Science,Masters,36-40,14,1,55,Hybrid,Tier1_City,3,2,0,2,0,1,5,27.55,Finance,4,5,1,1,2,4,1,5,3,5,1,0,4,1,65.35
Music,Accountant,4.214452912426741,6,0,3,0,4,1,0,4,4,4,0,3,2,0,Arts,Bachelors,31-35,0,0,0,Hybrid,Tier1_City,4,5,4,1,2,2,4,45.46,Manufacturing,1,4,1,4,0,0,4,4,1,3,0,0,1,3,39.3
Engineering,Electrical Engineer,4.919488782244205,8,1,0,0,8,1,3,3,3,4,2,4,2,0,Science,Bachelors,36-40,6,0,0,Hybrid,Tier1_City,1,4,1,2,2,5,3,9.72,Tech,5,1,2,3,4,0,3,5,5,3,0,1,3,4,64.49
Architecture,Data Scientist,4.005566811346825,4,0,1,1,4,1,3,3,1,0,2,3,4,1,Interdisciplinary,Masters,31-35,10,0,0,Hybrid,Tier1_City,3,3,0,3,1,2,2,33.93,Healthcare,5,5,4,5,0,2,1,2,5,5,1,1,3,5,68.0
Law,Surgeon,4.734125832027803,1,0,3,0,9,1,2,4,3,4,3,0,4,0,Arts,Bachelors,36-40,1,0,0,Office,Tier3_City,4,1,0,2,3,5,1,14.7,Tech,2,4,5,4,5,0,4,1,2,2,0,0,1,1,46.95
Music,Legal Secretary,3.637718001568672,2,1,3,1,4,0,4,4,1,1,1,4,1,1,Arts,Masters,25-30,11,0,0,Flexible,Tier1_City,3,2,3,5,3,3,2,33.34,Manufacturing,4,4,3,1,0,5,5,1,4,4,1,0,5,2,68.63
Physics,Pharmacist,4.263978923495774,5,1,4,1,7,1,4,3,1,1,2,4,0,1,Science,Bachelors,31-35,14,0,0,Office,Tier3_City,4,5,0,1,1,2,1,7.11,Other,3,1,4,1,1,5,3,5,2,4,0,1,3,5,57.7
Psychology,Composer,2.9801869844967075,6,1,2,1,2,1,2,2,0,2,0,2,4,0,Arts,Masters,40+,10,0,0,Remote,Tier3_City,4,1,4,3,4,4,4,47.35,Healthcare,3,5,1,5,5,4,2,3,4,5,0,1,4,4,66.64
Art,Paralegal,3.2960433787560746,0,0,3,0,0,1,3,4,2,2,2,3,1,1,Arts,Masters,31-35,14,0,0,Flexible,Tier1_City,3,4,2,1,0,5,3,39.96,Other,2,5,4,1,0,1,2,4,1,1,0,1,4,4,55.01
Engineering,Inorganic Chemist,2.54669003839828,4,2,2,0,4,0,0,4,0,4,1,4,2,0,Science,Bachelors,18-24,12,0,0,Flexible,Tier2_City,2,4,4,3,3,4,1,12.45,Other,2,4,3,1,4,5,2,1,3,4,1,1,3,5,57.57
Physics,Curriculum Developer,4.8664856021972245,7,1,3,0,1,0,2,0,0,4,1,3,0,1,Science,Bachelors,31-35,10,0,0,Office,Tier2_City,4,3,0,5,1,3,5,32.95,Finance,2,3,4,1,4,5,1,2,2,1,1,1,2,1,43.86
Physics,Web Developer,4.075989698830497,4,0,3,0,2,0,3,3,1,4,1,1,1,0,Science,Bachelors,36-40,12,1,31,Hybrid,Any,5,2,2,1,2,1,4,38.68,Other,1,1,3,1,2,1,3,3,5,2,1,1,1,2,56.92
Music,Architectural Technologist,4.042854021978398,6,2,2,1,1,1,2,2,4,1,4,3,2,0,Arts,High School,31-35,1,1,27,Remote,Tier1_City,3,5,4,4,5,5,1,12.84,Finance,1,1,2,4,2,1,5,4,2,4,0,1,4,1,52.79
Engineering,Biologist,2.699109059789775,8,1,1,0,3,1,4,3,4,2,3,2,0,0,Science,Bachelors,25-30,7,0,0,Office,Tier1_City,2,1,2,3,1,1,5,7.39,Other,1,2,1,4,0,5,4,2,5,4,1,0,1,5,67.59
Education,Legal Consultant,3.3070844336846035,9,0,4,1,1,1,1,2,2,3,2,2,2,1,Arts,Masters,31-35,14,1,16,Flexible,Any,1,5,5,4,5,3,4,19.53,Education,1,5,5,4,5,2,3,5,3,2,0,1,5,1,62.81
Music,Entrepreneur,3.6623604727954526,7,2,4,0,6,1,4,4,0,3,0,2,1,0,Arts,PhD,40+,8,1,6,Office,Tier1_City,4,1,3,1,4,1,1,9.38,Manufacturing,2,5,4,1,5,1,4,1,3,3,1,0,3,3,61.87
Marketing,Construction Manager,4.787419824536888,3,1,4,0,8,0,0,0,2,2,0,3,0,0,Commerce,Masters,18-24,5,0,0,Hybrid,Tier1_City,4,2,0,4,0,5,5,29.59,Healthcare,2,2,2,2,3,3,4,5,3,3,1,1,3,3,42.95
Law,Physical Chemist,4.136785494542991,5,0,2,1,9,0,2,3,3,0,3,1,4,0,Arts,Masters,31-35,10,0,0,Remote,Tier2_City,5,4,2,4,5,0,3,22.93,Tech,1,4,4,4,5,3,2,3,2,2,1,1,2,1,59.87
Architecture,Composer,3.933272110856454,9,0,3,1,9,0,1,1,4,0,2,1,0,0,Interdisciplinary,Masters,25-30,0,1,48,Hybrid,Tier1_City,2,4,1,1,4,5,4,24.73,Tech,1,4,2,3,5,2,1,1,5,5,0,0,3,3,55.31
Physics,Interior Designer,4.534947081635233,9,1,4,1,2,0,2,2,1,2,4,4,4,1,Science,Masters,31-35,0,0,0,Office,Tier2_City,4,5,3,5,5,5,1,28.51,Healthcare,5,1,3,3,4,1,1,2,1,1,0,0,2,1,44.21
Business,Forensic Psychologist,4.3039845734449855,0,0,2,0,4,0,3,0,2,2,4,1,3,1,Commerce,Bachelors,31-35,13,0,0,Remote,Tier3_City,2,5,0,4,2,4,5,49.16,Manufacturing,4,4,2,2,0,4,5,3,4,5,0,1,3,3,61.85
Architecture,Physicist,3.395213660797193,3,1,0,1,1,1,2,0,4,2,3,4,1,1,Interdisciplinary,PhD,18-24,10,0,0,Hybrid,Tier2_City,4,3,3,4,2,0,3,40.25,Manufacturing,5,3,3,5,5,2,5,4,3,5,1,1,2,4,72.73
Marketing,Ecologist,4.079946177567502,0,0,0,0,5,1,4,4,3,1,4,4,0,1,Commerce,Masters,18-24,6,1,41,Office,Tier2_City,1,1,1,5,2,0,5,32.59,Other,4,3,2,3,2,5,2,2,1,4,1,1,5,2,66.89
Finance,Credit Analyst,3.9784257655351474,6,2,2,0,4,1,0,2,0,2,4,3,4,0,Commerce,Masters,31-35,7,1,7,Hybrid,Tier1_City,5,3,0,4,2,0,3,20.09,Tech,1,3,4,5,4,5,4,4,2,1,0,0,4,3,51.07
Law,Aerospace Engineer,4.466488634215208,4,2,1,1,0,1,3,2,3,2,3,0,1,0,Arts,Bachelors,18-24,2,0,0,Remote,Tier3_City,1,1,3,4,1,5,1,4.27,Healthcare,1,2,5,3,1,5,2,1,4,5,0,0,1,2,51.29
Education,Biologist,3.760166024444314,7,2,2,1,9,0,4,3,1,1,2,2,4,1,Arts,Bachelors,25-30,8,1,32,Office,Tier3_City,1,2,3,4,2,3,5,8.48,Other,1,3,1,2,5,0,1,4,1,3,1,1,5,4,49.9
Biology,Actuary,4.970301458384449,2,2,0,1,1,0,3,4,0,2,1,4,4,0,Science,Bachelors,36-40,3,0,0,Remote,Tier1_City,3,5,2,2,2,0,5,37.35,Healthcare,5,2,5,4,2,2,1,1,1,5,1,0,5,2,49.02
Engineering,Chemist,2.9802149803306985,6,0,4,1,3,1,4,0,4,0,4,4,1,0,Science,Masters,25-30,3,0,0,Hybrid,Tier1_City,1,1,2,5,1,2,2,20.35,Tech,2,1,2,5,5,3,2,4,3,3,0,1,4,1,58.27
Art,Organic Chemist,3.678809185411664,5,1,1,0,9,0,3,1,0,0,1,3,1,1,Arts,Bachelors,25-30,2,0,0,Office,Tier3_City,5,4,3,4,2,1,4,18.72,Healthcare,4,1,3,5,1,5,3,5,1,3,0,1,4,4,36.72
Art,Legal Secretary,3.218124530268089,9,0,2,0,6,0,3,2,3,1,4,4,4,0,Arts,Bachelors,36-40,7,1,17,Office,Tier1_City,5,2,2,5,4,3,5,44.78,Healthcare,5,3,4,2,4,4,1,5,1,1,1,1,3,4,54.16
Engineering,Animator,4.365168771174561,3,0,0,1,5,1,1,0,2,2,4,0,3,1,Science,PhD,18-24,8,0,0,Flexible,Tier2_City,4,4,0,3,4,2,3,25.77,Other,1,2,1,5,3,1,5,3,4,4,0,0,5,5,68.26
Engineering,Inorganic Chemist,4.236865402580188,9,1,3,1,1,1,0,3,4,2,4,1,0,1,Science,Bachelors,25-30,0,0,0,Hybrid,Tier1_City,1,2,2,3,3,5,4,45.28,Finance,2,3,1,3,0,5,3,4,4,3,1,1,2,1,47.6
Education,Human Resources Specialist,2.956248709314867,7,1,1,0,0,0,3,4,4,1,3,2,0,0,Arts,Bachelors,31-35,1,0,0,Hybrid,Tier1_City,2,1,0,4,4,5,1,44.67,Finance,5,4,4,4,0,3,2,1,2,2,1,0,1,1,48.5
Computer Science,Legal Secretary,2.714584723819768,1,1,1,1,9,0,4,0,2,0,0,3,2,0,Science,High School,31-35,0,0,0,Office,Tier1_City,3,4,0,5,0,2,4,6.77,Education,4,2,2,1,3,1,3,2,3,4,0,0,2,3,29.68
Architecture,Musician,3.704104767538555,0,0,0,1,0,1,4,0,3,2,0,1,3,1,Interdisciplinary,Masters,36-40,13,0,0,Hybrid,Tier3_City,3,1,0,5,0,4,2,47.43,Other,1,2,1,2,0,5,4,1,3,2,1,1,2,2,53.36
Architecture,Nurse,3.8589669268819673,6,1,4,1,6,0,2,0,4,1,1,1,4,0,Interdisciplinary,PhD,36-40,3,0,0,Hybrid,Tier2_City,3,3,0,5,0,4,1,6.62,Education,4,2,4,5,5,1,3,5,1,3,0,0,3,2,44.95
Psychology,Music Therapist,4.916617348882779,3,0,2,0,9,0,1,4,3,4,2,0,2,1,Arts,Bachelors,31-35,9,1,30,Hybrid,Tier2_City,5,2,3,2,1,2,5,48.28,Manufacturing,1,2,2,5,5,2,2,2,3,3,0,0,3,3,57.3
Medicine,Legal Consultant,3.260573671439635,7,2,2,0,3,0,0,2,3,2,1,2,0,1,Science,Masters,18-24,6,0,0,Hybrid,Tier1_City,5,5,4,3,4,4,1,24.27,Finance,1,4,4,5,0,2,4,4,3,1,1,1,5,2,48.94
Psychology,Risk Analyst,4.449496187061007,2,1,1,1,5,0,3,4,4,2,3,3,0,1,Arts,Bachelors,18-24,13,0,0,Hybrid,Tier1_City,4,4,4,5,0,1,1,38.76,Finance,3,3,1,5,1,3,5,5,5,2,1,1,2,3,67.34
Chemistry,Surgeon,3.93550587336529,9,2,1,0,5,1,0,3,3,3,1,0,3,1,Science,PhD,25-30,6,0,0,Hybrid,Tier1_City,1,1,0,5,3,1,2,36.19,Finance,4,1,5,2,0,1,5,4,1,5,1,1,2,4,54.86
Marketing,Illustrator,2.7320915501822345,3,2,1,1,0,1,3,4,3,0,4,4,0,1,Commerce,Masters,18-24,11,0,0,Hybrid,Tier1_City,5,4,4,2,1,5,3,27.37,Finance,2,5,1,3,1,5,1,5,5,5,1,1,3,4,78.03
Physics,Zoologist,3.967342931603315,6,1,2,1,6,1,2,0,4,0,0,3,3,1,Science,Masters,31-35,5,0,0,Flexible,Tier2_City,3,1,0,2,3,4,1,32.11,Manufacturing,1,5,1,3,0,2,3,4,2,4,1,0,5,3,50.19
Engineering,Financial Controller,3.020116013111011,7,1,4,1,1,0,1,0,0,4,1,3,2,0,Science,High School,31-35,12,1,50,Hybrid,Tier2_City,5,3,4,5,4,0,3,47.65,Tech,2,2,5,4,5,3,2,5,4,4,1,0,5,5,56.15
Education,Organic Chemist,2.637426077205918,0,2,4,1,6,0,1,3,1,3,3,0,3,1,Arts,PhD,18-24,10,0,0,Remote,Tier1_City,1,5,5,1,2,2,4,46.59,Manufacturing,5,2,2,4,0,5,5,3,3,3,1,0,1,1,65.47
Psychology,Astronomer,2.884517422120346,4,0,4,0,1,0,4,1,3,4,4,4,0,0,Arts,Masters,36-40,4,1,58,Hybrid,Any,5,4,1,5,3,1,2,33.75,Tech,1,1,4,1,2,1,5,1,3,2,0,1,4,4,61.8
Engineering,Physician Assistant,3.542412604600429,4,1,4,0,0,0,0,3,2,4,2,0,1,0,Science,Bachelors,18-24,10,1,7,Hybrid,Tier1_City,1,4,2,5,2,4,5,33.91,Education,1,5,2,3,3,0,3,1,5,1,1,0,3,1,52.07
Marketing,Civil Engineer,3.704143966020926,8,1,1,1,9,1,2,2,3,4,1,1,3,1,Commerce,Masters,25-30,3,0,0,Flexible,Tier3_City,4,1,4,2,1,4,1,14.61,Finance,1,2,2,2,2,0,2,4,3,1,0,1,3,5,45.81
Physics,Marketing Manager,3.915427054493856,4,0,3,1,5,0,4,2,2,1,3,0,1,1,Science,Bachelors,31-35,11,0,0,Office,Tier1_City,5,1,0,2,3,1,3,41.95,Other,2,4,4,3,0,3,2,4,4,4,1,1,2,4,61.98
Education,Financial Controller,4.823337378663954,1,0,3,0,9,1,2,2,4,4,0,4,3,1,Arts,Masters,25-30,12,0,0,Office,Tier1_City,1,4,2,5,3,1,1,32.73,Other,3,5,2,3,1,0,4,2,1,5,1,0,4,1,68.95
Biology,Organic Chemist,3.563112244141098,1,1,4,1,8,0,1,3,1,4,3,0,1,1,Science,Bachelors,25-30,13,0,0,Flexible,Tier2_City,1,3,2,5,5,0,2,41.83,Tech,4,4,3,4,0,4,5,2,5,3,0,0,2,3,67.01
Law,Lawyer,2.7831823206142814,7,0,4,1,0,1,2,3,2,2,2,2,1,1,Arts,Masters,18-24,7,0,0,Flexible,Tier1_City,2,4,3,5,1,4,5,33.92,Manufacturing,1,1,1,5,4,5,3,1,3,3,0,0,3,3,58.02
Medicine,Analytical Chemist,3.6670505158530418,5,2,0,0,3,1,0,0,0,3,0,3,3,0,Science,Bachelors,25-30,6,0,0,Remote,Tier1_City,4,2,3,2,1,4,4,17.07,Tech,4,1,3,5,4,5,5,1,4,5,1,1,4,4,49.5
Law,Entrepreneur,3.7733875589380337,2,2,2,1,1,1,0,4,0,3,1,1,1,1,Arts,Bachelors,31-35,10,0,0,Hybrid,Tier1_City,5,2,4,5,0,3,4,11.91,Healthcare,4,5,4,3,4,3,3,3,3,2,1,0,3,2,46.44
Business,Actuary,4.069587281552151,7,1,0,1,7,1,1,3,0,4,0,3,0,0,Commerce,Bachelors,36-40,10,1,9,Hybrid,Tier1_City,2,4,3,5,4,5,3,6.62,Education,4,3,5,3,4,3,1,4,3,5,1,0,1,5,59.58
Marketing,Financial Controller,2.7386261225577573,1,1,4,0,0,1,3,4,0,0,0,3,1,0,Commerce,High School,25-30,9,0,0,Hybrid,Tier2_City,5,3,0,4,3,0,4,30.54,Education,2,5,5,3,0,1,3,4,1,4,0,0,3,5,49.9
Engineering,Physicist,4.733315612739178,0,0,0,0,5,0,2,0,4,4,3,1,4,1,Science,Bachelors,25-30,0,0,0,Office,Tier2_City,3,1,3,1,3,1,3,16.35,Finance,4,4,4,3,4,5,2,1,5,5,0,0,5,4,52.79
Physics,Clinical Psychologist,4.858787844793412,1,1,4,0,6,1,3,0,4,1,1,4,3,0,Science,Bachelors,31-35,5,0,0,Hybrid,Tier1_City,3,1,1,3,1,1,5,32.63,Finance,5,3,4,4,3,4,1,4,5,3,1,0,1,2,56.21
Psychology,Psychologist,4.958957015254777,6,0,4,1,3,1,3,0,4,4,0,3,3,0,Arts,Masters,36-40,13,0,0,Hybrid,Tier1_City,1,4,4,1,1,2,1,5.76,Manufacturing,2,4,2,3,0,5,3,2,4,1,0,1,1,5,61.49
Biology,Actuary,4.218173189779122,5,1,0,0,8,1,3,4,4,0,0,4,2,0,Science,Bachelors,25-30,1,0,0,Hybrid,Tier3_City,2,5,2,4,4,5,2,20.66,Tech,2,4,1,3,2,3,5,4,5,2,0,1,4,2,53.73
Law,Game Developer,4.194299512259898,6,2,4,0,9,0,1,3,1,0,1,1,3,0,Arts,Bachelors,25-30,3,1,49,Hybrid,Tier1_City,1,1,5,3,1,1,5,15.25,Healthcare,5,4,3,1,0,5,4,2,2,4,1,1,4,2,33.89
Business,Biochemist,3.577224360371833,6,2,0,0,2,1,4,3,3,1,4,4,4,0,Commerce,Masters,31-35,4,1,36,Hybrid,Tier2_City,1,2,2,5,2,4,5,20.41,Education,3,2,4,1,1,2,5,5,1,1,0,0,4,4,55.01
Chemistry,Teacher,4.649181471884155,2,1,1,1,2,0,0,1,4,3,0,2,4,1,Science,High School,31-35,7,0,0,Office,Any,1,2,1,4,2,1,4,5.55,Tech,3,3,5,3,3,3,1,4,3,5,1,1,5,1,50.49
Medicine,Brand Manager,3.988945535946713,8,2,4,0,4,1,4,3,2,2,1,1,0,1,Science,PhD,18-24,5,0,0,Hybrid,Tier1_City,3,5,0,5,5,4,4,37.04,Healthcare,1,2,1,5,0,4,1,5,5,1,0,0,4,5,66.63
Medicine,Advertising Manager,2.955820770399729,3,1,1,0,1,0,4,0,0,4,3,4,2,0,Science,Masters,31-35,10,0,0,Flexible,Tier1_City,1,5,2,2,2,4,2,8.48,Other,3,2,1,2,2,5,1,1,2,2,0,1,1,2,60.13
Architecture,Pharmacist,3.888598424413975,4,1,1,0,8,1,0,2,3,4,1,0,0,1,Interdisciplinary,Masters,18-24,1,0,0,Office,Any,1,2,1,4,2,0,1,3.68,Tech,1,4,2,1,1,3,3,4,5,2,1,1,4,3,44.68
Marketing,Animator,3.512087465559121,6,0,3,0,6,1,2,1,1,2,3,3,4,1,Commerce,Masters,25-30,4,1,35,Hybrid,Tier1_City,1,4,3,2,4,1,5,47.48,Finance,4,1,5,3,5,0,2,3,3,2,1,0,4,5,49.9
Engineering,Art Therapist,3.82133251140814,5,1,0,1,8,0,4,4,2,4,0,1,4,1,Science,Masters,25-30,14,1,57,Remote,Tier1_City,1,4,4,4,3,0,4,12.07,Other,1,5,1,1,1,4,1,3,5,3,0,1,4,4,66.92
Psychology,Legal Secretary,2.9732869170267007,8,2,1,0,4,0,3,3,2,3,3,4,3,1,Arts,Bachelors,36-40,4,0,0,Office,Tier2_City,2,4,1,4,2,5,5,41.92,Other,3,1,5,3,2,2,2,5,3,2,1,0,5,5,56.05
Chemistry,Architect,3.46575831010622,1,0,0,1,4,1,0,2,1,4,4,3,0,0,Science,Bachelors,25-30,5,0,0,Office,Tier1_City,5,2,1,2,5,4,1,48.33,Education,1,4,3,5,5,4,1,3,4,4,0,0,1,4,59.39
Law,Data Scientist,4.912484777382202,2,0,4,0,2,0,1,0,3,0,1,3,1,0,Arts,Bachelors,25-30,0,0,0,Hybrid,Any,2,5,3,3,1,5,3,28.1,Healthcare,2,5,5,5,2,3,4,2,5,5,1,0,2,5,48.25
Medicine,Legal Analyst,4.796760012391686,7,1,4,0,2,1,4,4,0,2,1,4,0,0,Science,Masters,18-24,7,0,0,Remote,Tier1_City,4,3,0,1,2,1,1,27.73,Finance,3,5,1,1,2,2,5,1,1,4,0,1,1,3,57.1
Psychology,Web Developer,3.4306108009862,9,0,2,1,6,1,0,3,1,2,3,3,0,1,Arts,High School,36-40,2,0,0,Hybrid,Tier2_City,2,2,5,5,5,5,5,20.27,Other,1,4,5,2,2,2,3,2,3,5,0,0,2,1,44.75
Music,Physical Chemist,4.197666237467741,7,0,1,0,1,1,2,2,3,4,1,4,2,0,Arts,Masters,18-24,4,0,0,Remote,Tier2_City,4,2,5,4,4,5,5,23.0,Manufacturing,3,2,5,2,4,2,4,1,1,3,0,1,3,4,56.27
Business,Financial Analyst,4.290126991146629,8,2,2,1,2,0,0,0,3,3,2,1,3,0,Commerce,PhD,25-30,6,0,0,Flexible,Tier2_City,3,1,3,5,1,1,2,25.66,Manufacturing,5,5,5,2,3,0,4,3,4,3,1,0,4,5,52.72
Computer Science,Pharmacist,4.512931824916575,0,0,3,1,5,1,0,1,1,2,3,2,2,1,Science,Masters,18-24,2,0,0,Hybrid,Tier2_City,5,4,3,2,5,0,5,10.15,Finance,3,5,1,2,2,4,2,1,1,4,0,1,1,4,44.42
Architecture,Forensic Psychologist,2.689894055663085,8,0,1,1,3,1,4,0,4,0,0,0,1,0,Interdisciplinary,Bachelors,31-35,13,0,0,Remote,Any,1,1,2,5,2,0,4,20.14,Healthcare,5,5,3,4,4,5,4,2,1,2,0,1,3,3,48.42
Engineering,Advertising Manager,4.58426307366258,3,0,4,0,4,0,2,4,4,3,2,3,4,1,Science,Bachelors,25-30,9,0,0,Remote,Any,4,2,5,2,3,4,2,41.36,Healthcare,1,5,5,3,0,3,3,5,4,3,1,0,4,2,66.16
Finance,Game Developer,2.685137787891976,9,2,0,0,9,0,3,4,2,0,4,0,3,0,Commerce,Masters,25-30,14,0,0,Office,Tier1_City,3,2,1,5,1,4,5,11.57,Education,5,3,3,5,1,0,1,5,5,5,1,1,3,5,70.85
Art,Sound Engineer,3.211809326150301,0,1,4,1,6,0,3,4,1,2,2,4,2,0,Arts,Masters,25-30,12,0,0,Office,Tier2_City,5,2,1,1,1,1,1,37.3,Finance,3,2,1,2,0,2,5,4,4,5,0,1,2,2,67.12
Biology,Organic Chemist,3.290976930282275,9,1,4,0,3,1,0,1,3,4,1,2,3,1,Science,Bachelors,36-40,14,0,0,Hybrid,Tier1_City,4,3,3,1,3,1,5,33.62,Manufacturing,2,3,4,4,0,5,3,2,2,4,1,1,3,4,59.04
Engineering,Ecologist,4.254724349203702,2,0,3,0,1,0,0,0,3,4,4,2,2,1,Science,Bachelors,25-30,5,1,55,Hybrid,Tier2_City,3,1,3,1,1,3,1,5.69,Finance,5,3,5,3,5,3,5,2,3,4,0,1,3,1,50.17
Law,Biomedical Engineer,4.387096476080243,9,2,2,1,4,0,2,3,4,4,2,0,0,0,Arts,PhD,31-35,4,0,0,Hybrid,Tier1_City,1,5,1,1,2,3,1,4.05,Tech,3,4,3,4,4,1,4,5,3,2,0,1,2,1,57.57
Business,Special Education Teacher,4.778199718941491,8,0,0,1,1,1,2,2,3,2,1,1,4,1,Commerce,Masters,36-40,6,1,26,Hybrid,Tier3_City,3,4,1,1,1,2,5,19.57,Healthcare,2,2,5,1,4,3,3,3,5,2,1,1,3,1,54.49
Art,Animator,2.996389720324748,7,2,3,0,4,1,1,0,2,1,3,3,0,0,Arts,Masters,36-40,9,0,0,Flexible,Tier1_City,3,4,1,1,2,4,1,35.53,Other,4,1,2,1,2,1,2,5,4,4,0,0,4,4,57.75
Physics,Animator,3.4908481868251133,4,1,2,0,5,1,4,2,2,3,0,0,1,0,Science,Masters,25-30,14,0,0,Hybrid,Tier3_City,1,3,0,2,3,5,3,18.53,Tech,5,2,2,2,2,1,5,4,3,1,1,1,4,5,56.34
Art,Chemical Engineer,3.399695203413753,2,2,0,1,4,1,0,0,1,4,0,3,3,1,Arts,Masters,40+,10,0,0,Remote,Tier1_City,4,1,3,4,0,2,2,34.38,Manufacturing,5,1,1,1,4,5,2,4,3,1,0,1,3,3,46.17
Biology,Digital Marketing Specialist,3.659806461077668,5,0,1,1,8,1,2,3,2,1,4,0,0,0,Science,Bachelors,18-24,2,0,0,Hybrid,Any,3,4,3,5,3,2,5,34.28,Healthcare,1,5,3,3,3,2,5,2,1,5,0,1,5,1,48.57
Chemistry,Digital Marketing Specialist,4.683637095442098,8,1,3,1,6,1,1,3,1,3,4,3,0,0,Science,Bachelors,25-30,12,0,0,Remote,Tier2_City,1,2,2,1,2,0,3,40.91,Manufacturing,4,1,3,2,5,1,4,2,4,2,1,1,3,5,60.64
Law,Marketing Manager,4.5974139260010425,0,1,0,0,6,1,3,2,0,2,2,4,0,1,Arts,Bachelors,36-40,13,1,23,Hybrid,Tier3_City,4,1,2,2,4,5,1,7.68,Manufacturing,1,1,5,4,5,0,5,4,1,1,0,0,4,3,52.15
Education,Brand Manager,4.8789104570069455,4,0,3,1,7,0,2,1,3,0,1,4,0,0,Arts,Bachelors,25-30,1,0,0,Hybrid,Tier2_City,1,4,4,2,3,0,1,30.13,Manufacturing,1,1,2,5,2,2,1,2,2,2,1,1,3,3,43.32
Medicine,Nuclear Physicist,2.936916091122224,8,2,1,1,3,0,4,1,0,0,1,3,2,0,Science,Masters,25-30,3,0,0,Remote,Any,2,1,1,2,4,3,2,5.94,Education,3,5,5,5,5,5,1,1,2,5,1,1,3,2,52.94
Chemistry,Forensic Psychologist,4.644163625494103,6,2,2,1,7,1,0,0,2,4,0,0,1,1,Science,Masters,25-30,2,0,0,Flexible,Tier3_City,4,3,1,4,4,2,3,11.27,Manufacturing,1,5,5,5,0,1,5,4,2,3,1,0,4,3,41.29
Biology,Physicist,4.167031945936786,7,1,4,0,7,0,1,4,4,0,2,1,4,0,Science,Masters,31-35,14,0,0,Hybrid,Tier3_City,2,5,4,5,2,3,3,18.3,Manufacturing,5,3,1,3,2,4,5,4,5,4,1,0,3,5,66.37
Engineering,Counselor,3.012478891498138,3,0,0,1,5,0,1,1,2,4,1,4,4,1,Science,Bachelors,25-30,3,1,55,Remote,Tier1_City,3,5,3,4,2,5,5,36.25,Tech,1,1,4,2,2,5,4,2,4,2,0,1,1,3,46.56
Education,Nurse,4.317089055639476,6,0,2,1,0,1,3,3,1,3,3,1,1,0,Arts,Masters,31-35,6,1,30,Hybrid,Tier2_City,3,1,1,3,0,5,1,48.77,Tech,2,2,1,1,3,5,1,1,5,5,1,1,3,4,58.78
Biology,Legal Analyst,4.214014624551528,3,2,0,1,2,0,1,2,2,1,4,3,2,0,Science,Masters,36-40,4,0,0,Hybrid,Tier1_City,3,3,2,2,5,4,4,19.1,Tech,5,4,1,2,4,0,2,4,2,1,1,1,5,2,50.92
Finance,AI Researcher,3.010092261837489,6,1,3,1,4,0,1,4,0,3,0,1,4,0,Commerce,Masters,31-35,3,0,0,Remote,Tier1_City,4,4,0,3,1,1,5,27.49,Healthcare,3,3,1,4,3,4,3,1,5,5,0,0,2,3,53.83
Architecture,School Psychologist,3.3691170613033496,7,2,4,1,3,1,1,2,4,3,0,0,2,0,Interdisciplinary,Masters,18-24,13,0,0,Remote,Tier3_City,5,2,5,1,3,0,5,15.18,Education,1,1,5,5,2,3,2,4,3,2,1,1,4,3,58.65
Music,Art Director,4.191815311066455,7,0,4,1,5,0,3,4,3,3,3,4,1,0,Arts,Bachelors,36-40,14,1,28,Remote,Tier1_City,4,1,3,1,2,4,5,34.75,Healthcare,2,3,5,2,3,0,3,1,5,5,0,0,2,1,74.57
Finance,Ecologist,2.7483448038702365,3,0,0,1,9,1,2,0,0,1,0,3,4,1,Commerce,Bachelors,25-30,5,0,0,Hybrid,Tier1_City,4,1,0,4,3,4,2,20.23,Education,2,1,5,2,5,5,3,5,4,4,1,0,2,2,46.15
Engineering,Actuary,3.011021543055377,8,1,0,1,0,0,2,1,4,1,1,3,2,0,Science,Bachelors,18-24,6,1,48,Remote,Tier1_City,5,4,0,5,5,0,2,25.64,Education,5,1,5,1,2,4,3,4,1,5,1,1,4,3,50.36
Engineering,Curriculum Developer,4.034449406494459,4,2,3,1,3,1,1,3,4,2,3,3,4,1,Science,Bachelors,18-24,11,0,0,Remote,Tier1_City,4,2,4,3,5,0,5,29.69,Finance,1,3,2,4,3,4,5,1,4,5,0,1,2,1,74.28
Law,Chemist,3.5757041248435613,5,2,2,1,9,0,4,2,0,2,0,4,2,1,Arts,Bachelors,25-30,13,1,54,Flexible,Tier1_City,2,2,0,5,4,5,4,35.25,Other,2,1,3,5,1,5,1,5,1,4,1,1,1,2,55.33
Biology,Marketing Specialist,3.508009079760912,8,2,1,1,5,1,3,1,2,2,4,1,3,0,Science,Masters,18-24,10,0,0,Remote,Tier1_City,5,4,1,4,1,5,3,5.82,Finance,1,1,2,1,1,2,4,2,5,5,1,1,5,4,70.7
Business,Curriculum Developer,4.816036522497312,8,2,3,0,9,0,2,1,2,4,4,4,0,0,Commerce,PhD,18-24,4,0,0,Hybrid,Tier1_City,5,1,4,1,0,2,3,29.08,Finance,5,4,3,5,2,3,4,3,5,2,0,1,4,3,67.3
Biology,Landscape Architect,2.6102797184125768,5,1,3,1,6,0,3,0,4,3,0,0,2,0,Science,Masters,25-30,11,0,0,Remote,Tier2_City,2,4,2,5,3,3,1,23.26,Education,4,2,5,1,3,0,4,1,4,1,0,0,3,1,57.0
Physics,School Psychologist,4.891531628017642,5,2,1,1,6,0,1,4,1,3,3,0,2,0,Science,Masters,25-30,6,1,38,Remote,Tier1_City,5,5,0,5,1,5,3,9.29,Education,2,5,2,1,2,0,1,5,1,1,1,1,4,5,44.82
Business,Marketing Manager,3.8177394549300425,4,0,4,0,7,0,0,4,4,3,4,0,0,1,Commerce,Bachelors,31-35,2,1,50,Office,Any,5,4,1,1,0,4,3,12.78,Healthcare,3,4,3,5,3,5,5,4,2,1,1,0,4,4,42.78
Engineering,Chemical Engineer,3.4991935461811163,6,1,2,0,8,1,2,0,4,3,0,1,1,0,Science,Masters,36-40,6,1,12,Remote,Any,2,3,1,3,3,2,4,44.54,Education,1,5,4,4,4,5,4,5,2,4,0,1,4,3,56.52
Finance,Microbiologist,4.486742494579729,1,1,1,0,5,1,1,4,1,2,2,1,0,0,Commerce,Bachelors,31-35,11,1,47,Remote,Tier1_City,1,1,2,1,1,2,3,43.97,Manufacturing,5,5,1,3,3,0,5,3,5,4,0,1,5,2,58.74
Physics,Education Administrator,4.825165194108837,2,2,0,0,0,1,1,4,1,0,3,3,1,1,Science,Bachelors,25-30,14,0,0,Hybrid,Tier1_City,1,3,4,5,2,4,4,4.57,Manufacturing,5,2,3,3,3,1,2,3,5,4,0,1,5,2,62.99
Marketing,Illustrator,4.832147988234083,8,0,4,1,1,0,3,2,3,1,4,4,3,1,Commerce,Bachelors,18-24,2,1,11,Remote,Tier1_City,1,1,4,3,3,5,2,35.4,Education,3,4,2,2,2,0,1,3,3,2,1,0,3,1,52.36
Architecture,Art Therapist,4.624980782778732,1,2,3,0,5,1,4,0,1,1,3,0,1,1,Interdisciplinary,Bachelors,40+,13,1,50,Hybrid,Any,2,1,4,3,1,4,4,29.05,Manufacturing,4,1,2,2,3,1,2,2,5,3,0,0,1,2,56.59
Biology,Conductor,2.547287861014788,2,1,4,1,7,1,4,4,3,2,1,3,1,0,Science,High School,18-24,5,0,0,Remote,Tier2_City,3,5,2,1,5,1,2,47.17,Education,1,2,4,4,2,2,1,1,5,2,1,1,4,3,58.79
Art,Actuary,2.920191298603281,0,2,2,0,9,1,2,0,4,4,1,1,4,0,Arts,Bachelors,36-40,7,0,0,Hybrid,Tier2_City,4,4,2,5,0,5,4,45.68,Finance,4,1,3,3,2,1,5,4,3,1,0,1,5,1,45.29
Marketing,Landscape Architect,2.7468717304400414,2,0,0,0,7,0,3,2,2,1,1,3,3,1,Commerce,Bachelors,18-24,12,0,0,Remote,Any,5,4,2,4,1,3,5,30.24,Education,5,1,1,2,0,3,5,1,3,1,1,0,3,5,51.94
Computer Science,Music Teacher,3.916954043984803,2,0,2,1,3,1,4,2,1,2,4,0,3,1,Science,PhD,36-40,14,0,0,Flexible,Any,2,5,4,5,2,4,2,9.53,Finance,2,1,2,3,2,5,2,1,4,3,1,0,1,1,70.54
Chemistry,Judge,4.094910175594016,0,2,2,0,0,0,3,2,2,0,1,3,2,1,Science,Bachelors,25-30,5,1,49,Hybrid,Tier3_City,4,5,0,2,3,5,2,24.61,Tech,4,1,5,3,3,1,1,2,5,4,0,0,4,3,55.66
Physics,Physicist,4.413043575169676,1,0,1,1,7,1,2,1,1,0,3,2,4,0,Science,Bachelors,25-30,9,0,0,Hybrid,Tier3_City,2,2,2,4,3,0,3,37.08,Manufacturing,2,4,5,3,1,5,4,4,2,1,0,0,3,3,48.66
Education,Risk Analyst,4.36048895795312,7,1,0,1,5,0,0,0,4,1,3,1,0,0,Arts,Bachelors,31-35,10,0,0,Office,Any,5,3,2,3,3,1,2,47.73,Tech,3,5,3,2,4,3,4,2,5,2,0,0,3,2,56.26
Biology,Industrial-Organizational Psychologist,4.045496620504544,1,1,4,0,2,0,2,3,1,2,0,1,4,0,Science,Masters,25-30,2,0,0,Office,Any,3,1,4,4,2,3,4,20.1,Manufacturing,5,5,4,2,3,3,3,4,5,5,1,0,3,4,52.24
Music,Analytical Chemist,3.860202851951401,1,1,1,1,3,1,3,1,4,0,4,3,0,1,Arts,Bachelors,25-30,11,0,0,Hybrid,Tier1_City,2,2,2,3,0,5,5,39.88,Other,2,4,1,4,5,3,2,5,1,3,0,1,5,1,60.43
Marketing,Cybersecurity Analyst,4.670736747371155,7,2,1,0,2,1,3,3,3,4,1,2,3,0,Commerce,Bachelors,25-30,4,0,0,Office,Any,4,4,0,3,3,0,5,35.12,Other,1,5,3,1,3,3,5,4,1,5,0,0,2,1,51.05
Computer Science,Software Developer,3.786415566592173,0,2,3,1,9,0,4,2,1,1,1,3,2,0,Science,Bachelors,31-35,8,1,13,Hybrid,Tier3_City,4,2,4,4,0,5,3,6.68,Other,5,2,3,2,3,0,2,2,4,3,1,1,4,4,52.69
Law,Zoologist,3.597987197427137,9,1,1,0,3,1,4,4,4,3,1,0,1,1,Arts,High School,18-24,7,0,0,Hybrid,Tier1_City,5,4,2,3,1,0,4,29.22,Tech,3,1,1,5,0,5,4,5,2,3,1,1,2,4,56.44
Biology,Biologist,4.99980308305978,3,0,3,1,6,0,0,1,4,3,4,3,3,0,Science,High School,18-24,5,1,15,Office,Tier2_City,1,5,2,3,5,3,4,11.62,Other,1,1,2,1,1,3,3,4,1,2,0,0,1,2,45.25
Psychology,Music Therapist,4.383518667773961,4,1,2,0,8,1,4,3,1,3,0,0,4,1,Arts,Bachelors,25-30,8,0,0,Flexible,Tier2_City,5,1,3,2,5,1,1,35.13,Education,5,1,5,3,3,4,1,3,2,1,1,0,5,3,46.38
Marketing,Art Director,3.5967710084420337,4,1,2,1,2,1,2,3,0,3,4,4,3,1,Commerce,High School,18-24,1,1,43,Remote,Tier1_City,5,1,3,5,0,0,2,31.67,Other,4,3,2,4,5,2,4,2,3,4,1,1,1,5,43.02
Education,Mechanical Engineer,3.881522938781897,4,0,4,0,7,0,0,2,3,2,2,0,1,0,Arts,Bachelors,31-35,12,0,0,Hybrid,Tier3_City,1,1,1,5,0,2,3,48.73,Tech,5,2,4,5,2,4,4,5,5,1,1,1,5,5,50.44
Biology,Pharmacist,4.892665051835707,4,0,4,0,0,1,0,1,2,3,4,0,0,0,Science,Bachelors,18-24,10,0,0,Office,Tier1_City,3,5,1,2,5,3,5,46.96,Manufacturing,1,3,1,5,1,0,2,3,4,5,1,0,4,5,64.95
Law,Architectural Technologist,2.628221669982405,9,0,4,0,1,1,3,1,1,3,0,2,1,0,Arts,Masters,25-30,8,0,0,Remote,Any,2,4,2,4,3,3,1,3.44,Healthcare,2,4,2,1,1,3,1,5,2,1,1,1,5,3,46.71
Business,Physician Assistant,4.882717858517635,6,2,3,1,3,0,3,2,2,0,2,3,0,0,Commerce,Masters,18-24,9,1,15,Flexible,Tier1_City,4,5,3,1,4,4,4,6.76,Manufacturing,2,3,3,4,3,1,4,4,1,5,0,1,2,4,63.38
Physics,School Counselor,3.3662937094056167,8,0,4,0,8,1,0,2,0,0,2,4,1,1,Science,Bachelors,25-30,12,0,0,Hybrid,Tier1_City,2,1,1,1,4,1,2,39.15,Healthcare,5,5,3,1,2,5,3,4,5,4,1,0,3,3,54.6
Medicine,Biologist,2.884427453019255,0,2,4,1,4,1,3,1,4,2,1,1,2,1,Science,Bachelors,18-24,9,0,0,Hybrid,Any,2,1,4,1,2,2,5,35.23,Education,5,5,4,2,1,0,5,5,5,4,0,1,5,4,60.86
Medicine,Pharmacist,3.5842774128234822,3,0,0,0,4,0,4,0,4,4,0,2,1,0,Science,PhD,18-24,5,1,29,Remote,Tier1_City,4,1,3,2,5,2,1,40.64,Manufacturing,3,2,4,3,4,2,4,5,5,3,0,1,4,5,68.48
Medicine,Investment Banker,2.812871955195839,2,0,1,0,7,1,3,2,4,1,2,2,1,1,Science,Bachelors,18-24,8,0,0,Remote,Tier3_City,1,4,0,2,5,4,4,15.54,Tech,4,3,1,4,2,1,2,4,4,1,1,0,3,1,62.69
Psychology,Nurse,2.99332273333686,3,1,4,0,6,0,0,1,4,0,1,3,2,1,Arts,Bachelors,40+,11,0,0,Remote,Tier1_City,4,4,0,3,2,0,5,42.92,Education,3,3,2,2,1,1,4,1,3,2,1,0,4,1,49.68
Psychology,Electrical Engineer,3.1020947704098965,6,1,3,0,5,0,2,3,2,3,3,1,1,0,Arts,Masters,18-24,3,0,0,Remote,Any,1,2,0,1,4,0,5,23.79,Manufacturing,3,1,3,3,1,3,2,5,5,2,1,1,2,1,54.18
Biology,Musician,3.6561885755557393,0,0,1,1,0,0,2,2,1,4,1,3,4,1,Science,Bachelors,31-35,4,0,0,Hybrid,Tier1_City,1,2,0,4,1,2,4,15.31,Education,2,2,1,3,2,2,1,1,5,4,1,1,4,1,54.12
Finance,Credit Analyst,4.492819977583191,4,0,0,1,5,0,4,0,2,0,4,3,0,0,Commerce,Bachelors,18-24,1,0,0,Office,Tier1_City,5,3,3,4,3,1,4,3.5,Healthcare,2,1,1,2,0,5,4,4,5,4,1,1,2,1,52.54
Chemistry,Chemist,2.788136274360826,3,0,1,1,9,1,1,0,4,1,2,3,4,1,Science,Bachelors,18-24,2,0,0,Hybrid,Any,3,4,4,1,3,0,3,43.95,Education,1,2,3,4,2,5,3,3,3,5,0,0,3,3,49.28
Business,Principal,2.7120605094889902,8,2,0,1,5,0,0,4,1,2,2,4,1,0,Commerce,Masters,25-30,0,1,48,Remote,Tier1_City,5,5,0,1,1,3,5,28.16,Tech,3,2,2,5,4,2,4,3,1,1,1,1,3,2,37.76
Business,Financial Controller,2.8223620679194017,9,1,1,1,6,0,3,0,4,1,2,1,0,0,Commerce,Bachelors,25-30,3,0,0,Remote,Any,3,4,4,1,1,5,4,48.84,Manufacturing,1,3,5,1,0,1,5,2,2,5,0,0,3,4,46.86
Finance,Microbiologist,3.700173280334753,6,2,4,1,7,0,2,2,3,2,1,0,3,0,Commerce,Masters,40+,11,0,0,Hybrid,Tier3_City,1,2,1,2,4,4,1,36.59,Healthcare,5,1,4,4,3,2,3,2,5,3,0,1,4,5,64.18
Education,Music Teacher,3.1930451019493225,1,2,3,0,7,1,1,1,1,2,4,1,2,1,Arts,PhD,36-40,1,0,0,Hybrid,Tier1_City,5,1,1,2,2,1,2,6.78,Education,1,4,2,5,0,4,5,4,5,1,0,1,3,1,53.34
Art,Nuclear Physicist,4.973450528202438,9,2,0,0,4,1,2,4,1,3,2,4,3,1,Arts,Bachelors,31-35,11,0,0,Flexible,Tier2_City,2,2,2,2,1,0,3,30.64,Finance,2,1,5,5,4,3,4,5,1,4,1,0,1,5,58.16
Engineering,Physical Chemist,3.8223610894553017,0,1,1,0,4,0,4,3,1,1,2,1,4,1,Science,Bachelors,31-35,14,0,0,Office,Tier1_City,4,2,3,5,2,5,4,3.8,Healthcare,3,4,5,5,4,3,3,3,3,4,0,0,4,1,58.94
Art,Nurse,4.307293816701479,3,1,2,1,8,1,4,3,3,3,3,0,3,0,Arts,Bachelors,25-30,1,1,36,Office,Tier1_City,4,2,0,4,0,2,2,29.22,Healthcare,2,5,3,1,4,4,3,5,3,1,0,0,4,4,44.7
Business,Biomedical Engineer,3.25401541868354,5,2,0,1,2,0,1,0,0,0,4,2,4,0,Commerce,Bachelors,25-30,0,1,43,Remote,Tier1_City,4,3,4,4,3,4,3,19.46,Tech,5,2,5,1,1,4,5,1,2,3,1,0,2,2,31.88
Law,Nuclear Physicist,4.169926346217054,5,2,2,0,5,0,0,2,4,4,3,2,4,0,Arts,Bachelors,36-40,9,1,55,Office,Tier2_City,3,3,4,3,4,0,5,33.23,Tech,4,1,4,1,0,2,1,4,3,5,1,1,5,1,63.55
Chemistry,Brand Manager,4.938755144967297,5,2,2,0,3,0,1,0,4,4,0,1,4,1,Science,PhD,31-35,11,0,0,Remote,Any,4,3,5,2,3,2,2,28.45,Education,3,2,1,5,4,1,5,2,3,3,1,1,3,4,62.17
Architecture,Nurse,4.920888171451107,1,2,0,0,6,1,0,4,2,2,4,3,1,1,Interdisciplinary,Masters,25-30,1,1,50,Hybrid,Tier1_City,3,5,3,5,4,0,3,15.28,Finance,2,1,2,2,5,2,3,4,1,2,1,1,2,2,45.15
Art,Principal,3.4817778788730944,9,2,1,1,8,1,0,3,4,3,4,3,2,0,Arts,Masters,18-24,3,1,18,Hybrid,Tier1_City,3,3,1,5,0,4,4,10.63,Healthcare,4,5,4,1,0,4,4,2,1,1,1,1,4,4,45.72
Medicine,Organic Chemist,3.8236631071406793,9,1,0,0,7,0,3,3,1,4,3,3,3,1,Science,Bachelors,18-24,5,0,0,Hybrid,Tier2_City,3,5,3,4,3,3,4,22.02,Education,5,1,5,5,5,3,4,4,1,4,0,0,3,4,54.71
Art,Art Therapist,4.823042839233025,9,1,4,0,6,1,4,0,4,3,1,1,3,0,Arts,Masters,36-40,12,0,0,Remote,Tier1_City,2,4,4,2,0,3,3,49.38,Other,4,5,1,4,0,3,1,4,2,2,1,1,3,5,59.45
Biology,Web Developer,3.2261193531211285,6,0,2,1,4,1,2,2,3,0,4,2,3,0,Science,PhD,25-30,11,0,0,Hybrid,Tier3_City,1,4,3,3,4,5,5,23.48,Finance,2,2,1,5,3,3,4,2,3,3,0,1,5,1,71.89
Finance,Financial Advisor,4.041539344232381,7,2,4,1,4,1,2,0,4,2,2,2,4,0,Commerce,Masters,25-30,6,0,0,Remote,Tier2_City,2,3,5,2,1,2,3,38.19,Education,2,3,5,1,5,2,3,1,1,3,0,1,5,3,49.06
Art,Market Research Analyst,4.147381154036021,3,1,3,1,1,0,1,3,4,0,2,1,1,1,Arts,High School,18-24,6,1,29,Remote,Any,1,4,1,1,3,3,1,5.68,Healthcare,5,4,4,1,3,5,4,4,4,4,0,0,2,3,48.66
Computer Science,Marketing Specialist,2.8903951884960493,7,1,3,1,6,0,0,3,2,1,2,0,0,0,Science,Masters,36-40,6,0,0,Office,Tier2_City,2,4,1,2,0,4,3,20.81,Education,5,2,5,1,3,4,3,3,5,2,0,1,4,1,46.19
Marketing,Actuary,3.711135075470724,6,2,1,1,7,0,0,2,4,2,0,1,3,0,Commerce,Bachelors,18-24,14,0,0,Flexible,Tier1_City,3,1,5,1,5,2,3,30.28,Tech,4,3,2,2,5,1,4,4,4,3,0,1,4,4,58.64
Psychology,Nuclear Physicist,4.226192157977278,5,0,1,0,9,0,2,3,2,4,0,2,4,0,Arts,Bachelors,36-40,3,0,0,Office,Tier3_City,1,3,0,1,3,0,4,38.31,Tech,4,2,1,3,1,5,1,5,2,5,0,0,5,1,47.12
Art,Cybersecurity Analyst,4.694447963857047,2,1,2,0,8,0,1,4,2,3,4,1,4,0,Arts,Bachelors,18-24,11,0,0,Hybrid,Tier3_City,4,3,0,3,3,1,5,27.83,Manufacturing,2,2,3,2,1,2,4,3,3,5,0,1,1,1,66.73
Business,Quantum Physicist,3.732505883853523,9,1,3,0,5,1,1,3,3,4,3,3,4,0,Commerce,Masters,36-40,4,0,0,Remote,Tier3_City,2,2,5,4,3,0,3,27.22,Finance,5,1,1,4,3,5,2,5,3,5,0,0,4,2,62.56
Marketing,Sound Engineer,3.98435830848108,9,0,4,1,9,0,4,3,0,0,4,2,1,1,Commerce,Masters,31-35,13,1,20,Remote,Tier1_City,1,2,0,2,2,4,2,38.9,Other,1,5,5,1,4,3,2,2,5,2,1,1,3,2,64.46
Medicine,Industrial-Organizational Psychologist,2.899790257427523,4,2,0,0,3,0,4,3,2,4,4,1,3,1,Science,Bachelors,18-24,10,0,0,Remote,Tier2_City,4,4,1,1,0,5,4,17.72,Healthcare,5,5,5,3,2,5,3,2,2,4,1,1,5,1,64.1
Psychology,Forensic Psychologist,2.640473311873607,5,2,2,0,9,0,3,4,3,0,0,0,1,1,Arts,Bachelors,25-30,11,1,34,Flexible,Tier2_City,5,2,4,2,0,2,4,7.26,Finance,3,1,3,4,5,4,3,2,2,1,1,0,2,5,46.67
Law,Software Developer,3.814384802281036,0,1,2,1,6,0,3,1,1,2,0,2,2,0,Arts,Bachelors,25-30,2,0,0,Hybrid,Tier1_City,3,1,0,4,3,0,3,19.32,Tech,3,1,3,5,1,1,4,5,4,5,0,1,2,5,48.13
Business,Animator,3.4994414662295625,1,2,1,0,2,0,4,0,0,4,0,3,0,1,Commerce,Bachelors,18-24,0,0,0,Office,Tier1_City,2,3,3,4,1,2,2,10.47,Other,5,2,1,3,2,0,2,2,2,4,0,1,4,2,38.82
Chemistry,Accountant,2.87916873789074,4,1,1,1,4,0,1,1,3,3,4,2,0,1,Science,Bachelors,36-40,13,0,0,Office,Tier3_City,2,1,4,5,3,3,3,48.4,Healthcare,4,5,5,2,1,2,4,3,3,3,1,0,1,4,61.59
Business,Software Developer,2.642087509245593,6,2,4,0,5,1,1,1,3,2,3,1,0,1,Commerce,Bachelors,25-30,7,1,57,Hybrid,Tier1_City,5,3,5,4,2,1,2,30.14,Manufacturing,3,2,1,1,0,0,3,2,3,1,0,0,1,2,45.99
Biology,Music Therapist,3.029942025200154,8,1,0,1,4,1,4,4,3,3,4,4,0,1,Science,Masters,25-30,9,0,0,Flexible,Tier1_City,1,5,2,3,4,4,4,23.99,Tech,2,3,4,3,4,4,5,4,3,3,0,1,2,5,76.67
Marketing,Acoustics Specialist,4.876086531630999,3,1,0,0,0,1,1,4,0,1,3,1,2,0,Commerce,Bachelors,18-24,10,0,0,Remote,Tier1_City,2,3,0,1,2,0,2,45.87,Tech,2,3,5,4,1,0,2,5,3,2,1,1,1,3,55.28
Engineering,Dentist,2.5293963349348525,4,2,2,0,5,0,3,4,4,0,4,0,2,0,Science,Bachelors,25-30,6,0,0,Hybrid,Tier1_City,2,1,2,5,1,1,3,45.32,Other,2,1,1,2,0,3,2,5,4,2,0,1,2,5,55.56
Music,Legal Secretary,4.540195529557735,8,1,0,0,6,0,2,4,3,4,3,3,4,0,Arts,Bachelors,36-40,13,1,55,Flexible,Tier1_City,2,4,0,3,3,4,1,22.54,Finance,5,5,5,4,4,2,5,5,3,2,1,0,3,1,67.11
Medicine,Clinical Psychologist,3.7885744455386567,2,1,0,0,4,0,1,3,2,1,4,2,0,0,Science,PhD,25-30,8,0,0,Hybrid,Tier3_City,2,2,4,2,0,4,1,44.11,Education,3,3,5,4,5,1,5,5,3,4,0,0,3,1,63.42
Computer Science,Architect,2.8965207014484893,4,1,3,1,7,0,4,2,3,2,2,2,2,1,Science,Masters,40+,13,0,0,Remote,Any,5,2,2,1,5,5,2,6.01,Finance,4,5,2,1,1,3,2,1,5,3,0,0,1,4,69.7
Art,AI Researcher,4.121613126174614,1,1,4,1,3,1,4,0,3,0,0,1,3,1,Arts,Masters,36-40,9,0,0,Remote,Tier2_City,3,1,1,4,3,3,3,44.63,Tech,2,5,1,3,4,4,2,2,4,2,0,0,4,3,55.84
Business,Industrial-Organizational Psychologist,3.05185859207412,4,0,0,0,3,0,0,4,0,0,4,4,3,1,Commerce,Bachelors,18-24,3,0,0,Office,Tier1_City,2,2,0,1,1,5,5,17.6,Finance,4,4,5,4,1,2,2,4,4,2,1,1,4,1,42.75
Marketing,Financial Analyst,3.883854464470263,3,2,0,0,1,1,3,1,1,0,0,4,3,1,Commerce,Masters,18-24,11,1,30,Remote,Tier3_City,5,4,5,2,0,5,1,29.56,Education,2,3,3,2,3,4,3,4,2,2,0,1,4,5,49.62
Art,Pharmacist,4.601640873811494,2,2,1,1,6,1,3,3,3,2,3,3,0,0,Arts,High School,36-40,14,1,10,Flexible,Tier1_City,4,2,5,5,2,2,4,15.68,Manufacturing,5,3,3,4,1,4,2,5,2,3,0,0,5,3,58.75
Physics,Interior Designer,4.560622800381563,3,0,1,0,3,0,3,3,4,4,1,4,3,1,Science,Masters,25-30,11,0,0,Remote,Tier1_City,2,5,3,5,4,2,3,49.29,Healthcare,2,2,2,4,1,4,1,4,1,2,0,0,3,1,68.99
Chemistry,Urban Planner,4.575572254977259,8,2,2,0,6,1,1,3,1,0,0,4,0,0,Science,PhD,18-24,4,1,50,Hybrid,Tier1_City,1,3,2,5,4,1,3,6.37,Tech,5,2,5,2,0,2,2,2,3,1,0,0,5,3,44.91
Art,Principal,2.6767125732318817,7,0,4,0,9,0,3,2,4,1,4,0,2,0,Arts,Masters,25-30,4,1,28,Hybrid,Tier2_City,5,5,5,4,3,3,1,24.01,Finance,3,5,1,5,3,3,5,3,3,3,1,0,5,2,60.67
Education,AI Researcher,4.925402781792291,6,1,0,1,1,0,1,1,2,2,4,3,3,1,Arts,Masters,25-30,12,0,0,Hybrid,Tier3_City,1,3,3,3,2,4,5,32.19,Tech,3,1,1,4,2,5,1,4,5,2,1,0,4,3,65.09
Education,Lawyer,4.391040664458849,0,1,0,1,2,0,3,0,4,4,3,2,4,1,Arts,Masters,31-35,6,1,50,Hybrid,Any,3,5,2,3,5,3,4,31.93,Healthcare,4,2,3,2,4,4,5,1,4,3,0,1,5,3,64.94
Computer Science,Nuclear Physicist,3.865452071155015,9,2,3,1,2,0,1,0,1,2,2,0,1,1,Science,Bachelors,18-24,12,0,0,Flexible,Tier2_City,4,2,4,1,5,3,5,37.72,Finance,2,2,4,1,2,1,5,5,4,5,1,0,4,5,52.94
Biology,Urban Planner,4.190757603432731,1,2,4,0,7,0,1,3,0,0,3,1,3,1,Science,PhD,18-24,8,0,0,Office,Tier2_City,1,2,3,4,1,1,4,37.05,Manufacturing,3,5,5,3,2,3,4,3,5,1,0,1,4,5,53.73
Engineering,Actuary,2.6726832193130843,9,0,4,0,8,0,0,0,3,0,0,3,3,0,Science,Bachelors,36-40,7,0,0,Office,Tier1_City,2,4,0,5,4,2,1,40.28,Healthcare,1,3,2,2,3,4,2,3,4,3,1,1,1,1,49.34
Art,Clinical Psychologist,3.196665029484139,9,1,4,0,7,1,3,0,1,2,2,0,4,0,Arts,Bachelors,31-35,6,0,0,Remote,Tier2_City,5,5,1,5,2,3,3,14.01,Education,1,2,2,2,3,2,2,5,5,1,1,1,3,2,42.07
Marketing,Principal,2.7549367598400725,9,0,4,1,4,1,0,1,3,1,0,0,2,1,Commerce,Bachelors,25-30,13,0,0,Remote,Any,4,3,4,2,3,3,4,20.41,Education,4,1,5,3,3,4,2,5,3,4,0,0,4,2,47.86
Psychology,Art Director,2.861391324637033,5,1,2,1,2,1,2,1,2,0,3,1,0,0,Arts,High School,31-35,0,1,14,Remote,Tier1_City,5,3,2,2,0,3,3,20.96,Tech,3,5,5,2,0,4,5,4,3,2,1,1,5,3,31.63
Law,Curriculum Developer,4.770586291151747,7,2,3,0,3,0,2,3,4,2,4,1,2,1,Arts,Bachelors,25-30,11,1,28,Remote,Tier1_City,4,2,0,5,3,0,2,47.92,Education,5,3,2,5,0,0,1,5,5,4,0,0,1,3,72.1
Education,Mechanical Engineer,4.868409058114802,1,2,4,1,3,0,1,2,4,3,0,2,3,1,Arts,Bachelors,31-35,9,1,8,Office,Tier1_City,1,2,2,5,3,3,2,22.24,Finance,1,4,2,1,4,0,2,1,3,4,0,1,4,2,53.97
Music,Teacher,4.505860817448276,8,1,4,0,8,0,3,3,1,1,1,4,4,1,Arts,Bachelors,25-30,12,0,0,Hybrid,Tier2_City,3,2,3,4,2,3,1,13.43,Education,3,1,1,5,3,3,2,2,2,4,0,1,1,1,57.87
Medicine,Zoologist,4.50434019476571,8,0,1,1,9,0,2,0,4,3,2,4,4,1,Science,Masters,18-24,5,1,45,Office,Tier2_City,5,5,3,3,4,4,1,32.72,Manufacturing,5,3,2,4,2,0,1,3,2,3,1,1,2,3,56.55
Art,Physical Chemist,3.040750888229103,9,2,4,0,2,0,0,1,1,3,1,3,1,1,Arts,High School,31-35,9,0,0,Remote,Tier2_City,2,3,1,2,2,5,1,23.08,Other,2,5,3,1,4,2,1,5,1,1,0,0,4,4,33.6
Art,Chemical Engineer,4.576588803844775,5,0,0,1,3,0,4,2,4,1,4,3,3,1,Arts,Bachelors,25-30,14,0,0,Hybrid,Tier3_City,5,5,3,3,0,0,2,14.75,Finance,3,4,2,4,0,0,2,4,5,2,1,1,3,5,70.95
Education,Social Media Manager,4.782754929351167,2,0,2,1,8,0,2,3,0,3,0,3,2,0,Arts,Masters,40+,14,0,0,Flexible,Tier2_City,3,3,4,4,2,3,4,36.61,Other,2,1,2,3,1,2,4,5,4,3,0,1,1,5,59.76
Computer Science,Composer,2.856110417336878,3,0,0,0,4,1,2,2,3,0,0,0,1,1,Science,Bachelors,25-30,8,0,0,Flexible,Tier2_City,1,3,2,5,1,5,5,12.02,Tech,1,2,3,2,1,4,2,1,4,2,0,0,3,2,43.93
Architecture,Astronomer,3.930684998652784,8,2,2,0,0,1,0,3,3,2,1,3,1,0,Interdisciplinary,Masters,36-40,12,0,0,Flexible,Any,2,4,2,3,3,3,1,32.77,Tech,2,2,3,2,4,3,2,5,1,1,1,0,1,5,52.03
Engineering,Physicist,2.6114607911915177,1,2,1,0,5,1,1,4,2,0,4,1,0,0,Science,Masters,36-40,6,0,0,Office,Any,2,2,4,5,4,1,5,23.23,Education,1,1,5,1,0,0,5,1,2,4,0,0,3,1,54.39
Finance,Legal Secretary,3.44920647183552,0,2,4,0,2,0,3,4,4,2,2,4,4,1,Commerce,Masters,18-24,0,1,8,Office,Tier1_City,1,5,3,5,5,1,5,18.0,Education,4,2,2,2,4,0,3,5,5,5,1,1,5,5,67.64
Engineering,Dentist,2.5500076065609827,7,0,4,1,1,0,1,4,1,4,2,1,0,1,Science,Masters,31-35,8,1,19,Flexible,Tier2_City,5,5,3,1,0,5,2,47.46,Tech,4,5,3,2,0,3,2,2,1,2,1,1,5,1,49.77
Finance,Conductor,4.162595539128256,4,0,1,1,9,1,1,1,0,2,0,0,1,1,Commerce,Bachelors,25-30,2,1,51,Office,Tier3_City,2,2,4,3,5,0,4,18.25,Finance,1,1,1,4,3,2,5,4,2,3,0,1,5,2,36.9
Engineering,Illustrator,3.690643229929474,2,1,2,0,6,1,0,1,0,0,3,0,3,1,Science,Masters,36-40,13,0,0,Flexible,Tier1_City,5,5,1,3,3,4,2,19.33,Healthcare,5,1,4,5,1,5,3,1,5,4,0,1,4,1,56.91
Biology,Forensic Psychologist,2.949772046042818,6,2,2,1,5,0,2,1,1,1,1,4,4,1,Science,Bachelors,25-30,8,1,36,Remote,Tier3_City,5,4,0,5,2,0,1,43.92,Tech,4,2,3,2,2,2,5,5,3,2,0,1,2,2,47.91
Engineering,Market Research Analyst,4.346387649527677,8,2,0,1,2,0,3,3,2,0,2,4,4,0,Science,Bachelors,31-35,3,1,41,Flexible,Tier1_City,1,5,0,4,5,0,2,9.07,Manufacturing,5,1,4,4,3,0,5,3,2,3,1,1,3,1,50.0
Computer Science,Web Developer,2.891942322498741,7,2,0,1,7,0,1,0,0,2,1,2,0,0,Science,Masters,25-30,14,0,0,Hybrid,Tier3_City,3,3,3,1,1,1,2,8.08,Finance,5,4,2,5,2,5,4,1,5,2,1,1,4,4,53.1
Business,Astronomer,4.297318646998583,5,0,4,0,8,1,4,4,2,2,1,2,2,0,Commerce,Bachelors,18-24,8,1,31,Remote,Tier1_City,3,2,5,5,2,1,2,16.29,Healthcare,5,1,1,2,4,2,1,2,2,5,1,0,2,2,57.25
Business,Risk Analyst,3.963850774498548,3,1,1,0,7,0,0,3,1,0,0,3,3,0,Commerce,Masters,18-24,12,0,0,Remote,Tier3_City,5,2,0,2,3,4,1,30.81,Healthcare,3,2,1,1,1,2,1,2,2,3,1,0,2,2,48.83
Business,Construction Manager,4.349606666339303,6,2,0,1,2,0,2,0,3,3,4,0,0,1,Commerce,Masters,25-30,14,0,0,Flexible,Tier1_City,1,4,0,2,5,3,1,21.06,Finance,3,2,5,1,2,0,5,3,1,3,1,1,2,3,60.18
Law,Financial Analyst,4.022824911187139,0,2,3,1,9,0,3,2,0,3,2,1,0,1,Arts,Masters,31-35,7,0,0,Hybrid,Tier1_City,3,5,5,1,0,4,2,31.6,Tech,5,2,5,1,5,0,1,5,3,3,0,1,4,1,50.63
Architecture,Art Director,3.202476998720442,1,0,4,1,0,0,0,3,0,1,4,0,0,1,Interdisciplinary,PhD,31-35,6,0,0,Flexible,Tier1_City,5,3,0,4,5,3,2,10.51,Healthcare,1,2,2,3,4,0,2,5,5,1,0,1,5,2,58.5
Music,Construction Manager,3.292961689642132,6,1,0,1,1,1,1,3,0,4,1,1,3,0,Arts,Bachelors,31-35,3,1,19,Remote,Tier1_City,2,1,3,5,5,5,5,15.29,Manufacturing,4,5,3,1,0,1,4,5,2,2,0,0,5,1,37.93
Medicine,Entrepreneur,4.712730374997161,6,1,3,0,0,1,4,1,1,0,1,0,1,0,Science,Bachelors,25-30,8,0,0,Hybrid,Any,2,3,2,3,4,5,4,29.56,Other,2,2,1,2,3,0,4,5,4,1,0,0,1,2,47.89
Education,Teacher,2.625631303788192,8,1,0,1,6,0,3,1,3,2,3,3,1,1,Arts,Masters,25-30,3,0,0,Hybrid,Tier1_City,4,3,3,1,5,2,5,13.21,Finance,3,4,2,2,0,5,1,5,3,2,1,1,2,1,54.5
Architecture,Brand Manager,3.593251044195589,2,0,0,0,4,1,4,2,3,4,3,2,1,1,Interdisciplinary,Bachelors,18-24,0,1,30,Hybrid,Tier2_City,4,5,3,4,3,1,4,22.87,Education,3,1,2,1,3,1,1,3,2,5,0,1,5,2,51.26
Engineering,Nurse,2.8571405228801057,3,0,3,1,2,1,4,0,0,2,2,0,4,0,Science,Masters,36-40,5,1,45,Hybrid,Tier2_City,4,1,5,3,0,2,4,29.91,Other,2,3,3,1,1,4,4,2,4,2,1,1,4,4,43.84
Finance,Nuclear Physicist,4.8655602128517454,6,0,3,0,3,1,0,0,1,4,2,4,0,0,Commerce,Masters,40+,3,0,0,Office,Tier1_City,3,4,1,2,3,2,2,48.76,Tech,5,3,1,4,2,2,5,3,1,4,0,0,3,3,46.19
Physics,Physical Chemist,4.215043534666422,7,2,1,0,0,0,3,2,2,4,1,3,1,0,Science,Masters,25-30,9,0,0,Remote,Tier1_City,2,5,1,2,1,1,5,6.75,Finance,2,5,1,5,0,1,5,4,5,5,0,0,5,3,74.6
Architecture,Composer,3.8249246697037873,1,0,0,0,0,1,2,0,2,3,3,0,3,1,Interdisciplinary,Bachelors,18-24,2,0,0,Remote,Tier1_City,2,2,3,3,2,2,4,24.64,Manufacturing,5,3,1,1,0,4,5,4,3,3,0,0,3,5,40.19
Business,Financial Analyst,3.672075580036572,1,2,4,0,2,0,4,2,3,3,0,0,0,0,Commerce,Bachelors,18-24,11,0,0,Remote,Tier2_City,3,1,4,1,5,0,4,21.62,Other,3,2,5,4,2,5,2,1,3,3,0,1,4,4,60.0
Psychology,Physician Assistant,3.751205743317862,2,0,2,1,0,1,3,1,3,3,4,2,3,1,Arts,Bachelors,31-35,4,0,0,Flexible,Any,2,2,4,2,4,3,1,41.74,Other,2,3,1,2,2,2,5,5,5,5,0,0,2,1,64.2
Finance,Music Therapist,4.217551390242703,5,1,2,0,1,0,2,3,1,1,4,2,0,0,Commerce,Bachelors,31-35,2,0,0,Hybrid,Tier3_City,2,1,1,5,0,4,4,45.31,Healthcare,1,4,4,1,4,2,5,2,2,1,0,1,3,4,34.65
Physics,Animator,4.611452588301064,7,0,3,0,2,0,2,3,3,4,2,4,2,0,Science,Masters,31-35,10,1,38,Hybrid,Any,5,2,5,3,4,1,2,45.63,Tech,4,2,3,4,3,2,1,1,5,3,0,1,3,1,77.05
Education,Interior Designer,2.691639600497825,7,0,3,1,5,1,4,2,1,2,0,4,0,1,Arts,Bachelors,25-30,8,1,58,Hybrid,Tier2_City,2,5,1,3,4,0,3,20.63,Tech,4,3,1,4,5,5,3,4,5,2,1,0,4,2,59.27
Finance,Biomedical Engineer,4.135142117179857,8,1,1,0,6,0,4,2,0,3,1,3,4,0,Commerce,Bachelors,31-35,11,0,0,Office,Any,5,1,2,2,4,5,1,17.32,Finance,4,2,3,5,5,3,5,1,3,3,0,1,2,3,61.97
Computer Science,Human Resources Specialist,4.783699571704188,2,1,2,0,3,0,0,0,2,0,1,0,1,1,Science,High School,31-35,5,0,0,Remote,Tier1_City,4,4,1,1,5,4,3,24.11,Finance,2,5,3,2,4,3,5,4,2,3,0,1,5,5,35.25
Psychology,Music Therapist,4.875998425165146,0,0,4,0,4,1,4,1,2,4,3,2,1,1,Arts,Masters,25-30,14,0,0,Remote,Tier2_City,1,5,5,5,0,4,2,19.17,Manufacturing,5,4,4,5,0,1,3,4,5,2,1,0,5,4,66.87
Architecture,Physical Chemist,4.702111989038933,6,1,0,0,2,1,3,4,4,4,4,3,4,0,Interdisciplinary,Masters,25-30,2,0,0,Office,Tier1_City,5,1,0,1,0,4,3,36.79,Education,3,1,1,5,2,1,5,3,2,3,1,0,2,3,61.86
Finance,Market Research Analyst,2.723271848435661,3,2,3,0,1,1,4,2,3,4,0,0,2,1,Commerce,Bachelors,18-24,4,0,0,Flexible,Tier1_City,2,2,3,4,4,2,4,13.04,Finance,4,2,3,5,1,2,3,1,1,2,1,0,2,4,44.87
Law,Paralegal,3.927839507778697,4,2,1,0,2,1,4,4,1,1,2,2,0,0,Arts,Bachelors,25-30,7,0,0,Hybrid,Tier3_City,4,3,3,4,2,2,3,33.96,Other,2,4,1,2,0,4,3,4,3,3,1,0,4,3,53.81
Law,Organic Chemist,2.9684741186883365,1,0,0,1,4,1,1,4,3,0,1,3,2,1,Arts,Bachelors,36-40,13,0,0,Remote,Tier1_City,1,1,5,2,5,2,5,46.57,Finance,4,5,4,1,0,1,5,2,3,4,0,0,5,3,61.71
Marketing,Psychologist,3.0749406216920026,8,1,3,0,1,1,1,0,3,1,1,4,0,1,Commerce,Bachelors,25-30,7,0,0,Hybrid,Tier3_City,1,5,3,2,5,2,2,16.16,Finance,5,5,5,5,5,0,2,4,1,2,1,1,5,3,49.93
Finance,Illustrator,3.3162325260733136,0,1,2,0,0,1,0,4,0,4,4,1,2,0,Commerce,Masters,36-40,5,0,0,Flexible,Tier2_City,4,2,5,2,3,0,5,34.81,Manufacturing,1,4,5,3,3,5,5,3,5,3,0,0,1,4,60.38
Medicine,Web Developer,3.138437399299544,6,0,3,1,8,0,0,4,0,0,1,2,4,1,Science,Masters,25-30,4,0,0,Hybrid,Tier1_City,4,5,2,4,5,2,3,9.75,Healthcare,1,3,5,2,4,0,2,1,1,1,1,1,3,1,36.94
Education,Digital Marketing Specialist,4.891329289731784,8,1,2,0,4,0,3,0,2,1,0,0,4,1,Arts,Bachelors,18-24,14,0,0,Hybrid,Tier1_City,1,2,2,1,4,1,5,8.71,Education,3,4,5,4,5,1,5,4,1,4,0,1,1,5,49.95
Physics,Judge,3.1201946475158904,6,1,2,1,7,0,3,0,1,1,4,3,1,1,Science,Bachelors,25-30,4,0,0,Hybrid,Tier1_City,1,5,0,1,1,4,1,8.44,Manufacturing,1,3,2,4,3,4,2,5,3,4,0,0,4,3,52.87
Education,Principal,3.6098870274549375,9,2,2,1,8,1,4,4,0,2,2,4,1,1,Arts,PhD,25-30,0,0,0,Flexible,Any,2,1,3,2,4,0,3,9.51,Finance,1,3,3,2,0,0,5,5,4,1,1,0,1,4,53.54
Business,Judge,3.682382271147315,3,0,4,0,7,0,0,3,4,2,4,1,3,0,Commerce,Bachelors,25-30,1,0,0,Office,Tier2_City,5,1,0,5,0,5,5,13.16,Healthcare,2,4,2,4,2,2,4,4,3,4,0,0,2,1,48.39
Art,Legal Consultant,3.0235274005910373,1,1,3,0,7,1,1,2,1,2,4,3,0,0,Arts,Masters,18-24,14,0,0,Office,Tier2_City,5,1,1,1,5,2,4,29.45,Finance,2,5,1,2,1,2,4,1,1,2,1,0,3,3,60.06
Architecture,School Counselor,3.4322284809435173,6,2,2,1,6,1,2,0,0,1,1,4,2,1,Interdisciplinary,Bachelors,25-30,11,0,0,Remote,Tier1_City,1,2,3,4,5,5,3,39.05,Manufacturing,3,1,5,1,3,3,3,3,3,4,0,1,3,1,55.64
Marketing,Psychologist,3.694943359743807,9,0,0,1,8,1,4,2,3,2,3,4,4,1,Commerce,Bachelors,18-24,10,0,0,Hybrid,Tier1_City,1,4,0,3,3,4,1,8.96,Tech,3,1,1,2,5,3,1,2,4,5,0,1,4,1,70.63
Physics,Accountant,3.4232328774062903,2,0,2,1,0,1,2,4,3,0,0,0,4,1,Science,High School,18-24,3,1,27,Hybrid,Tier1_City,3,5,2,3,1,0,4,43.89,Finance,2,4,4,1,0,3,4,1,1,3,1,1,4,2,32.11
Business,Marketing Specialist,4.544462917400894,2,0,3,1,8,1,3,2,4,0,1,1,0,0,Commerce,Bachelors,25-30,5,0,0,Remote,Tier3_City,1,4,5,3,5,4,3,42.61,Healthcare,1,2,3,2,5,5,4,3,3,4,0,1,3,2,51.32
Engineering,Web Developer,4.138399469612106,9,1,4,1,3,1,4,2,2,2,1,4,0,1,Science,PhD,25-30,10,0,0,Flexible,Tier1_City,5,4,2,5,3,5,4,37.19,Education,5,4,4,5,5,4,5,4,5,3,0,0,4,5,72.91
Medicine,Risk Analyst,2.836240277389168,1,2,0,0,2,1,3,4,1,1,0,1,2,1,Science,Bachelors,36-40,6,1,24,Hybrid,Tier2_City,2,4,2,2,3,0,3,23.02,Tech,1,1,3,3,4,2,1,2,1,3,1,1,3,4,42.29
Chemistry,Special Education Teacher,3.271178761335612,4,2,0,0,2,1,3,1,1,2,2,2,4,0,Science,High School,25-30,0,1,45,Remote,Tier2_City,3,3,5,4,1,3,3,3.07,Finance,1,4,4,1,3,4,5,1,4,2,0,0,3,1,33.81
Engineering,Industrial-Organizational Psychologist,4.758618288778757,4,0,3,1,2,1,2,1,0,0,2,3,2,1,Science,High School,31-35,7,0,0,Flexible,Tier1_City,5,5,0,5,4,0,2,37.53,Finance,5,5,4,3,0,0,5,4,3,2,0,1,5,1,45.25
Chemistry,Civil Engineer,2.814414780000808,5,2,1,1,4,1,2,3,0,0,0,1,2,1,Science,Bachelors,25-30,11,1,46,Remote,Tier2_City,2,3,0,4,4,2,5,44.31,Healthcare,3,1,3,4,4,2,3,2,1,4,1,1,2,4,48.7
Marketing,Investment Banker,3.3778674070320003,7,1,2,1,3,1,3,4,3,0,3,2,0,1,Commerce,Bachelors,31-35,0,0,0,Office,Tier3_City,3,5,0,4,4,5,3,18.76,Tech,2,1,1,1,4,3,5,4,3,5,1,1,3,3,48.76
Art,Animator,4.373364486385287,5,2,3,1,7,1,0,2,4,1,3,3,4,1,Arts,High School,25-30,8,1,9,Office,Tier1_City,3,3,4,2,2,4,1,36.75,Tech,3,1,4,4,1,5,5,5,2,5,1,0,1,4,52.77
Business,Architectural Technologist,3.316372576907834,0,1,4,0,9,1,2,1,2,2,0,1,3,0,Commerce,Masters,36-40,14,0,0,Flexible,Tier2_City,3,5,3,3,4,4,5,5.92,Tech,3,5,3,5,2,3,3,5,1,2,1,1,3,5,53.64
Marketing,Education Administrator,4.053464586126592,5,2,3,0,2,1,0,0,0,3,4,3,2,1,Commerce,Bachelors,25-30,3,1,10,Office,Tier3_City,3,1,4,2,1,4,2,36.35,Finance,3,1,3,5,1,5,5,3,1,2,0,1,5,5,40.32
Art,Civil Engineer,2.551045526973564,4,0,2,0,3,1,3,3,1,4,3,1,2,0,Arts,Bachelors,36-40,11,1,34,Office,Tier1_City,3,4,4,5,2,1,5,6.21,Tech,2,2,4,1,4,0,1,2,2,1,1,1,3,5,52.09
Physics,Acoustics Specialist,4.828666664154608,9,2,0,0,3,1,3,4,2,0,2,3,2,0,Science,PhD,25-30,14,0,0,Hybrid,Tier1_City,3,2,5,5,4,1,5,30.6,Finance,3,1,1,1,3,2,3,5,3,3,1,1,3,4,67.72
Business,Composer,3.0612371170359336,4,0,0,0,3,0,0,4,1,1,0,0,4,0,Commerce,Bachelors,18-24,6,1,57,Hybrid,Tier1_City,4,4,1,5,2,2,3,31.09,Finance,3,4,5,3,5,4,4,4,5,3,1,0,5,4,47.77
Marketing,AI Researcher,3.259599735439698,0,1,4,1,9,0,2,0,1,1,4,1,0,1,Commerce,PhD,31-35,10,0,0,Flexible,Any,2,5,1,2,1,3,1,17.2,Other,4,2,2,4,2,4,5,3,5,3,1,0,2,2,62.96
Finance,School Psychologist,4.309167055115788,7,1,0,0,0,1,0,4,0,0,3,2,0,0,Commerce,Bachelors,18-24,13,0,0,Remote,Tier1_City,5,2,2,4,4,1,3,6.72,Tech,1,3,5,3,4,0,1,5,5,1,0,1,4,3,51.94
Computer Science,Industrial-Organizational Psychologist,3.918066978523295,4,1,4,1,9,0,3,4,3,3,2,3,1,0,Science,Masters,25-30,5,0,0,Office,Tier1_City,1,4,5,4,0,0,1,47.62,Manufacturing,4,1,4,1,2,5,2,3,2,3,0,0,5,2,54.85
Psychology,Counselor,4.642337314840869,7,0,4,1,9,1,3,3,4,2,2,4,4,1,Arts,Masters,18-24,14,1,24,Remote,Tier1_City,5,5,4,1,5,5,1,28.17,Education,2,3,4,3,3,2,3,2,4,5,1,0,4,5,78.22
Marketing,Clinical Psychologist,3.026213686610953,1,0,1,0,8,0,3,3,0,3,3,2,2,1,Commerce,Masters,31-35,12,0,0,Remote,Tier1_City,4,4,1,5,1,2,4,30.25,Education,5,3,3,1,0,4,3,5,1,3,0,0,4,4,54.63
Music,Software Developer,3.460838333890414,5,2,1,1,1,0,0,1,3,0,4,4,1,1,Arts,PhD,40+,8,0,0,Remote,Tier1_City,4,5,4,4,3,3,3,31.91,Manufacturing,5,5,1,2,0,3,5,5,4,2,0,1,1,5,62.21
Psychology,Ecologist,4.086077671033578,8,0,3,1,7,0,2,4,2,2,0,0,2,1,Arts,Bachelors,25-30,13,0,0,Remote,Tier2_City,3,3,3,1,3,0,2,44.88,Tech,4,4,1,4,4,3,5,1,1,1,1,0,3,4,50.06
Finance,Brand Manager,4.216357434482605,3,2,4,0,3,1,3,2,1,3,1,4,0,1,Commerce,PhD,36-40,1,0,0,Flexible,Tier1_City,4,3,4,4,1,4,5,5.83,Finance,4,4,4,5,4,4,3,1,4,4,1,1,4,2,60.39
Finance,Cybersecurity Analyst,3.666988702344504,4,2,3,1,0,1,1,1,3,4,4,1,0,1,Commerce,Bachelors,25-30,14,0,0,Flexible,Tier3_City,5,1,2,5,3,1,4,44.98,Healthcare,4,3,1,5,1,5,5,2,4,2,0,0,4,3,60.7
Music,School Counselor,4.74296977693581,8,1,2,0,1,0,2,3,1,0,2,1,0,1,Arts,Bachelors,25-30,14,1,37,Hybrid,Any,4,2,0,3,1,0,2,14.26,Manufacturing,1,5,2,3,4,2,5,2,2,1,1,0,4,3,46.45
Finance,Chemical Engineer,4.471425041374724,6,1,2,1,5,0,2,0,4,0,0,2,3,0,Commerce,Bachelors,36-40,10,1,19,Office,Tier2_City,5,3,2,5,0,3,3,6.66,Education,2,2,1,5,0,4,1,1,2,3,0,1,1,3,48.29
Education,Risk Analyst,2.6399674480363995,9,0,0,1,9,1,1,0,3,2,0,2,1,1,Arts,Bachelors,36-40,6,0,0,Hybrid,Any,3,5,4,2,1,2,1,33.89,Education,3,1,1,2,0,0,1,5,4,3,1,1,5,2,46.15
Chemistry,Art Therapist,3.083376708680133,7,1,2,0,7,0,3,4,3,2,2,2,0,1,Science,Bachelors,31-35,10,0,0,Office,Tier2_City,3,4,5,4,4,0,3,48.92,Finance,4,2,3,2,1,2,1,3,1,5,0,1,4,2,64.24
Physics,Artist,3.3601788267132315,3,1,4,1,5,1,3,2,0,4,0,4,3,1,Science,Masters,25-30,4,0,0,Office,Tier2_City,4,1,4,4,4,2,3,5.69,Education,1,1,4,3,5,4,4,2,3,3,0,1,2,4,52.09
Engineering,Illustrator,4.185927471061738,6,1,1,1,3,0,0,4,3,4,0,0,2,0,Science,Bachelors,25-30,12,0,0,Remote,Tier1_City,1,4,0,2,2,4,4,23.03,Education,5,3,1,5,3,3,3,1,4,3,0,1,1,5,61.15
Finance,Nuclear Physicist,2.8239598153946504,5,1,3,1,9,1,4,4,2,0,1,1,1,1,Commerce,Masters,18-24,6,0,0,Hybrid,Tier1_City,3,4,2,2,3,3,2,27.9,Finance,5,5,4,5,2,2,3,3,2,3,1,0,2,2,56.01
Architecture,Principal,3.826101895765585,4,1,4,1,3,0,4,2,1,0,3,0,4,0,Interdisciplinary,Masters,25-30,0,0,0,Hybrid,Tier1_City,2,2,2,3,5,3,4,14.85,Tech,5,5,1,1,0,1,5,1,1,3,0,1,5,5,40.44
Chemistry,Financial Analyst,2.565122962762307,8,0,4,1,6,0,3,0,4,1,2,4,4,1,Science,Bachelors,25-30,10,0,0,Flexible,Tier1_City,2,4,4,4,3,1,2,49.19,Other,4,4,1,3,2,2,5,4,3,5,0,0,2,5,67.5
Medicine,Doctor,2.977122997489792,2,2,4,1,2,0,4,4,1,4,4,2,0,0,Science,Bachelors,36-40,10,0,0,Office,Tier3_City,3,2,3,4,1,5,4,33.13,Education,5,4,1,1,4,3,3,5,4,5,1,1,3,5,68.79
Architecture,Analytical Chemist,4.431203229024433,3,1,2,0,7,0,0,0,2,3,1,1,4,0,Interdisciplinary,Bachelors,36-40,9,1,46,Flexible,Tier1_City,4,5,5,3,5,3,5,42.68,Other,5,2,3,2,4,2,5,3,2,3,1,0,2,5,48.55
Finance,Music Teacher,3.323625073947083,0,2,2,0,7,1,1,3,1,0,2,2,2,1,Commerce,Bachelors,25-30,8,1,30,Office,Tier1_City,3,4,5,1,5,0,1,22.54,Other,5,4,1,3,5,0,1,1,5,5,1,0,2,1,58.64
Psychology,Astronomer,4.512344350811591,5,0,4,0,4,0,4,1,4,3,1,0,2,0,Arts,Bachelors,18-24,0,0,0,Hybrid,Any,4,4,1,3,3,0,1,19.64,Tech,3,1,5,1,3,3,2,3,1,5,0,0,2,1,40.87
Computer Science,School Psychologist,3.843155127748057,4,1,0,1,1,1,0,3,2,4,0,1,1,0,Science,Bachelors,36-40,13,0,0,Flexible,Tier2_City,5,4,4,5,5,0,1,29.0,Healthcare,5,5,2,2,5,3,4,4,3,2,0,0,1,1,52.82
Biology,Data Scientist,4.803437044793851,6,1,0,1,1,0,3,4,4,2,0,1,2,1,Science,Bachelors,18-24,4,0,0,Hybrid,Tier2_City,1,5,4,4,5,4,5,23.46,Tech,1,5,1,5,2,5,1,4,2,4,0,0,5,5,53.89
Computer Science,Graphic Designer,4.33835016757535,3,2,2,1,0,1,0,3,3,0,1,2,4,0,Science,PhD,31-35,13,1,50,Hybrid,Tier1_City,1,3,5,2,4,3,5,36.6,Finance,4,3,5,3,0,0,1,5,5,4,1,0,3,3,67.08
Art,Legal Secretary,4.359511978599652,1,1,4,1,4,1,3,0,0,1,2,3,2,1,Arts,Masters,18-24,7,0,0,Office,Any,5,3,1,5,0,3,1,15.49,Finance,3,3,4,1,1,1,5,1,4,4,0,0,5,1,51.94
Biology,Chemical Engineer,4.063046670779596,0,2,3,0,4,0,1,1,3,0,1,0,4,1,Science,Bachelors,25-30,0,1,7,Remote,Tier1_City,5,5,0,4,1,0,1,24.13,Finance,3,2,3,4,0,2,4,1,1,5,0,0,2,3,31.12
Music,Credit Analyst,3.390864676071935,8,0,1,1,6,1,1,4,1,2,2,2,2,1,Arts,Masters,40+,6,0,0,Hybrid,Tier2_City,5,1,4,3,3,1,2,45.07,Education,4,3,4,5,2,0,2,1,3,4,0,0,2,1,58.01
Psychology,Art Therapist,3.3175442628393967,6,1,1,0,0,0,1,3,0,1,2,1,3,0,Arts,Bachelors,18-24,1,0,0,Hybrid,Tier2_City,1,1,3,5,4,1,2,38.54,Manufacturing,5,1,3,1,2,2,2,2,2,2,0,1,2,1,32.92
Law,Conductor,3.138475980734147,2,0,3,1,4,0,3,2,4,2,0,0,3,1,Arts,Bachelors,25-30,6,0,0,Hybrid,Tier2_City,3,2,0,4,2,3,3,10.9,Education,5,4,4,1,0,2,5,5,4,4,1,1,4,5,52.44
Education,School Psychologist,3.1460834850634587,1,2,4,1,2,1,0,3,1,1,1,1,3,0,Arts,Masters,25-30,6,0,0,Flexible,Any,2,5,0,1,5,3,4,44.68,Tech,2,4,4,3,0,1,4,4,2,3,0,1,5,1,49.88
Chemistry,Advertising Manager,4.213992133003012,4,1,1,0,6,0,4,2,1,0,1,3,2,1,Science,Bachelors,36-40,8,0,0,Flexible,Tier1_City,4,1,0,1,5,2,2,30.68,Healthcare,5,2,2,4,3,2,1,5,5,5,1,0,3,4,63.71
Medicine,Principal,3.1085729649839013,9,0,4,0,0,0,3,0,4,1,4,1,2,0,Science,Bachelors,36-40,5,0,0,Hybrid,Tier3_City,2,2,4,2,3,3,2,34.93,Healthcare,1,4,2,5,4,5,1,2,4,3,1,0,2,3,60.37
Finance,Web Developer,3.449015344171404,8,1,4,0,6,1,4,3,1,4,4,4,3,0,Commerce,PhD,18-24,3,1,19,Hybrid,Tier2_City,4,4,5,4,0,0,2,16.83,Healthcare,5,5,2,5,5,0,3,1,2,1,1,1,3,3,58.27
Music,Zoologist,4.647474894702985,8,2,1,0,7,1,2,0,4,2,2,2,3,1,Arts,Masters,18-24,6,0,0,Office,Tier2_City,1,4,0,1,0,5,2,23.75,Other,4,4,4,3,3,2,1,4,1,5,0,1,1,4,53.97
Chemistry,Special Education Teacher,4.547693908743774,3,1,0,0,6,1,3,0,1,2,1,0,2,1,Science,Masters,31-35,6,0,0,Hybrid,Any,3,1,2,3,3,4,5,40.92,Healthcare,5,3,3,3,0,2,2,1,1,3,0,0,4,5,42.55
Architecture,Musician,4.772453481179042,0,2,0,1,2,0,4,3,1,0,0,1,1,0,Interdisciplinary,Masters,25-30,3,0,0,Remote,Tier2_City,2,2,4,4,3,3,3,18.54,Other,4,5,2,3,0,1,2,2,3,1,1,1,5,4,42.5
Psychology,Geneticist,2.827753750721669,4,1,4,1,8,0,2,3,2,4,1,1,2,1,Arts,Masters,31-35,1,0,0,Office,Tier3_City,5,2,4,3,4,3,2,10.76,Manufacturing,3,3,3,4,1,2,4,2,1,2,1,0,5,3,46.75
Psychology,Sound Engineer,4.8067514263423154,7,1,3,1,0,1,4,3,1,3,1,4,4,1,Arts,Bachelors,18-24,12,0,0,Office,Tier1_City,5,3,1,3,3,0,4,20.78,Healthcare,2,3,3,3,4,3,1,1,1,3,1,0,3,4,57.78
Engineering,Legal Analyst,4.714535122220984,6,0,4,1,5,0,1,1,4,3,3,2,2,0,Science,Bachelors,18-24,10,0,0,Remote,Tier3_City,5,1,5,1,2,2,2,6.25,Other,3,2,1,4,5,4,1,1,3,4,0,1,2,1,60.4
Art,Market Research Analyst,3.378185865659905,8,2,2,1,8,0,0,3,3,1,4,1,4,1,Arts,High School,31-35,8,0,0,Office,Tier3_City,2,3,0,4,4,5,5,36.74,Education,4,2,5,4,5,5,1,3,4,2,0,1,4,2,56.24
Finance,Ecologist,4.808933208196011,0,1,2,0,3,0,4,1,2,4,2,0,2,1,Commerce,Bachelors,18-24,13,0,0,Hybrid,Any,3,5,4,5,5,3,1,9.94,Healthcare,2,5,4,2,1,3,2,4,2,2,1,1,3,1,54.12
Medicine,Fluid Mechanics Engineer,3.748767913260715,3,0,0,1,7,0,2,2,1,1,0,1,4,0,Science,Bachelors,36-40,7,0,0,Remote,Any,3,2,5,1,5,1,1,16.4,Finance,3,4,5,3,4,1,2,4,4,1,1,0,1,5,44.6
Engineering,Financial Controller,3.051031028461014,3,0,2,1,1,1,0,4,0,2,1,1,3,1,Science,Bachelors,18-24,4,0,0,Office,Tier1_City,5,3,3,1,5,1,3,44.41,Tech,5,1,4,3,4,5,5,5,2,3,0,1,3,5,44.33
Psychology,Mechanical Engineer,4.821562014946679,1,1,2,0,0,0,1,2,3,0,0,2,3,0,Arts,PhD,18-24,13,1,33,Remote,Tier2_City,2,2,3,4,5,1,1,28.4,Education,5,4,3,5,2,2,3,5,1,4,0,1,2,4,59.49
Education,Nurse,4.980927011469088,4,1,1,0,0,1,0,2,4,0,2,0,4,0,Arts,PhD,40+,4,0,0,Remote,Any,5,5,5,4,1,4,2,18.1,Manufacturing,2,5,5,3,4,0,1,2,5,5,1,0,3,1,59.66
Marketing,Dentist,4.72479522847457,3,2,4,1,6,0,1,3,1,2,3,3,2,0,Commerce,Masters,25-30,0,1,42,Office,Tier2_City,4,3,4,3,2,4,5,28.74,Education,3,1,1,4,5,2,5,4,3,5,0,0,5,4,54.32
Chemistry,Animator,4.29642247935664,2,0,0,0,5,0,3,3,0,4,4,1,3,1,Science,Bachelors,31-35,10,0,0,Flexible,Tier2_City,4,5,4,4,4,5,3,13.26,Finance,1,3,5,3,0,5,4,2,4,3,0,1,2,2,65.91
Chemistry,Acoustics Specialist,2.9593887169799467,5,2,0,0,2,1,1,4,1,0,0,3,3,1,Science,Masters,18-24,8,0,0,Remote,Tier1_City,2,2,3,3,4,3,2,4.18,Healthcare,1,3,5,1,4,2,1,1,2,3,1,1,3,1,49.33
Psychology,Physician Assistant,4.456539936466184,5,1,4,0,8,1,2,2,3,4,2,2,1,0,Arts,Bachelors,31-35,10,0,0,Flexible,Tier1_City,4,2,3,1,5,3,1,31.38,Healthcare,1,1,1,5,3,1,1,4,5,1,1,0,3,1,65.02
Marketing,Web Developer,4.835812860904177,2,0,3,0,6,1,0,0,0,4,1,4,4,1,Commerce,Masters,31-35,13,0,0,Remote,Tier2_City,1,4,2,2,0,3,4,36.56,Manufacturing,3,3,1,1,2,2,5,2,2,5,1,0,3,5,50.75
Education,Biochemist,4.477233747705307,7,2,0,1,2,1,4,4,1,3,3,3,3,0,Arts,Bachelors,25-30,9,0,0,Remote,Tier3_City,1,2,3,5,4,4,2,44.35,Tech,3,4,2,4,1,0,3,3,3,4,0,1,5,2,71.24
Physics,Industrial-Organizational Psychologist,3.241098860099086,1,0,0,1,3,0,3,4,2,3,3,4,3,0,Science,Masters,36-40,10,0,0,Remote,Tier2_City,1,4,2,1,2,5,4,39.28,Healthcare,3,2,4,1,5,0,4,3,4,4,0,0,5,2,74.1
Medicine,Inorganic Chemist,3.566940450574104,8,2,3,1,0,1,2,3,4,1,0,4,1,0,Science,Bachelors,31-35,7,0,0,Remote,Tier1_City,4,5,4,4,3,3,4,46.55,Other,4,4,3,4,4,4,4,4,3,4,1,0,3,5,57.34
Education,Music Therapist,4.177935245304035,9,0,1,0,8,1,1,0,3,0,0,2,0,1,Arts,Masters,25-30,4,0,0,Hybrid,Tier2_City,3,1,0,5,2,0,3,49.34,Manufacturing,1,3,5,5,1,4,4,4,4,1,0,1,4,1,44.43
Medicine,Biochemist,2.62717681832054,8,0,4,1,5,1,2,3,2,3,3,2,0,1,Science,PhD,25-30,9,1,52,Flexible,Any,1,5,5,2,5,2,5,38.01,Healthcare,1,2,5,2,0,2,2,5,3,4,1,0,1,2,71.72
Computer Science,School Counselor,4.344768245042317,5,0,2,1,2,0,4,0,3,4,1,3,1,1,Science,Bachelors,25-30,5,1,16,Remote,Tier2_City,5,4,5,2,5,1,1,43.79,Other,1,4,3,1,1,0,3,4,4,4,0,0,4,3,56.93
Art,Animator,3.789357975421558,1,1,0,0,1,0,1,3,3,0,0,0,4,1,Arts,Bachelors,18-24,11,0,0,Hybrid,Any,3,1,5,3,1,1,1,34.67,Education,4,3,1,5,4,2,1,5,1,5,1,1,1,2,49.35
Biology,Fluid Mechanics Engineer,3.928642963039576,4,0,2,0,7,0,2,0,3,3,3,2,0,1,Science,PhD,25-30,9,0,0,Office,Tier1_City,2,4,0,5,4,0,2,11.03,Manufacturing,4,4,1,2,1,3,3,3,4,4,1,1,3,5,67.89
Medicine,Architectural Technologist,4.028341072084936,7,1,0,1,3,0,0,4,0,4,2,3,3,1,Science,Bachelors,25-30,10,0,0,Hybrid,Any,4,2,1,3,4,3,1,11.54,Manufacturing,3,3,5,4,0,1,3,3,1,3,0,0,2,2,55.82
Music,Cybersecurity Analyst,4.298201953119278,5,2,0,1,5,1,1,2,2,1,2,4,4,0,Arts,Masters,25-30,9,0,0,Office,Tier3_City,5,4,5,1,4,5,3,8.18,Manufacturing,1,5,5,4,4,1,3,3,5,3,1,0,5,2,64.0
Finance,Civil Engineer,2.9834533970070503,9,0,4,1,5,1,3,2,2,0,2,2,2,0,Commerce,Masters,31-35,7,1,51,Hybrid,Any,2,1,2,5,5,5,1,47.32,Healthcare,1,1,3,2,1,0,3,1,4,2,0,0,4,5,60.32
Computer Science,Market Research Analyst,3.6091768019156296,0,0,2,1,8,0,3,1,3,4,0,4,4,0,Science,Bachelors,25-30,5,0,0,Remote,Tier3_City,4,4,3,1,4,4,2,34.62,Manufacturing,5,3,3,5,1,3,3,4,2,1,1,1,5,5,49.91
Marketing,Chemist,4.764517565274288,4,2,0,1,9,0,2,0,1,0,1,1,2,0,Commerce,Bachelors,36-40,9,0,0,Office,Tier1_City,4,3,2,3,0,3,1,40.13,Education,5,4,4,2,0,0,2,3,4,5,1,0,5,3,50.25
Psychology,Musician,2.7517804605326184,9,0,2,1,7,1,4,1,3,4,4,3,1,1,Arts,Bachelors,25-30,13,0,0,Remote,Any,5,3,1,5,0,5,5,18.56,Tech,5,3,1,1,3,3,5,5,4,2,1,0,5,1,62.79
Music,Chemist,3.719079250805738,1,1,2,0,7,0,0,3,4,0,1,3,3,0,Arts,Masters,25-30,3,1,13,Remote,Tier2_City,4,5,1,3,3,3,4,24.64,Tech,4,3,2,2,3,5,3,5,5,2,0,1,1,3,49.73
Finance,Music Therapist,2.935321342842081,1,2,2,1,8,1,0,2,3,1,3,1,1,1,Commerce,Bachelors,31-35,2,0,0,Hybrid,Tier1_City,4,5,2,5,4,1,4,4.87,Finance,3,4,2,3,2,0,1,2,2,1,0,0,2,3,37.37
Art,Chemist,4.342861639465627,2,2,0,0,5,1,2,1,0,0,1,0,3,1,Arts,Bachelors,25-30,6,0,0,Hybrid,Tier1_City,4,1,3,3,1,1,4,44.78,Education,2,4,3,1,0,4,3,2,1,1,1,1,3,1,26.4
Marketing,Organic Chemist,4.56814178330513,1,0,2,1,5,0,3,3,1,0,2,2,1,0,Commerce,Bachelors,25-30,12,0,0,Office,Tier1_City,3,4,4,2,3,4,5,43.09,Education,1,2,4,5,3,2,4,1,4,2,1,1,4,1,61.32
Finance,Social Media Manager,2.9704679073900304,9,1,3,1,7,0,0,2,1,0,0,2,4,0,Commerce,Masters,18-24,1,0,0,Hybrid,Tier3_City,1,2,4,3,5,1,3,39.89,Manufacturing,5,3,5,1,1,1,4,5,4,4,1,1,2,5,43.09
Biology,School Counselor,4.344858094704018,1,2,0,1,5,1,2,2,0,3,2,4,4,1,Science,Masters,25-30,6,0,0,Hybrid,Tier2_City,5,1,4,2,4,3,2,5.74,Finance,1,5,3,4,0,1,4,2,2,3,0,1,5,4,54.59
Computer Science,Legal Analyst,4.671902536104497,9,0,3,0,4,1,2,2,1,2,2,2,0,0,Science,PhD,25-30,0,1,23,Hybrid,Tier2_City,3,1,5,3,0,0,5,11.19,Other,1,1,3,4,1,5,4,4,5,2,1,0,1,2,47.68
Art,Construction Manager,2.7198327092375463,7,2,3,0,0,0,1,1,2,1,3,0,4,0,Arts,Bachelors,40+,12,0,0,Hybrid,Tier1_City,5,1,1,5,1,4,2,18.71,Other,1,3,3,4,1,3,3,4,2,1,0,1,5,3,45.65
Finance,Ecologist,3.5323534792552627,9,0,1,1,4,1,4,2,4,3,0,3,4,1,Commerce,Masters,25-30,9,1,53,Flexible,Tier2_City,3,5,5,5,3,0,3,15.36,Education,3,4,2,1,2,4,4,4,2,2,1,0,1,5,61.73
Biology,Legal Consultant,2.914309022224556,5,1,4,1,4,0,4,4,1,1,1,2,2,1,Science,Masters,36-40,4,0,0,Flexible,Tier1_City,4,1,2,5,1,3,5,42.41,Education,1,2,3,4,5,3,2,4,3,3,1,0,5,2,55.26
Music,Marketing Manager,2.760950473648621,9,1,3,1,2,0,1,1,1,0,4,1,4,1,Arts,Masters,31-35,14,0,0,Hybrid,Tier2_City,4,4,1,4,4,4,1,12.16,Education,3,3,4,5,2,4,3,2,1,5,1,1,2,4,61.36
Art,Principal,2.8561977253312523,6,2,1,1,8,0,2,2,1,2,0,1,2,1,Arts,PhD,25-30,8,1,27,Remote,Any,3,1,3,1,2,0,3,28.01,Healthcare,2,5,2,5,4,3,5,1,5,3,1,1,4,4,63.95
Architecture,Artist,4.354334623011409,3,1,4,1,8,0,3,2,1,2,4,0,2,1,Interdisciplinary,Bachelors,25-30,12,0,0,Hybrid,Any,4,2,5,5,1,4,4,29.85,Education,2,4,4,1,5,0,4,2,4,5,1,1,4,4,62.4
Architecture,Biochemist,4.197509132450762,4,0,4,0,5,1,3,4,4,4,1,1,2,1,Interdisciplinary,Bachelors,36-40,14,1,48,Remote,Tier1_City,1,1,0,2,1,3,5,22.98,Other,4,5,2,2,0,5,3,4,5,1,0,0,1,1,60.43
Architecture,Astronomer,4.680409717030596,8,0,4,0,4,1,4,3,4,0,1,4,3,1,Interdisciplinary,Masters,36-40,12,1,18,Hybrid,Tier2_City,5,5,1,5,5,5,3,14.31,Healthcare,1,5,4,2,3,0,2,3,5,5,1,0,5,5,76.27
Chemistry,Art Director,3.4437773833310814,6,0,3,1,1,1,1,2,0,0,3,4,0,0,Science,Bachelors,18-24,0,0,0,Remote,Tier2_City,4,5,3,4,0,4,3,48.13,Other,5,1,1,5,2,1,1,4,2,4,1,0,3,2,40.12
Architecture,Microbiologist,2.5256488234066947,9,2,4,0,0,0,3,4,0,1,1,3,0,1,Interdisciplinary,Masters,25-30,7,1,37,Office,Tier1_City,2,2,3,2,4,5,5,22.43,Education,4,1,1,1,0,5,3,1,4,2,0,0,3,1,53.18
Business,Marketing Manager,2.513231460210517,3,0,0,1,0,1,2,2,1,3,1,0,3,1,Commerce,Masters,25-30,8,1,29,Remote,Any,3,1,3,4,1,3,4,37.18,Other,4,3,2,5,2,3,5,5,4,2,0,1,5,3,52.55
Medicine,Market Research Analyst,3.6647184137719657,3,0,2,1,3,1,2,4,0,0,4,2,1,0,Science,Bachelors,18-24,8,0,0,Flexible,Tier2_City,3,1,0,2,4,4,4,11.65,Tech,2,1,1,4,3,5,1,5,3,4,0,0,4,3,61.89
Business,Sound Engineer,2.728900525117892,3,0,3,1,2,0,3,2,2,4,4,1,4,1,Commerce,Masters,25-30,7,0,0,Remote,Tier2_City,4,1,4,3,0,4,3,41.67,Healthcare,5,3,5,4,2,3,4,4,4,3,1,0,4,4,64.49
Psychology,Fluid Mechanics Engineer,4.076643292842076,9,1,3,1,2,1,3,1,3,2,1,0,4,0,Arts,Bachelors,36-40,3,0,0,Office,Tier2_City,3,5,2,1,5,5,2,13.15,Healthcare,1,3,4,5,4,0,3,1,3,1,0,1,4,1,43.49
Biology,Mechanical Engineer,3.272890533188762,1,1,2,1,6,0,1,1,1,3,4,4,0,1,Science,Bachelors,25-30,13,0,0,Flexible,Tier1_City,2,1,1,1,4,1,3,34.74,Manufacturing,1,4,2,4,0,3,4,2,2,4,0,1,5,1,60.05
Biology,Civil Engineer,2.834580748346559,6,0,2,0,8,1,0,0,4,3,3,4,2,0,Science,Masters,31-35,13,0,0,Remote,Tier1_City,3,5,0,4,0,5,5,26.81,Education,2,4,1,3,5,1,1,1,1,2,1,1,5,3,58.44
Art,Doctor,4.181861331854694,8,2,0,1,1,0,2,2,4,0,3,3,2,0,Arts,PhD,31-35,6,0,0,Flexible,Tier1_City,2,5,3,1,0,5,5,9.89,Finance,3,2,2,3,5,5,2,4,5,5,1,0,4,4,68.24
Art,Legal Analyst,4.402460665635353,2,0,0,1,0,1,3,4,2,2,0,1,3,1,Arts,High School,25-30,0,0,0,Hybrid,Tier1_City,3,4,0,4,3,5,5,4.17,Finance,2,1,5,3,0,1,5,2,5,3,1,1,5,4,42.36
Finance,Nuclear Physicist,4.518200174260112,3,2,2,1,4,0,2,0,2,1,4,2,4,0,Commerce,Bachelors,18-24,6,0,0,Flexible,Tier1_City,3,3,1,4,5,3,4,46.75,Finance,5,2,2,2,1,3,3,5,4,3,0,1,4,2,56.36
Art,Quantum Physicist,4.723955542724614,4,2,3,0,7,1,0,0,2,1,3,3,3,1,Arts,Masters,31-35,5,0,0,Flexible,Any,2,5,2,4,5,2,1,8.91,Finance,3,5,2,2,5,1,1,4,4,4,0,0,5,5,56.1
Education,Marketing Manager,4.151920808456045,9,2,3,0,4,1,2,4,3,4,2,0,0,0,Arts,Masters,36-40,4,0,0,Remote,Tier3_City,5,3,1,1,4,5,5,36.13,Tech,5,3,3,1,5,1,1,5,5,2,0,0,5,5,58.27
Business,Musician,3.1048802327346414,4,2,3,1,8,1,1,0,0,4,2,4,3,0,Commerce,Masters,31-35,0,0,0,Office,Any,1,4,5,4,2,4,5,33.68,Finance,1,3,3,2,4,3,3,4,1,2,1,0,2,2,34.62
Music,Biologist,3.967222298705452,8,0,4,1,8,0,0,1,4,1,0,0,3,0,Arts,Bachelors,18-24,7,1,18,Remote,Tier3_City,2,3,0,1,3,0,2,19.06,Other,3,4,3,5,2,3,3,2,1,1,0,1,5,3,39.5
Education,Construction Manager,3.825273710592755,2,1,0,1,9,0,0,4,0,3,3,1,2,1,Arts,Bachelors,18-24,9,0,0,Remote,Tier3_City,1,3,5,4,5,1,2,11.71,Manufacturing,5,5,3,1,1,0,4,1,1,1,1,0,2,4,46.24
Art,Clinical Psychologist,3.550280830663896,0,0,4,0,1,1,2,2,2,2,4,1,0,0,Arts,Bachelors,18-24,0,0,0,Remote,Tier1_City,3,2,3,5,0,5,3,11.38,Finance,1,3,4,1,2,0,3,5,4,4,0,1,5,3,41.69
Physics,Legal Consultant,4.824588974607893,3,0,3,1,0,0,2,3,0,2,2,3,2,1,Science,Masters,25-30,0,0,0,Remote,Tier2_City,5,2,5,4,5,5,3,30.51,Manufacturing,5,3,5,5,4,4,3,2,4,4,1,1,3,3,53.92
Chemistry,Art Therapist,3.8341502233037694,1,0,3,1,7,0,2,4,3,2,3,2,2,1,Science,Bachelors,31-35,13,0,0,Hybrid,Tier1_City,2,3,3,2,2,1,3,28.71,Healthcare,3,5,2,3,1,3,1,5,1,2,0,0,5,1,57.45
Medicine,Financial Analyst,3.553939137553112,9,0,3,0,2,1,2,3,3,3,4,1,2,0,Science,Bachelors,18-24,14,0,0,Hybrid,Tier1_City,5,5,4,4,1,5,5,44.17,Other,1,5,5,2,3,4,4,3,5,4,0,0,3,4,68.64
Psychology,Conductor,4.703143330513692,4,1,2,1,5,0,2,2,4,4,3,3,3,1,Arts,PhD,36-40,2,1,14,Office,Tier2_City,2,1,4,3,1,4,2,33.08,Education,5,3,2,1,0,3,4,2,3,3,0,0,5,4,58.58
Computer Science,Biologist,4.411733386936261,1,1,4,1,8,1,2,0,3,3,2,0,2,0,Science,High School,25-30,12,0,0,Hybrid,Tier2_City,4,1,2,4,5,2,3,41.51,Finance,4,5,3,3,4,4,5,2,5,5,1,1,2,4,62.53
Computer Science,Paralegal,2.5356699787629964,1,0,2,1,5,0,4,3,3,2,0,2,2,1,Science,PhD,31-35,7,1,40,Flexible,Tier1_City,2,4,2,2,5,5,2,4.52,Manufacturing,3,1,4,4,4,2,5,1,3,2,1,1,5,1,65.32
Physics,Education Administrator,2.936341051399268,6,1,0,1,5,1,4,0,1,2,2,1,2,0,Science,Masters,40+,7,0,0,Remote,Tier1_City,1,5,5,2,3,1,5,34.54,Other,3,5,2,3,2,3,5,1,1,3,1,1,1,3,49.79
Marketing,Accountant,3.2064533472838805,4,2,2,0,8,1,0,0,1,0,0,0,0,1,Commerce,Masters,18-24,13,0,0,Remote,Tier1_City,4,3,5,1,5,5,5,13.98,Manufacturing,3,2,2,3,3,1,5,4,4,5,1,1,1,2,56.17
Engineering,Game Developer,4.708222272593321,4,1,3,1,3,0,2,1,4,4,1,0,0,1,Science,Bachelors,36-40,14,1,16,Office,Tier3_City,3,2,4,5,2,3,3,14.88,Education,1,2,1,2,3,4,4,1,1,2,1,1,1,1,51.12
Architecture,Construction Manager,3.440217203635134,8,1,1,0,7,0,1,1,0,2,4,1,1,1,Interdisciplinary,High School,18-24,6,1,59,Flexible,Any,2,1,4,4,5,4,5,36.87,Healthcare,3,3,4,4,5,2,1,4,2,2,0,0,3,3,44.18
Engineering,Artist,3.356569163703852,2,1,2,1,6,0,1,2,2,2,4,3,0,0,Science,Masters,25-30,4,0,0,Office,Tier3_City,1,3,1,1,4,4,5,40.29,Finance,5,3,4,1,4,2,5,1,4,2,1,1,3,5,54.68
Business,Microbiologist,3.738395102140574,2,0,1,0,6,1,2,2,0,2,4,2,0,0,Commerce,Masters,36-40,14,1,13,Hybrid,Tier3_City,3,1,1,5,2,2,2,20.47,Manufacturing,4,4,4,5,4,0,5,1,3,3,1,1,4,1,60.63
Chemistry,Architectural Technologist,2.731768836846567,8,1,1,0,5,0,4,4,3,0,1,2,2,1,Science,Masters,36-40,7,0,0,Remote,Tier2_City,1,2,5,4,3,3,1,40.13,Finance,5,5,5,1,0,2,4,4,4,2,1,1,2,2,56.54
Computer Science,Teacher,3.917683262909458,5,1,3,1,7,0,4,3,1,3,2,3,4,0,Science,Bachelors,25-30,1,1,19,Remote,Tier1_City,3,2,3,3,4,3,4,23.86,Other,5,2,3,2,3,4,2,3,1,4,1,1,5,5,47.68
Marketing,Counselor,3.179041739602765,8,0,1,0,4,0,4,4,2,2,4,2,0,1,Commerce,Masters,25-30,7,0,0,Hybrid,Tier3_City,2,5,5,4,4,2,3,43.31,Tech,3,4,1,1,4,2,1,2,3,4,0,0,1,1,69.64
Education,Risk Analyst,4.841937018234697,7,2,3,0,1,0,1,1,4,4,0,4,0,0,Arts,Masters,31-35,11,1,6,Hybrid,Tier1_City,5,3,3,2,1,0,1,4.17,Manufacturing,4,3,5,2,0,2,1,4,2,3,0,1,3,5,56.56
Art,Clinical Psychologist,3.0638052272323404,3,0,3,0,1,0,1,3,0,4,3,0,1,0,Arts,Masters,36-40,10,0,0,Hybrid,Tier1_City,3,3,4,2,2,5,3,6.92,Healthcare,4,1,3,2,2,0,1,3,5,3,0,1,5,3,61.68
Music,Architect,3.869131920831397,6,2,4,1,2,1,4,0,0,2,2,4,0,1,Arts,Masters,18-24,1,0,0,Hybrid,Tier3_City,5,4,1,3,4,3,1,39.49,Other,4,5,2,1,3,0,2,1,2,2,1,1,5,3,40.49
Computer Science,Legal Analyst,3.026830237100377,5,2,3,1,5,1,4,0,0,4,0,4,4,1,Science,Masters,36-40,9,0,0,Office,Any,3,4,4,1,3,0,5,32.33,Education,4,4,1,5,1,3,5,4,5,4,1,0,2,3,69.65
Music,Urban Planner,3.867204214327268,8,1,2,0,8,1,1,2,3,4,2,1,2,0,Arts,Masters,25-30,4,0,0,Office,Tier2_City,5,2,4,5,1,0,3,29.27,Manufacturing,2,1,5,5,1,5,5,3,4,2,1,1,3,3,52.57
Art,Inorganic Chemist,3.0685499357995267,8,1,4,1,8,0,0,0,3,1,1,0,3,0,Arts,Bachelors,25-30,10,0,0,Remote,Any,2,5,2,4,4,4,1,31.86,Tech,4,3,1,1,4,1,1,3,1,5,0,0,1,3,46.52
Music,School Psychologist,2.888218848933356,5,1,0,0,4,0,2,1,0,1,1,4,2,1,Arts,Bachelors,25-30,12,0,0,Hybrid,Tier2_City,1,3,4,2,2,5,4,46.72,Education,3,2,3,4,4,2,2,2,1,2,1,0,4,2,44.98
Art,Pharmacist,2.9181126087389013,4,2,0,1,4,0,3,2,2,3,0,1,4,1,Arts,Bachelors,25-30,3,0,0,Remote,Tier1_City,2,5,3,1,1,4,5,33.81,Healthcare,4,4,5,3,5,1,2,1,5,4,0,1,1,2,48.72
Psychology,Entrepreneur,3.1108036567044306,0,1,3,0,4,1,1,2,0,0,1,0,1,0,Arts,Bachelors,36-40,14,1,31,Remote,Tier2_City,3,2,2,3,2,1,3,33.43,Finance,5,4,5,5,0,2,4,5,1,3,0,1,5,4,42.69
Marketing,Special Education Teacher,4.277103612386243,1,2,2,0,0,0,4,3,0,2,3,2,0,1,Commerce,Bachelors,25-30,12,0,0,Office,Any,4,2,1,2,2,4,3,38.7,Finance,2,3,1,2,4,5,4,3,4,5,0,1,3,1,62.88
Chemistry,Entrepreneur,3.3794785205493696,5,0,2,0,2,1,0,0,3,0,3,1,3,0,Science,Bachelors,40+,0,1,8,Office,Tier2_City,1,4,3,3,2,3,1,43.73,Manufacturing,5,3,2,5,4,0,5,4,2,4,0,0,1,2,36.44
Chemistry,Teacher,2.850011666367818,7,0,4,0,3,0,2,0,2,3,0,1,3,0,Science,Bachelors,18-24,4,0,0,Office,Tier3_City,5,4,0,4,1,3,3,15.31,Education,3,2,2,4,0,4,5,1,4,3,1,1,4,5,45.27
Biology,Entrepreneur,3.557105168403134,2,0,4,1,1,0,1,0,1,3,0,1,4,1,Science,Bachelors,31-35,6,0,0,Remote,Tier2_City,1,3,1,5,4,5,5,31.99,Tech,3,2,2,1,1,5,5,5,4,1,0,0,2,2,42.04
Marketing,Marketing Specialist,2.796519579678307,3,1,4,1,3,0,3,4,3,1,2,4,4,1,Commerce,Masters,36-40,0,0,0,Flexible,Tier2_City,1,5,5,2,5,0,2,30.45,Tech,4,2,3,4,0,3,1,5,2,5,0,0,3,5,59.72
Art,Electrical Engineer,2.866797572838001,8,2,1,1,0,0,2,4,0,1,0,2,0,0,Arts,PhD,31-35,1,0,0,Remote,Tier1_City,2,2,0,2,0,3,1,9.34,Healthcare,3,1,1,3,5,2,1,5,3,2,1,1,1,3,44.36
Chemistry,Manager,4.306621692362974,1,0,0,0,2,1,3,1,4,1,0,3,3,0,Science,Bachelors,31-35,11,0,0,Flexible,Tier1_City,3,4,3,4,4,4,4,27.45,Other,2,1,3,5,5,4,4,3,3,3,0,0,5,1,59.89
Art,Biologist,4.759100667144828,3,2,1,0,8,0,3,4,1,0,3,3,4,0,Arts,PhD,25-30,14,0,0,Hybrid,Tier1_City,2,5,1,1,1,4,3,6.27,Education,5,3,3,2,3,0,5,2,5,2,0,1,5,1,66.59
Physics,Biologist,2.8316023118513782,1,1,0,0,9,0,1,4,2,0,0,3,1,1,Science,Bachelors,36-40,13,0,0,Remote,Tier2_City,3,2,0,5,0,5,5,11.69,Education,3,4,2,2,3,5,5,5,5,2,1,1,3,3,51.22
Biology,Financial Advisor,4.7132498636351325,3,1,2,0,7,0,2,0,2,1,2,0,3,0,Science,Bachelors,36-40,8,0,0,Remote,Tier3_City,4,5,0,2,0,4,3,45.91,Finance,3,1,2,4,4,3,4,5,3,3,1,1,2,4,46.93
Engineering,Education Administrator,4.2628855911741415,8,1,2,0,6,1,0,0,2,2,3,0,3,1,Science,Bachelors,18-24,11,0,0,Remote,Tier3_City,2,1,1,5,0,2,4,8.6,Healthcare,2,3,2,1,4,1,1,4,3,1,1,1,3,4,43.61
Law,Legal Consultant,3.851889906413264,7,1,1,0,6,0,4,4,0,0,3,1,4,0,Arts,Bachelors,36-40,4,1,59,Hybrid,Tier1_City,4,1,4,2,5,5,5,30.21,Healthcare,1,1,1,3,5,3,1,5,4,5,0,1,4,5,55.69
Medicine,Architectural Technologist,2.8790280779399966,4,2,0,1,8,0,3,4,1,3,1,4,2,1,Science,Masters,25-30,13,1,23,Flexible,Tier2_City,3,4,3,5,3,5,4,18.2,Other,1,2,1,1,1,1,4,1,1,1,0,1,1,1,58.28
Art,School Counselor,4.418575470118504,7,1,0,1,7,0,3,1,3,3,2,3,0,0,Arts,Masters,25-30,12,1,52,Hybrid,Tier2_City,1,1,3,3,1,3,5,29.1,Healthcare,2,3,2,5,1,2,2,2,5,4,0,1,2,2,71.37
Engineering,Music Teacher,4.884265836901594,3,1,2,1,8,0,3,0,1,3,0,4,4,0,Science,Bachelors,36-40,6,1,28,Hybrid,Tier2_City,4,2,2,2,5,5,2,14.04,Education,3,2,3,4,2,5,3,2,1,1,0,0,2,4,44.69
Education,Advertising Manager,4.973785263426415,6,1,2,1,0,0,3,1,3,2,0,2,1,0,Arts,Bachelors,25-30,1,0,0,Flexible,Tier2_City,4,4,1,5,5,1,5,23.89,Finance,2,5,1,4,3,1,3,5,2,1,1,1,3,2,42.27
Medicine,Special Education Teacher,2.5426173907564205,1,2,2,0,4,1,3,3,0,0,3,0,4,0,Science,Bachelors,36-40,6,0,0,Hybrid,Tier1_City,3,5,3,1,3,3,4,43.76,Healthcare,2,4,5,2,3,1,4,3,3,1,0,0,5,4,42.22
Architecture,Music Therapist,3.770678446434217,0,0,4,0,3,0,4,3,1,3,2,3,3,1,Interdisciplinary,Bachelors,25-30,6,1,8,Hybrid,Any,3,3,0,3,0,3,1,20.68,Finance,1,2,3,5,5,3,2,3,4,2,0,0,2,5,57.44
Engineering,Astronomer,3.908645073075741,0,1,0,1,6,1,4,1,4,2,4,0,0,0,Science,Bachelors,18-24,6,0,0,Flexible,Any,2,1,1,3,3,2,2,19.59,Other,4,4,3,2,2,2,4,5,2,2,1,1,1,1,53.03
Medicine,Architectural Technologist,4.131444350282565,0,0,3,0,4,1,0,4,4,3,1,2,1,0,Science,Bachelors,25-30,4,1,22,Remote,Tier1_City,2,1,5,1,3,3,3,23.97,Healthcare,3,3,4,1,2,0,5,5,5,3,0,1,4,2,51.72
Finance,Industrial-Organizational Psychologist,3.997135820020588,2,0,1,0,9,1,0,2,2,3,2,3,0,0,Commerce,Masters,18-24,8,0,0,Hybrid,Tier3_City,3,4,0,5,5,0,2,7.72,Education,5,5,1,4,3,3,2,3,4,2,1,1,1,5,60.6
Marketing,Web Developer,4.745306457591099,4,0,3,1,4,0,0,2,4,4,0,2,4,0,Commerce,PhD,31-35,1,0,0,Office,Tier1_City,4,2,1,4,1,4,2,21.21,Finance,2,4,5,4,4,2,5,5,2,3,1,0,2,2,49.72
Law,Quantum Physicist,3.029892148904037,1,0,3,1,0,1,1,4,0,3,1,3,0,1,Arts,Bachelors,25-30,3,0,0,Remote,Tier1_City,5,1,0,1,2,4,3,3.32,Manufacturing,1,1,1,3,3,5,4,4,2,1,0,0,4,1,39.84
Architecture,Music Teacher,4.689347105180088,8,0,4,1,1,0,0,4,0,1,4,0,2,0,Interdisciplinary,PhD,25-30,1,1,19,Office,Any,2,5,0,5,3,5,5,26.66,Other,4,3,3,1,2,4,1,4,1,2,1,0,5,5,40.95
Psychology,Marketing Manager,3.689631960397632,5,1,4,0,7,0,3,0,1,3,2,0,2,1,Arts,Bachelors,18-24,7,1,54,Remote,Tier2_City,3,2,1,1,3,2,2,42.85,Healthcare,3,5,1,5,1,0,5,5,3,2,0,1,3,1,48.63
Education,Marketing Specialist,4.613771264348237,4,0,0,1,8,1,4,0,2,2,1,1,2,0,Arts,Bachelors,25-30,11,1,33,Remote,Tier1_City,5,1,2,1,0,4,2,28.95,Education,2,1,3,3,0,5,1,3,4,4,0,0,3,1,58.54
Music,Electrical Engineer,2.754869115007692,4,1,1,1,4,0,0,2,1,0,4,3,2,0,Arts,Bachelors,31-35,10,0,0,Remote,Tier2_City,5,1,0,2,0,0,1,31.56,Finance,1,1,5,4,1,1,1,4,4,5,1,1,4,3,58.51
Medicine,Education Administrator,4.1627748971702685,4,0,2,1,2,1,3,1,4,4,0,2,2,1,Science,Masters,18-24,0,0,0,Flexible,Tier3_City,5,5,1,5,5,2,1,4.44,Tech,2,5,3,5,5,4,4,3,4,5,0,0,3,1,59.89
Music,Accountant,3.177666655641671,5,2,2,1,2,0,1,0,0,0,0,1,4,0,Arts,PhD,31-35,8,0,0,Flexible,Any,5,1,4,4,0,1,4,43.4,Education,5,2,2,2,1,1,4,5,2,1,0,0,1,4,40.19
Psychology,Counselor,3.377519220464369,3,1,0,1,1,0,4,4,1,2,3,4,3,0,Arts,Masters,36-40,11,1,16,Remote,Tier1_City,1,2,5,2,4,4,3,21.1,Education,3,5,3,1,2,2,3,5,3,1,0,0,4,4,66.39
Engineering,AI Researcher,4.252644077853631,5,0,1,0,6,0,0,2,1,0,0,3,0,0,Science,Bachelors,31-35,12,0,0,Remote,Tier3_City,2,3,4,1,3,3,5,48.82,Tech,3,5,2,2,3,0,5,5,4,5,1,0,4,2,54.71
Computer Science,Mechanical Engineer,3.800676046113,8,1,3,0,3,0,1,2,3,0,0,4,1,0,Science,Masters,36-40,13,0,0,Hybrid,Any,5,3,5,1,0,0,5,8.66,Tech,3,5,5,4,5,5,1,4,2,3,1,0,2,1,54.41
Marketing,Market Research Analyst,3.9547228021474297,3,2,4,0,7,0,4,1,0,1,1,1,4,0,Commerce,Bachelors,18-24,4,0,0,Hybrid,Tier2_City,5,1,2,1,1,0,4,47.4,Manufacturing,3,4,5,3,2,0,5,2,3,3,1,1,1,5,42.06
Engineering,Geneticist,4.852499006552042,2,2,1,1,7,0,2,3,3,3,0,2,1,0,Science,Masters,25-30,10,0,0,Flexible,Tier2_City,3,4,1,5,4,4,5,32.81,Manufacturing,1,2,3,2,2,3,5,2,2,5,1,1,2,2,66.11
Psychology,Forensic Psychologist,4.536047793796749,4,1,3,0,7,0,4,1,2,3,1,0,2,0,Arts,Bachelors,36-40,11,0,0,Flexible,Tier1_City,3,2,5,5,5,5,5,5.46,Manufacturing,5,3,2,4,5,2,4,2,4,4,1,1,4,3,61.19
Art,Pharmacist,3.0121161391577225,4,1,3,0,6,0,2,3,0,0,1,0,0,1,Arts,Bachelors,31-35,2,0,0,Office,Tier1_City,1,3,2,2,2,1,1,48.67,Education,2,1,3,2,5,1,5,4,1,2,0,1,1,1,28.73
Biology,Psychologist,2.8696107163779097,1,1,1,0,7,0,0,1,3,4,2,1,2,1,Science,Masters,31-35,11,0,0,Hybrid,Tier2_City,5,4,5,4,3,3,5,3.65,Education,1,4,5,1,5,1,3,3,4,4,1,1,4,2,60.88
Medicine,Biochemist,4.409779211049093,6,2,3,1,0,1,0,0,1,4,4,4,1,0,Science,Masters,31-35,10,1,11,Remote,Any,1,3,0,2,3,1,5,37.34,Education,4,2,2,2,4,5,2,2,5,4,1,0,5,2,66.12
Chemistry,Construction Manager,2.803292197571707,8,2,4,1,9,1,2,3,0,4,0,2,3,0,Science,Bachelors,25-30,3,0,0,Remote,Tier3_City,3,4,5,3,1,1,4,44.81,Manufacturing,3,5,4,1,5,1,1,2,5,4,0,0,3,1,48.56
Physics,Psychologist,3.738184662899928,8,0,3,1,1,0,0,4,1,2,0,2,1,0,Science,Masters,18-24,0,0,0,Hybrid,Tier2_City,2,1,5,1,2,4,4,11.26,Finance,3,4,4,1,4,1,2,1,1,2,1,0,2,1,31.78
Architecture,Digital Marketing Specialist,4.3385171481615785,2,2,3,1,7,0,4,1,3,0,2,0,1,1,Interdisciplinary,Bachelors,31-35,2,0,0,Hybrid,Tier3_City,4,4,4,1,2,3,2,19.14,Education,2,4,5,5,0,0,2,5,4,3,1,1,5,5,45.05
Engineering,Aerospace Engineer,3.641574903796407,5,1,0,0,0,1,0,2,2,2,4,4,2,0,Science,Masters,31-35,10,1,7,Office,Tier3_City,4,1,2,1,5,4,5,29.38,Education,3,1,2,3,4,0,1,2,4,3,0,1,1,4,71.11
Psychology,Construction Manager,3.2692478505841702,1,1,2,1,7,1,2,1,3,1,1,3,2,1,Arts,Masters,25-30,7,0,0,Hybrid,Tier2_City,1,4,0,2,5,4,5,34.95,Education,3,3,3,2,0,1,2,2,3,3,0,1,4,3,54.88
Law,Nurse,4.695868552402842,0,1,4,1,6,1,0,1,2,2,4,3,4,1,Arts,Masters,36-40,11,0,0,Remote,Tier1_City,3,4,4,2,4,5,5,43.98,Manufacturing,2,2,5,4,1,3,5,3,5,4,1,1,3,1,69.35
Marketing,Dentist,4.900058149579758,5,1,2,0,5,1,4,3,0,4,1,0,1,0,Commerce,Masters,25-30,1,0,0,Hybrid,Tier1_City,4,4,2,1,3,0,1,38.77,Healthcare,5,2,5,5,1,4,4,5,1,1,1,0,1,1,42.62
Computer Science,Financial Analyst,2.686156194027847,4,0,2,0,6,0,0,1,2,4,1,3,3,1,Science,Bachelors,25-30,1,0,0,Flexible,Tier1_City,5,2,0,2,0,5,5,20.08,Manufacturing,1,2,1,3,2,2,3,4,3,4,0,1,1,4,41.39
Art,Mechanical Engineer,3.775635204426979,9,1,4,1,1,0,1,3,2,4,0,2,0,1,Arts,Bachelors,36-40,8,1,53,Office,Tier1_City,2,3,5,5,5,5,1,41.62,Healthcare,5,5,3,5,1,1,3,4,2,1,0,1,1,1,51.36
Physics,Teacher,3.358368482058629,1,0,0,1,6,0,4,2,4,0,0,3,1,0,Science,Masters,31-35,4,1,16,Remote,Tier1_City,3,4,3,5,1,4,2,48.41,Manufacturing,2,5,3,2,4,2,5,1,2,2,0,0,3,4,46.66
Finance,Clinical Psychologist,3.530963499356293,8,2,2,1,2,0,2,0,1,4,2,2,4,1,Commerce,Bachelors,25-30,4,0,0,Flexible,Tier3_City,1,1,4,2,1,5,3,13.67,Finance,3,4,4,2,4,1,4,3,3,5,0,1,3,4,48.75
Biology,Data Scientist,2.5880385563014148,9,0,4,1,8,1,4,0,4,3,3,4,2,1,Science,Bachelors,18-24,0,0,0,Hybrid,Tier1_City,3,4,0,1,1,5,5,6.48,Finance,3,3,1,2,4,5,4,3,1,4,0,1,1,4,49.72
Medicine,Brand Manager,3.530796526825529,3,0,2,0,0,0,0,4,4,1,3,2,1,1,Science,Bachelors,18-24,12,0,0,Hybrid,Tier1_City,2,2,3,2,5,2,4,23.05,Education,5,1,3,3,3,5,2,5,3,3,0,0,1,1,61.36
Biology,Accountant,4.657174482564422,9,2,0,1,7,1,3,1,4,0,0,0,0,0,Science,Bachelors,31-35,5,0,0,Hybrid,Any,3,2,2,2,5,3,4,44.43,Manufacturing,4,1,3,5,4,3,3,3,1,1,1,1,2,5,39.29
Marketing,Conductor,3.0708028590315584,3,1,4,1,8,0,4,0,2,4,4,3,2,0,Commerce,Masters,25-30,7,1,49,Hybrid,Tier3_City,1,2,3,2,1,0,5,10.06,Healthcare,1,3,4,4,5,4,3,1,4,3,1,1,2,5,65.31
Music,Forensic Psychologist,4.551863730285604,3,2,1,0,1,0,1,1,0,1,1,0,0,1,Arts,Bachelors,36-40,5,0,0,Hybrid,Tier3_City,5,4,5,3,5,3,1,44.63,Healthcare,3,2,1,5,2,1,3,5,2,4,0,0,3,1,44.32
Physics,Marketing Specialist,3.261833800139888,2,1,4,1,9,1,0,4,2,0,4,0,1,1,Science,Masters,36-40,13,0,0,Office,Tier1_City,3,4,4,5,0,0,4,49.63,Finance,2,3,1,3,2,1,1,3,2,2,1,0,3,4,55.2
Law,Analytical Chemist,3.9299310291715104,5,2,4,0,2,0,2,3,2,2,1,2,0,1,Arts,Bachelors,36-40,14,1,7,Hybrid,Tier2_City,1,4,1,4,0,2,4,5.54,Education,5,1,2,1,1,4,3,3,3,2,0,0,2,4,51.49
Business,Legal Secretary,3.130583221022194,5,0,3,0,4,0,3,1,3,1,3,0,2,1,Commerce,High School,25-30,6,0,0,Remote,Tier2_City,5,3,2,4,4,4,2,26.28,Healthcare,1,5,5,1,0,1,1,2,5,1,0,1,3,5,47.31
Marketing,Special Education Teacher,3.64166812019128,7,0,4,1,5,0,1,2,4,0,3,2,2,0,Commerce,Bachelors,31-35,13,0,0,Remote,Tier2_City,4,4,3,3,3,0,2,18.46,Manufacturing,4,3,2,1,5,0,5,2,3,3,0,1,5,2,54.29
Engineering,Psychologist,3.6466081636246974,0,2,4,0,2,0,1,4,2,0,3,0,4,0,Science,High School,25-30,3,0,0,Office,Tier2_City,3,5,0,2,0,0,2,21.5,Education,3,4,1,4,5,3,1,1,4,5,1,0,1,3,44.3
Computer Science,Counselor,3.063419292020752,5,2,1,1,0,0,4,4,0,0,3,0,0,0,Science,Bachelors,18-24,1,0,0,Office,Tier2_City,5,2,1,3,4,0,4,24.23,Other,5,5,4,3,5,0,1,2,3,1,1,1,1,4,38.01
Engineering,Biotechnologist,3.5799088278532096,9,1,0,0,5,0,2,3,4,3,4,1,4,1,Science,Masters,18-24,0,1,26,Hybrid,Any,4,4,1,3,2,2,4,37.77,Manufacturing,3,4,2,3,3,5,4,3,1,2,0,0,5,1,47.19
Psychology,Biologist,4.477558906548616,6,1,4,1,3,0,2,0,0,4,2,3,4,0,Arts,Bachelors,25-30,11,0,0,Remote,Tier1_City,3,3,2,1,3,3,5,30.79,Manufacturing,5,4,4,1,0,3,2,2,4,1,1,0,2,5,51.86
Physics,Industrial-Organizational Psychologist,4.464698398960558,8,1,1,0,4,1,1,3,0,2,2,1,1,1,Science,Masters,36-40,5,0,0,Remote,Tier1_City,3,1,3,5,0,2,5,48.18,Finance,4,3,1,3,3,0,4,3,2,2,0,1,2,2,40.9
Physics,Marketing Specialist,3.754411958826837,9,2,0,1,3,0,2,0,4,3,0,4,2,1,Science,High School,18-24,8,0,0,Hybrid,Tier2_City,2,2,4,4,2,0,1,18.64,Manufacturing,2,4,4,3,5,5,3,5,1,4,1,0,5,3,46.92
Chemistry,Marketing Specialist,2.633057498285874,6,1,4,0,3,1,4,1,1,1,0,0,2,1,Science,Bachelors,18-24,9,0,0,Remote,Tier2_City,3,4,3,2,4,5,4,28.45,Tech,2,2,2,2,2,0,4,2,3,4,0,0,5,1,51.4
Psychology,Nurse,3.628958915782629,2,0,1,1,9,0,0,1,3,4,3,2,0,0,Arts,Masters,40+,4,1,52,Hybrid,Tier1_City,3,4,3,4,0,0,5,41.23,Education,1,3,1,4,2,5,2,1,5,4,0,0,3,2,60.83
Marketing,Credit Analyst,3.775577667037835,2,0,1,0,0,0,1,0,3,3,4,0,1,1,Commerce,Bachelors,18-24,11,0,0,Office,Tier3_City,5,1,2,4,0,5,5,20.53,Tech,3,1,1,3,3,1,1,4,5,2,0,0,4,4,55.51
Marketing,Composer,4.24072465960052,0,0,2,0,6,1,0,1,0,3,1,4,3,0,Commerce,Bachelors,31-35,1,1,29,Remote,Tier2_City,1,3,2,5,5,4,2,24.87,Manufacturing,3,2,2,1,1,3,1,3,1,4,0,1,2,1,35.55
Music,Cybersecurity Analyst,2.9666609338612746,2,1,1,0,4,1,2,4,0,3,3,0,1,0,Arts,Bachelors,25-30,0,1,26,Office,Tier2_City,2,5,0,4,2,2,2,35.19,Manufacturing,3,5,5,5,4,3,5,1,3,4,0,0,2,5,43.47
Law,Financial Analyst,3.791334058490613,9,0,1,0,8,1,1,3,4,4,1,2,0,1,Arts,Bachelors,18-24,2,1,7,Office,Tier2_City,3,1,4,4,0,5,2,43.45,Finance,2,3,2,5,4,1,5,3,5,5,0,0,2,1,57.09
Computer Science,Psychologist,3.025695447560328,7,2,0,0,7,0,4,2,2,0,0,3,3,0,Science,Masters,36-40,3,1,28,Remote,Tier3_City,5,3,2,3,1,2,3,22.54,Finance,1,1,2,4,0,5,2,3,1,5,0,1,5,1,49.22
Biology,Financial Controller,2.821570209416658,2,1,1,0,5,0,3,3,3,3,0,4,0,0,Science,Bachelors,18-24,6,0,0,Hybrid,Any,5,3,0,5,5,1,5,28.0,Other,2,1,3,3,2,3,2,5,5,3,1,1,2,2,62.32
Computer Science,Investment Banker,3.9348414103394274,8,0,1,1,3,0,4,1,2,3,1,3,2,1,Science,Masters,25-30,8,1,20,Remote,Tier1_City,1,4,5,1,5,3,2,48.83,Finance,5,3,1,2,4,3,4,3,1,1,1,1,2,2,57.03
Medicine,Psychologist,3.413439224449976,0,0,3,1,1,0,2,1,3,0,2,3,0,1,Science,Masters,25-30,7,0,0,Office,Tier1_City,4,4,1,2,0,1,2,5.0,Other,3,2,3,3,2,1,2,4,1,5,0,0,3,4,50.98
Education,Urban Planner,3.2718942474054686,6,0,1,0,5,0,1,2,3,0,4,2,0,0,Arts,Bachelors,18-24,8,0,0,Remote,Tier1_City,3,2,0,4,5,5,4,24.07,Finance,5,1,3,1,5,2,4,4,3,1,0,1,5,5,54.36
Medicine,Music Teacher,2.8188259534690734,9,2,0,1,2,0,1,3,1,4,0,1,2,0,Science,PhD,18-24,6,0,0,Hybrid,Any,4,4,4,2,3,1,2,32.89,Other,4,3,3,3,2,4,5,4,5,1,0,0,5,5,54.8
Business,Astronomer,4.592202807357829,0,0,1,1,7,1,2,4,2,1,4,2,3,0,Commerce,Bachelors,18-24,9,0,0,Hybrid,Tier2_City,1,4,0,1,2,3,4,3.4,Healthcare,5,3,4,5,2,5,4,1,1,1,1,0,3,5,51.9
Architecture,Architectural Technologist,3.5964858594100493,4,0,0,0,1,1,1,1,1,1,4,2,3,1,Interdisciplinary,PhD,18-24,7,0,0,Remote,Any,5,3,5,2,3,5,1,31.05,Finance,5,4,2,5,4,5,4,5,2,3,1,0,4,3,58.88
Law,Clinical Psychologist,2.9353146031033366,0,2,3,0,3,0,2,3,2,0,4,4,4,1,Arts,Bachelors,31-35,7,0,0,Remote,Any,4,4,0,1,4,4,2,5.64,Manufacturing,5,3,3,4,4,0,5,1,1,1,0,0,5,5,53.16
Music,Lawyer,2.7845550975833304,1,2,0,1,5,0,1,4,4,3,4,3,2,1,Arts,Masters,25-30,0,0,0,Hybrid,Tier2_City,1,4,2,3,3,4,4,43.31,Other,2,1,4,1,5,3,3,1,1,2,0,1,3,1,47.43
Art,Special Education Teacher,4.300315656723851,5,2,2,1,8,0,4,3,4,2,3,2,0,0,Arts,Bachelors,25-30,11,0,0,Hybrid,Tier1_City,4,4,4,4,1,3,2,40.93,Manufacturing,5,4,4,4,4,4,2,4,4,5,0,1,1,1,74.61
Finance,Teacher,3.0609714246660378,0,1,3,1,6,0,4,1,4,2,2,1,4,0,Commerce,Bachelors,25-30,13,0,0,Flexible,Tier1_City,5,5,0,1,5,3,1,4.52,Other,3,1,1,3,3,1,1,1,1,2,1,0,3,1,55.23
Finance,Industrial-Organizational Psychologist,4.977188660945433,1,2,0,0,7,1,1,3,1,3,0,4,3,0,Commerce,Masters,36-40,14,1,51,Remote,Tier1_City,3,5,3,2,5,5,2,5.29,Education,1,2,2,2,4,3,5,3,3,2,0,1,1,3,58.18
Chemistry,Nurse,4.234683130940507,0,0,4,0,9,1,3,3,4,2,1,2,1,0,Science,Masters,36-40,11,0,0,Hybrid,Tier3_City,2,2,0,4,1,2,4,38.42,Other,4,2,5,4,2,4,4,2,3,2,1,0,4,1,65.6
Art,Marketing Specialist,3.168893126956277,3,1,0,1,7,0,4,0,3,2,4,0,2,0,Arts,High School,31-35,14,0,0,Hybrid,Tier1_City,5,1,1,3,5,5,1,20.37,Tech,3,1,2,5,5,5,1,3,1,1,1,0,3,2,54.65
Law,Data Scientist,3.72143600406419,0,0,0,1,6,1,1,2,1,3,1,0,4,1,Arts,Bachelors,36-40,8,0,0,Remote,Tier2_City,4,3,1,4,3,2,1,30.03,Other,1,5,4,1,2,5,2,1,3,1,1,1,5,3,41.09
Marketing,Digital Marketing Specialist,3.983380678883847,0,0,3,1,2,0,0,1,1,3,1,1,0,0,Commerce,Masters,25-30,1,0,0,Hybrid,Tier1_City,3,2,0,1,4,2,1,15.71,Other,3,5,2,3,5,0,1,5,1,1,0,0,5,2,33.06
Music,Legal Secretary,2.9912979087357283,6,1,3,0,7,0,4,0,3,3,2,1,3,0,Arts,Masters,25-30,11,0,0,Remote,Tier1_City,2,3,5,3,0,2,3,11.13,Healthcare,5,5,1,1,0,5,1,3,3,4,1,1,1,3,59.86
Finance,Entrepreneur,2.932681495510926,5,0,4,0,5,1,0,1,2,0,4,4,2,0,Commerce,PhD,31-35,10,0,0,Office,Tier1_City,1,1,0,2,1,5,4,16.92,Healthcare,4,1,2,1,1,4,2,1,2,1,1,0,3,1,54.09
Engineering,Data Scientist,3.52741865496627,7,2,1,1,6,0,1,1,2,4,4,0,0,0,Science,Masters,31-35,13,0,0,Hybrid,Tier2_City,3,1,3,3,3,0,3,14.6,Education,3,3,4,1,3,2,4,5,1,5,0,0,4,4,62.19
Music,Art Director,4.961370100895378,1,0,1,1,1,0,4,2,1,1,3,1,4,0,Arts,PhD,25-30,6,0,0,Remote,Tier1_City,5,2,0,3,3,0,1,24.07,Education,4,4,4,5,5,3,4,4,1,1,0,0,2,5,51.64
Engineering,Pharmacist,4.724927911754698,9,0,0,1,1,0,2,3,1,2,0,0,0,0,Science,Masters,25-30,12,0,0,Hybrid,Tier2_City,4,5,2,5,3,4,3,38.09,Finance,2,3,3,2,0,0,3,2,2,5,0,0,3,5,54.97
Law,Data Scientist,2.57943104601299,0,0,1,1,6,0,1,4,3,3,1,1,2,0,Arts,Bachelors,40+,9,1,50,Hybrid,Tier2_City,2,5,4,3,0,0,2,29.04,Education,2,1,4,4,5,0,4,1,3,5,1,0,3,5,56.52
Music,Psychologist,4.71947218161548,2,2,0,1,7,1,2,2,1,3,4,0,1,1,Arts,Bachelors,36-40,9,0,0,Hybrid,Any,3,5,5,3,2,0,3,31.63,Healthcare,5,3,1,5,3,0,3,3,3,3,1,1,2,5,60.87
Finance,Legal Consultant,4.257994631029148,3,0,3,0,5,1,1,1,3,3,1,4,4,0,Commerce,Masters,25-30,12,1,59,Remote,Any,2,4,3,4,5,2,5,25.09,Tech,5,2,4,2,3,2,5,2,5,4,1,1,4,2,67.54
Marketing,Urban Planner,4.810343954684544,8,0,2,0,2,0,0,2,3,2,3,4,0,0,Commerce,Masters,31-35,4,1,7,Remote,Tier2_City,2,4,0,2,5,2,1,18.26,Other,2,4,2,3,2,4,2,4,2,1,0,1,3,5,49.94
Art,Special Education Teacher,4.627627485774527,1,2,3,1,2,0,2,3,3,2,2,2,3,0,Arts,High School,25-30,3,0,0,Hybrid,Tier3_City,3,2,5,4,4,3,1,9.74,Tech,3,1,5,4,2,0,3,4,2,2,1,0,2,5,46.79
Computer Science,Advertising Manager,2.715725240468519,5,1,2,0,7,1,2,4,2,3,1,0,3,0,Science,Bachelors,18-24,0,1,54,Remote,Tier1_City,4,4,2,4,2,2,4,19.66,Healthcare,1,4,4,2,2,2,2,2,4,1,0,0,2,4,38.65
Business,Legal Analyst,2.877327011103316,6,2,0,0,4,1,3,4,1,0,4,0,3,0,Commerce,PhD,25-30,0,1,56,Hybrid,Tier2_City,1,3,5,1,5,5,2,34.26,Finance,1,5,1,3,2,3,1,1,3,1,1,0,2,2,52.0
Chemistry,Counselor,2.6322123061789444,8,2,4,0,5,0,2,4,3,3,3,1,1,0,Science,Bachelors,25-30,2,0,0,Office,Tier2_City,3,2,0,4,4,3,4,37.49,Tech,2,5,1,4,0,3,2,1,1,5,1,1,4,5,54.37
Engineering,Financial Analyst,4.618490338143403,1,0,0,1,8,1,2,0,1,3,2,2,3,0,Science,Bachelors,18-24,13,0,0,Flexible,Tier1_City,1,2,3,5,4,3,3,25.05,Other,1,2,1,3,1,1,2,5,2,3,1,0,3,3,55.42
Chemistry,Special Education Teacher,2.8180217252377937,4,1,3,1,0,0,0,0,3,0,0,3,0,0,Science,Bachelors,36-40,14,0,0,Hybrid,Tier3_City,2,1,3,5,3,0,5,33.31,Other,3,1,1,5,1,2,2,5,4,2,1,0,4,2,51.95
Music,Ecologist,2.7101662418090435,6,2,4,1,4,1,1,0,2,2,3,0,3,1,Arts,Bachelors,25-30,0,0,0,Office,Tier1_City,2,1,1,1,1,2,5,12.9,Tech,1,5,2,3,5,0,1,1,3,1,0,0,4,3,33.42
Architecture,Quantum Physicist,2.985955936362347,8,0,1,0,7,0,0,3,4,3,2,2,1,0,Interdisciplinary,Bachelors,25-30,7,0,0,Hybrid,Tier1_City,4,2,1,2,3,0,5,43.42,Finance,1,4,3,1,0,5,4,3,1,2,0,1,5,2,46.61
Art,Data Scientist,4.351407777958318,3,2,3,1,7,1,4,4,2,4,4,2,2,1,Arts,Bachelors,18-24,2,1,45,Flexible,Tier1_City,3,5,0,2,0,2,5,43.7,Tech,2,4,5,5,1,2,3,4,4,2,0,1,3,5,55.66
Law,Biotechnologist,3.077030763170689,5,1,1,0,2,1,2,0,4,4,1,1,3,0,Arts,Bachelors,18-24,10,1,13,Remote,Any,3,1,4,4,5,0,2,18.06,Manufacturing,4,2,3,3,5,2,5,5,2,5,1,0,5,1,63.04
Engineering,AI Researcher,4.55065204701744,8,2,2,1,0,0,3,0,3,3,3,3,2,0,Science,Masters,36-40,9,0,0,Remote,Tier1_City,5,4,2,4,4,0,3,28.74,Healthcare,4,5,3,5,4,4,2,2,1,5,1,1,3,2,70.41
Law,Electrical Engineer,3.624512475243476,7,2,2,1,1,0,1,1,0,2,0,1,3,0,Arts,Bachelors,31-35,1,1,55,Remote,Tier1_City,4,2,1,4,1,0,5,31.51,Tech,3,3,3,4,4,1,2,2,1,3,0,0,1,5,27.04
Art,Biomedical Engineer,3.378265589136482,6,1,0,0,7,0,3,4,3,0,4,0,2,1,Arts,Masters,40+,5,1,54,Hybrid,Any,3,3,1,2,5,5,1,25.2,Tech,4,5,2,1,4,2,3,1,5,5,0,1,3,2,69.16
Education,Accountant,3.4569724233532577,1,0,3,0,5,1,2,3,3,2,4,4,1,0,Arts,Masters,40+,3,0,0,Remote,Tier1_City,2,2,4,3,4,4,3,45.82,Finance,5,2,5,1,2,0,3,2,4,3,1,1,3,2,60.69
Business,Organic Chemist,3.271727953465549,3,2,4,0,2,0,0,3,1,1,0,0,3,0,Commerce,Bachelors,25-30,12,0,0,Remote,Any,4,3,5,5,4,0,2,37.77,Tech,2,5,4,3,4,5,1,2,1,3,1,0,2,3,41.98
Marketing,Ecologist,2.81665248027867,1,2,4,1,5,0,0,4,1,2,1,4,2,1,Commerce,Masters,25-30,12,0,0,Hybrid,Any,5,1,3,3,3,1,5,34.61,Finance,4,1,4,4,5,1,3,1,2,3,0,1,3,3,61.31
Medicine,Counselor,4.212387598813491,5,1,3,0,5,0,0,0,4,2,1,4,0,1,Science,Bachelors,36-40,13,1,6,Flexible,Tier2_City,5,5,0,3,1,1,2,27.44,Healthcare,1,2,5,5,3,3,1,3,1,3,1,1,4,4,54.9
Finance,Investment Banker,3.755864592120079,8,0,1,0,3,1,4,3,2,0,4,2,3,1,Commerce,Masters,40+,10,1,15,Flexible,Tier2_City,2,3,0,2,1,1,5,6.99,Manufacturing,4,3,5,3,3,2,4,1,5,3,0,1,4,3,71.1
Music,Education Administrator,2.7436277371160576,0,0,1,1,6,0,4,2,2,2,4,3,0,0,Arts,Bachelors,31-35,13,0,0,Office,Any,3,5,2,3,5,5,1,8.07,Education,2,4,1,2,5,5,1,4,5,5,0,1,2,2,74.53
Engineering,Astronomer,4.4134304280829895,2,0,4,0,4,0,4,1,1,3,1,0,1,0,Science,Masters,31-35,12,0,0,Hybrid,Tier2_City,2,3,4,1,4,3,3,17.05,Healthcare,1,5,3,3,0,4,2,5,1,4,0,1,2,1,60.91
Medicine,Ecologist,3.558523012431284,7,1,1,0,7,0,4,0,3,4,2,3,1,1,Science,Masters,31-35,10,1,29,Flexible,Tier1_City,5,5,5,4,1,0,1,12.94,Tech,1,4,1,2,3,0,5,3,3,2,0,1,3,3,61.99
Biology,Marketing Specialist,4.803467490640605,5,1,3,1,3,0,1,4,3,1,1,2,0,0,Science,Bachelors,25-30,12,1,51,Flexible,Any,4,3,4,1,1,1,5,47.77,Manufacturing,2,2,2,1,5,5,2,3,1,5,1,0,4,3,51.11
Biology,Landscape Architect,4.587930942442855,2,1,2,0,9,0,4,4,0,3,0,4,3,0,Science,Bachelors,25-30,3,0,0,Flexible,Tier1_City,3,2,4,5,5,5,4,22.26,Education,3,4,2,3,5,2,1,2,5,1,1,1,3,1,51.48
Business,Acoustics Specialist,3.538267235015553,9,1,4,0,8,0,4,1,1,2,3,3,1,1,Commerce,Masters,36-40,1,0,0,Hybrid,Tier1_City,2,2,3,4,3,3,3,44.2,Education,3,1,5,3,0,4,2,5,5,4,0,1,2,4,56.78
Art,Sound Engineer,3.1962988647635147,2,0,4,0,2,0,4,4,0,0,4,3,2,1,Arts,Masters,31-35,1,1,19,Remote,Any,3,1,4,3,2,1,2,41.45,Other,2,2,2,1,1,3,4,5,2,5,1,0,5,4,53.64
Chemistry,Nuclear Physicist,3.803900463581923,4,1,1,1,3,0,3,2,0,0,4,4,3,1,Science,Bachelors,18-24,10,0,0,Remote,Tier1_City,4,2,3,5,0,2,5,41.19,Other,2,2,5,5,3,2,4,3,2,5,1,1,5,5,61.96
Psychology,Legal Analyst,4.507949632273648,9,1,4,1,9,0,3,4,4,2,1,2,0,1,Arts,Masters,25-30,5,0,0,Flexible,Tier3_City,5,4,0,4,2,4,1,13.14,Tech,2,5,4,3,5,4,5,4,3,1,0,0,4,3,55.81
Music,Physicist,3.5840908250914287,3,1,3,1,3,1,2,4,4,2,2,3,1,1,Arts,Bachelors,18-24,4,1,23,Remote,Tier2_City,2,1,3,3,1,0,4,24.02,Other,1,2,3,4,5,5,5,4,2,4,1,1,5,4,53.24
Chemistry,Digital Marketing Specialist,4.3223802623117935,4,1,4,1,4,0,3,4,4,1,1,3,4,1,Science,Masters,18-24,8,0,0,Remote,Tier3_City,5,2,0,1,4,4,5,17.94,Education,1,1,2,1,3,0,4,2,1,5,0,1,3,5,65.38
Music,Cybersecurity Analyst,4.797965979958615,4,1,1,1,5,1,2,2,1,2,0,2,3,1,Arts,Bachelors,36-40,3,1,46,Hybrid,Tier1_City,2,2,2,4,0,4,2,48.61,Education,2,5,1,5,0,0,4,2,1,4,0,0,5,4,36.69
Medicine,Pharmacist,3.57864893430899,1,0,3,1,6,0,2,1,0,2,4,0,3,0,Science,Masters,18-24,4,0,0,Remote,Tier2_City,3,4,4,3,0,2,1,44.21,Healthcare,1,1,2,1,3,3,2,4,5,2,1,1,1,1,44.32
Business,Game Developer,3.755445342930084,8,1,1,0,3,1,1,4,2,4,3,1,2,0,Commerce,Bachelors,18-24,14,0,0,Flexible,Tier1_City,1,5,2,1,4,2,3,14.75,Other,5,3,3,1,0,1,4,5,1,1,1,0,3,2,53.04
Music,Brand Manager,3.0024018447265344,6,0,1,0,9,0,0,4,2,2,2,4,0,1,Arts,Bachelors,25-30,0,0,0,Remote,Tier1_City,2,2,4,5,0,2,4,17.74,Other,2,5,2,5,3,5,1,4,5,5,1,0,3,1,51.52
Architecture,Civil Engineer,4.217892299168601,8,1,1,0,8,0,0,2,3,0,0,4,2,1,Interdisciplinary,Bachelors,31-35,11,0,0,Remote,Tier1_City,2,3,5,5,4,3,5,27.86,Healthcare,1,2,5,5,5,2,2,3,1,1,0,1,1,1,49.14
Physics,Curriculum Developer,2.5663956259026093,6,0,1,0,0,0,2,4,1,3,2,2,1,1,Science,Bachelors,25-30,11,0,0,Flexible,Tier1_City,5,5,2,5,0,1,5,16.09,Education,3,2,2,5,2,5,3,1,1,2,1,1,4,1,54.84
Chemistry,Financial Analyst,3.5710514304408973,0,1,2,0,0,1,3,1,4,4,0,2,3,1,Science,Bachelors,18-24,1,0,0,Hybrid,Any,1,3,1,5,5,0,5,41.75,Finance,2,2,4,4,1,4,5,1,1,5,1,0,4,1,52.61
Architecture,Aerospace Engineer,3.8598871956845127,8,2,2,0,0,1,1,3,1,1,4,2,4,1,Interdisciplinary,Bachelors,18-24,2,0,0,Flexible,Tier2_City,1,5,1,2,5,2,5,41.5,Tech,2,3,4,2,3,3,5,1,1,1,0,1,3,2,41.79
Psychology,Education Administrator,3.845107981166889,4,1,0,1,1,0,0,4,4,4,1,4,0,1,Arts,Masters,18-24,4,1,46,Hybrid,Tier2_City,1,3,3,4,2,5,1,37.04,Finance,2,1,2,1,5,3,5,5,2,3,0,0,4,2,53.9
Medicine,Fluid Mechanics Engineer,4.003782209510943,1,2,4,1,3,0,1,3,4,3,1,4,4,1,Science,High School,25-30,11,0,0,Office,Tier2_City,1,2,5,4,0,0,3,35.4,Finance,4,2,1,3,1,5,2,4,2,2,0,1,3,5,52.73
Psychology,Financial Analyst,3.2531556004990243,9,1,1,1,0,1,4,0,4,4,4,4,0,1,Arts,Bachelors,25-30,4,0,0,Remote,Any,4,3,2,2,3,0,2,28.72,Education,2,4,2,2,3,5,4,3,5,4,0,0,3,4,66.86
Chemistry,Entrepreneur,4.411307038721151,2,2,4,1,6,0,0,4,0,1,4,0,1,0,Science,Bachelors,36-40,3,0,0,Hybrid,Tier2_City,3,2,4,3,4,0,4,19.31,Tech,3,2,5,3,3,4,1,3,4,4,1,0,2,3,50.29
Finance,Urban Planner,4.22735922362619,5,2,4,0,1,0,0,0,1,3,3,4,2,0,Commerce,High School,25-30,13,0,0,Remote,Tier3_City,2,4,0,3,0,2,5,42.34,Finance,1,5,5,3,2,1,3,2,1,1,1,1,5,2,42.8
Chemistry,Zoologist,4.71191765506841,1,1,3,0,3,0,2,4,1,2,0,4,4,1,Science,Bachelors,18-24,9,0,0,Flexible,Tier1_City,3,3,3,5,5,2,5,43.37,Healthcare,2,5,5,3,4,5,5,5,5,1,1,1,5,4,58.48
Law,Construction Manager,3.698438787640759,6,0,3,0,6,1,4,2,1,3,0,4,0,1,Arts,Bachelors,31-35,2,0,0,Remote,Tier2_City,3,1,5,1,5,1,3,5.33,Healthcare,5,4,1,4,4,1,2,3,5,2,0,0,1,5,54.19
Business,Electrical Engineer,4.809164387366743,2,1,0,0,6,1,1,2,3,3,4,1,1,0,Commerce,Bachelors,25-30,8,1,16,Remote,Tier1_City,3,1,3,3,4,2,3,21.74,Tech,1,3,4,4,1,3,1,2,1,4,0,1,3,4,57.16
Art,Analytical Chemist,3.690559458033024,1,2,0,1,1,1,2,0,4,3,0,0,2,0,Arts,Bachelors,31-35,0,0,0,Flexible,Tier2_City,3,3,5,1,3,2,1,4.25,Finance,3,5,5,2,1,3,4,5,1,1,0,1,5,3,28.25
Architecture,Sound Engineer,2.850855357160569,2,1,0,1,7,0,4,1,2,0,2,1,0,1,Interdisciplinary,Bachelors,25-30,5,0,0,Hybrid,Tier1_City,4,2,1,4,0,0,1,42.46,Manufacturing,4,3,5,5,2,3,3,3,5,3,0,1,4,1,49.12
Computer Science,Judge,4.789659074529285,7,2,3,0,6,0,1,2,0,2,2,4,2,1,Science,Masters,25-30,6,0,0,Hybrid,Tier3_City,5,5,5,1,0,1,1,11.32,Other,3,3,2,4,0,3,5,4,5,3,1,1,4,3,54.74
Engineering,Conductor,3.498782132731279,6,1,3,0,0,0,3,2,1,0,1,4,1,1,Science,High School,31-35,9,0,0,Office,Tier1_City,4,4,2,4,3,4,4,34.67,Manufacturing,4,4,4,1,1,3,4,3,2,5,0,0,5,3,50.32
Finance,Biochemist,3.18691085929148,5,1,2,1,9,1,2,2,0,1,0,0,4,1,Commerce,Bachelors,36-40,3,0,0,Remote,Tier2_City,2,3,2,2,3,2,1,19.8,Tech,1,5,5,2,4,2,2,5,2,5,0,1,3,2,39.64
Finance,School Counselor,3.5741263551876967,2,2,4,0,1,0,0,4,3,4,2,0,1,1,Commerce,PhD,25-30,9,1,43,Remote,Tier2_City,1,4,5,2,3,5,5,41.36,Other,4,2,5,1,2,2,5,2,1,2,1,1,4,2,56.85
Education,Microbiologist,4.3870647600901,8,1,2,1,3,0,0,3,3,1,4,0,2,0,Arts,Bachelors,25-30,2,0,0,Flexible,Tier1_City,5,2,3,5,5,2,1,26.96,Tech,1,3,2,3,0,2,2,5,5,1,0,1,5,3,45.19
Psychology,Civil Engineer,4.923447575129488,0,2,0,0,2,0,2,1,3,0,3,2,2,0,Arts,Masters,25-30,7,0,0,Remote,Tier1_City,2,1,1,3,4,4,4,18.25,Manufacturing,3,3,2,1,5,0,4,1,1,2,1,0,1,1,47.42
Medicine,Physicist,3.310722351711036,7,0,0,1,2,1,1,0,4,1,4,4,4,0,Science,Bachelors,36-40,8,0,0,Hybrid,Tier1_City,1,2,0,5,3,0,1,18.22,Finance,3,5,3,4,2,2,3,3,3,2,0,0,2,1,55.23
Physics,School Counselor,2.775755218974516,5,2,1,0,5,1,1,2,0,4,0,1,4,1,Science,Masters,36-40,12,1,11,Office,Tier2_City,4,2,1,4,4,1,1,18.37,Finance,4,5,2,1,4,5,5,1,1,3,0,0,5,2,46.77
Business,Legal Analyst,4.96793602514853,0,0,2,1,0,0,4,2,2,2,4,1,2,1,Commerce,Masters,18-24,0,0,0,Remote,Tier2_City,3,3,2,5,2,0,5,40.06,Education,5,4,2,3,5,2,5,4,1,1,0,1,5,1,40.61
Finance,Paralegal,4.493883498671697,6,2,0,1,9,0,0,2,3,0,1,4,2,0,Commerce,Bachelors,18-24,14,0,0,Office,Tier2_City,2,4,0,1,0,3,5,36.42,Other,3,1,3,3,2,5,1,2,5,4,1,0,3,3,59.19
Music,Music Teacher,3.55420903143032,9,0,1,0,5,1,2,2,3,2,1,1,3,1,Arts,PhD,25-30,14,0,0,Hybrid,Tier2_City,3,5,3,4,0,2,5,18.0,Tech,4,1,5,4,3,1,5,4,5,3,0,1,5,3,67.89
Finance,Teacher,4.061513266599049,2,2,4,0,5,1,1,4,3,4,3,0,3,0,Commerce,Bachelors,18-24,14,1,47,Flexible,Tier2_City,3,4,0,2,1,5,1,26.04,Finance,2,1,2,2,4,3,1,5,2,1,0,1,5,5,52.3
Music,AI Researcher,3.926692489665754,4,0,2,1,8,0,4,2,0,2,0,1,0,0,Arts,High School,25-30,14,0,0,Remote,Tier2_City,3,5,3,3,2,3,5,6.58,Manufacturing,1,3,1,5,0,4,4,3,4,4,0,0,4,5,51.86
Music,Biochemist,4.785788551081014,5,2,4,1,6,1,2,0,3,2,0,0,4,1,Arts,Masters,18-24,10,0,0,Remote,Tier1_City,5,1,1,4,3,2,3,41.89,Other,2,4,3,2,2,5,4,2,1,4,0,1,2,3,49.86
Law,Forensic Psychologist,4.450245723366795,0,1,3,1,3,0,1,3,0,1,2,3,2,1,Arts,Masters,31-35,11,1,42,Office,Tier2_City,1,4,0,4,3,3,2,15.5,Manufacturing,2,1,3,5,4,1,3,1,2,5,0,1,4,3,62.04
Finance,Financial Advisor,3.2056801388811387,1,0,2,1,5,0,0,3,4,3,3,0,4,0,Commerce,Bachelors,36-40,9,0,0,Hybrid,Tier1_City,3,5,4,1,5,4,2,44.79,Healthcare,2,5,5,4,4,0,4,1,3,4,0,1,1,2,66.03
Law,Credit Analyst,3.786514462082586,6,1,2,0,3,1,4,2,3,3,0,3,4,1,Arts,Bachelors,40+,8,0,0,Hybrid,Tier2_City,2,4,2,3,2,2,5,31.05,Finance,4,3,2,4,0,1,3,5,1,3,0,0,1,4,52.9
Biology,Architectural Technologist,4.635185788736024,7,2,3,0,6,1,2,4,0,0,1,3,2,1,Science,High School,25-30,6,0,0,Office,Tier3_City,5,2,3,2,3,5,4,29.69,Education,3,3,1,4,4,4,2,1,4,5,1,0,4,5,49.43
Engineering,Game Developer,4.171537725340832,0,2,3,1,5,0,0,2,0,3,3,3,0,0,Science,Bachelors,25-30,0,1,23,Hybrid,Tier2_City,1,1,0,4,1,2,5,10.65,Education,2,5,5,3,0,1,1,5,3,2,1,1,5,1,35.93
Art,Urban Planner,4.056363622341565,7,2,3,1,9,0,4,2,2,4,2,2,1,0,Arts,Masters,36-40,6,0,0,Hybrid,Tier1_City,2,4,0,4,4,3,5,6.27,Other,4,4,2,2,4,1,2,2,1,2,1,1,5,3,56.28
Chemistry,Quantum Physicist,3.1685555141230424,0,0,3,1,9,0,4,1,0,4,2,4,1,1,Science,Bachelors,18-24,4,0,0,Remote,Tier1_City,5,2,5,1,0,1,1,28.97,Tech,3,4,5,5,2,2,3,4,5,4,1,0,1,4,57.1
Education,Biochemist,4.703738190895913,4,1,3,0,5,0,2,0,0,4,0,0,3,0,Arts,Bachelors,31-35,9,1,58,Office,Tier1_City,5,2,4,5,2,3,4,25.0,Healthcare,1,1,3,2,0,0,5,3,4,4,0,0,3,4,50.09
Marketing,Accountant,3.65442263851594,9,0,1,1,6,1,0,4,2,4,2,1,4,0,Commerce,Bachelors,25-30,12,0,0,Remote,Tier2_City,1,1,5,2,0,2,5,8.63,Other,3,5,3,5,0,5,1,4,5,3,1,1,1,5,58.81
Finance,Ecologist,2.7535692390222763,7,2,2,1,6,1,2,0,3,0,1,0,1,1,Commerce,High School,18-24,12,0,0,Flexible,Tier2_City,3,4,5,3,4,2,3,42.27,Manufacturing,3,2,2,1,4,2,2,4,3,4,1,1,1,2,45.82
Architecture,Financial Analyst,3.787168399017292,6,0,1,0,4,1,2,4,4,4,2,2,3,0,Interdisciplinary,Bachelors,25-30,6,1,22,Remote,Tier1_City,2,3,5,4,2,1,2,22.61,Manufacturing,2,4,5,2,5,4,2,3,2,1,1,0,1,3,49.76
Business,Aerospace Engineer,2.542016270542437,0,2,4,0,9,0,1,0,1,1,2,0,0,0,Commerce,Masters,18-24,11,0,0,Office,Tier3_City,4,3,1,4,4,0,3,15.24,Tech,4,1,2,1,3,0,2,2,5,3,0,0,4,3,57.42
Architecture,Investment Banker,4.975952486284653,0,2,1,1,6,0,0,1,2,1,1,1,1,0,Interdisciplinary,PhD,31-35,8,0,0,Hybrid,Tier1_City,3,3,4,2,3,1,3,40.05,Education,5,3,4,4,5,5,4,5,4,2,1,0,3,4,56.54
Art,Inorganic Chemist,4.763799045992082,7,1,2,0,5,0,2,2,2,0,1,2,3,0,Arts,Masters,25-30,7,0,0,Remote,Tier2_City,4,2,0,5,3,0,3,45.91,Education,1,4,2,3,5,5,5,1,5,5,1,1,4,2,59.68
Biology,Risk Analyst,3.661488051950637,5,0,2,0,0,0,2,3,0,1,1,1,3,1,Science,High School,25-30,5,0,0,Hybrid,Tier2_City,2,4,2,4,3,5,4,17.38,Manufacturing,4,2,4,3,0,4,2,3,2,4,0,1,4,4,42.02
Law,Architect,4.792867078339008,0,2,2,1,0,0,3,3,0,4,1,0,3,1,Arts,Masters,18-24,1,1,55,Remote,Tier2_City,4,5,0,2,4,2,4,39.47,Tech,2,3,3,2,3,4,2,4,1,4,0,1,4,1,46.03
Education,Art Director,4.214720457737977,0,1,1,1,7,1,1,2,0,0,1,0,1,1,Arts,Masters,36-40,7,0,0,Remote,Any,4,4,0,1,4,4,4,33.67,Other,4,3,1,1,5,5,2,3,2,5,1,1,1,1,48.69
Marketing,Biotechnologist,3.959946139559496,2,1,1,1,7,1,2,0,0,4,1,3,2,0,Commerce,Masters,25-30,11,0,0,Remote,Tier1_City,1,1,0,5,4,4,2,49.52,Finance,5,5,3,1,1,1,5,2,3,5,1,1,3,3,60.6
Engineering,Animator,2.8305662125508566,3,1,1,1,4,1,2,0,0,2,4,2,2,0,Science,Bachelors,25-30,13,1,11,Flexible,Tier1_City,1,5,5,3,0,3,1,12.59,Other,1,5,1,5,2,1,2,3,1,3,0,1,2,5,53.31
Law,Special Education Teacher,2.9395969791303984,5,1,1,0,2,1,4,1,3,0,3,2,3,0,Arts,Bachelors,25-30,3,0,0,Remote,Tier3_City,1,1,4,4,4,1,5,48.15,Healthcare,3,4,5,2,3,1,1,1,5,3,1,1,3,4,56.77
Psychology,Human Resources Specialist,3.3558024528658894,7,1,4,1,5,1,1,2,0,4,2,3,4,0,Arts,Bachelors,25-30,7,0,0,Flexible,Tier1_City,4,4,4,2,3,1,5,17.82,Education,1,2,1,2,5,1,4,4,5,5,0,1,3,3,60.51
Architecture,Conductor,3.164953675642028,3,2,3,1,8,1,1,3,4,3,2,1,1,0,Interdisciplinary,Bachelors,18-24,14,0,0,Remote,Any,4,1,3,1,1,4,1,22.36,Other,5,5,5,1,5,0,4,1,2,5,1,1,4,1,56.11
Marketing,Mechanical Engineer,4.291935694280828,3,1,4,0,7,0,1,1,0,2,1,2,0,0,Commerce,Bachelors,31-35,6,0,0,Office,Tier1_City,5,2,3,3,4,0,5,19.86,Education,1,1,4,1,2,5,2,1,1,4,1,0,3,4,42.51
Finance,Manager,3.726682950523131,0,0,0,0,1,0,4,3,3,4,4,2,4,1,Commerce,Bachelors,18-24,3,0,0,Flexible,Tier1_City,5,3,5,2,1,1,3,15.62,Education,1,3,5,3,0,2,5,1,2,4,0,0,3,3,58.35
Education,Biomedical Engineer,3.0103457340167945,5,2,2,0,5,1,0,3,0,2,1,3,4,0,Arts,Bachelors,18-24,7,0,0,Flexible,Tier2_City,1,4,5,2,3,0,2,35.58,Finance,2,1,2,2,5,0,5,1,1,4,0,1,4,5,47.34
Biology,Biomedical Engineer,4.0575490729556805,4,1,4,1,1,1,3,2,2,2,0,0,4,0,Science,Masters,31-35,10,0,0,Remote,Tier1_City,5,5,3,3,4,0,5,30.69,Finance,3,3,2,3,2,1,3,3,2,1,1,0,2,3,52.31
Finance,School Counselor,3.462348302801544,7,0,3,0,7,0,2,2,1,3,4,2,0,0,Commerce,Bachelors,18-24,10,0,0,Office,Tier1_City,3,5,0,1,0,0,2,17.37,Other,5,1,2,4,3,3,3,3,4,1,0,1,3,1,57.45
Biology,Fluid Mechanics Engineer,3.5613173083902376,6,0,3,0,1,1,2,4,3,3,3,3,1,1,Science,Bachelors,25-30,11,0,0,Remote,Any,5,1,3,1,0,0,1,9.21,Healthcare,2,3,3,4,5,4,1,4,4,2,0,0,4,2,64.75
Engineering,Nuclear Physicist,4.894782195465073,3,2,0,0,7,1,0,1,1,0,1,1,3,1,Science,PhD,25-30,10,0,0,Hybrid,Tier1_City,5,3,3,5,1,3,5,17.92,Education,1,5,2,1,5,5,1,5,1,3,1,1,1,3,42.98
Chemistry,Chemist,4.953147780571288,8,0,2,0,7,0,2,1,3,2,0,3,1,1,Science,PhD,25-30,1,0,0,Office,Tier2_City,3,4,1,4,5,3,2,20.92,Manufacturing,1,1,5,5,0,1,5,5,1,1,0,0,5,2,44.62
Biology,Cybersecurity Analyst,4.05240021591449,5,0,0,1,9,0,4,1,3,0,1,0,1,1,Science,Masters,31-35,8,0,0,Hybrid,Tier1_City,3,2,5,3,0,4,3,20.89,Education,4,4,5,1,5,1,1,1,2,3,0,1,5,2,46.93
Architecture,Digital Marketing Specialist,3.369114918989875,2,1,2,1,0,0,0,4,3,2,3,1,4,0,Interdisciplinary,PhD,31-35,5,0,0,Hybrid,Tier1_City,2,1,5,3,0,3,3,19.79,Healthcare,2,4,5,2,3,4,3,2,4,4,0,0,1,3,58.38
Music,Accountant,3.114112781141539,4,0,3,1,7,0,0,1,0,1,2,4,0,0,Arts,Bachelors,31-35,6,0,0,Remote,Tier1_City,4,4,4,3,0,5,1,5.29,Other,5,2,2,1,0,4,5,1,2,5,1,1,2,1,40.99
Psychology,Digital Marketing Specialist,4.836102989831865,7,1,2,0,0,1,1,1,1,1,2,4,2,1,Arts,PhD,31-35,9,0,0,Remote,Tier1_City,4,4,3,1,3,1,4,24.81,Healthcare,5,2,4,3,3,2,3,2,5,4,1,1,1,2,65.61
Biology,Web Developer,4.748394545134588,0,2,0,1,7,1,4,0,2,1,1,3,0,0,Science,Bachelors,25-30,0,0,0,Remote,Tier1_City,1,3,4,4,0,5,5,42.3,Manufacturing,5,2,4,1,0,0,2,2,1,5,1,1,5,2,34.61
Chemistry,Conductor,4.187272860602395,3,1,1,1,2,0,2,1,1,4,4,3,4,1,Science,Bachelors,25-30,2,0,0,Flexible,Any,2,5,2,5,2,3,3,11.48,Finance,5,1,3,3,5,5,2,1,4,5,0,1,3,3,53.08
Business,Actuary,2.5988038928059747,1,0,0,1,1,0,2,3,3,1,0,3,4,1,Commerce,Bachelors,25-30,13,0,0,Remote,Tier2_City,2,3,5,2,4,1,3,9.85,Manufacturing,1,3,5,4,3,4,1,4,5,2,0,0,1,1,61.62
Medicine,Web Developer,4.055190724980916,2,0,4,1,7,0,2,2,0,2,0,2,2,1,Science,Bachelors,25-30,9,0,0,Office,Tier3_City,2,1,1,2,0,1,1,25.18,Healthcare,1,2,5,3,1,5,3,2,1,3,0,1,1,4,42.89
Music,AI Researcher,3.7339609533208495,3,0,0,0,8,1,0,4,1,1,3,4,1,0,Arts,Bachelors,40+,4,1,8,Office,Tier1_City,2,1,2,3,5,0,3,20.42,Manufacturing,2,5,3,2,3,0,5,1,4,5,1,0,1,4,54.0
Engineering,Graphic Designer,2.501451367566011,9,0,2,0,9,1,4,4,3,2,3,0,3,1,Science,Masters,36-40,14,1,54,Hybrid,Tier1_City,5,3,5,4,5,4,5,29.38,Education,3,4,5,1,3,5,5,1,5,1,0,0,3,5,69.05
Engineering,Lawyer,2.504265348401006,5,1,1,1,4,0,1,2,0,3,1,2,1,1,Science,Masters,18-24,11,0,0,Office,Tier2_City,2,4,4,1,0,0,1,47.51,Healthcare,5,4,1,2,1,1,1,1,2,1,0,1,2,3,49.2
Psychology,Special Education Teacher,3.6154973062214246,1,0,2,1,8,0,4,1,4,1,2,2,1,0,Arts,Masters,18-24,6,0,0,Office,Tier3_City,1,5,4,4,0,0,2,38.76,Other,1,5,3,3,2,3,3,2,2,4,0,1,2,2,56.27
Business,Acoustics Specialist,3.29016603227418,8,1,2,0,4,1,1,2,2,3,4,3,2,0,Commerce,Bachelors,18-24,0,0,0,Hybrid,Tier1_City,4,1,2,4,2,5,1,35.29,Finance,2,4,5,3,0,3,1,3,4,4,0,0,2,1,48.14
Law,Psychologist,4.188803329217732,4,0,4,0,2,1,3,4,2,0,1,1,3,1,Arts,Masters,18-24,8,1,11,Hybrid,Tier1_City,2,3,3,1,0,3,5,22.55,Finance,5,1,3,3,5,2,5,2,3,2,0,1,1,2,55.47
Music,Industrial-Organizational Psychologist,3.5255190132489167,3,1,1,0,9,1,1,2,1,3,1,2,2,1,Arts,Masters,18-24,4,1,34,Flexible,Tier1_City,4,1,1,3,0,5,5,16.51,Manufacturing,3,5,1,3,3,2,2,3,3,2,0,1,4,4,44.16
Chemistry,Chemical Engineer,3.877903719103273,0,0,1,1,6,0,4,3,3,4,1,4,0,0,Science,Bachelors,25-30,12,0,0,Flexible,Tier1_City,3,5,4,4,4,3,2,28.39,Manufacturing,5,1,1,3,2,2,3,3,1,4,0,0,3,1,65.04
Architecture,Clinical Psychologist,2.530168809591426,7,0,4,0,6,1,0,3,3,0,0,3,0,0,Interdisciplinary,Masters,36-40,11,1,55,Office,Tier3_City,1,2,0,2,5,5,1,44.62,Manufacturing,4,4,2,1,4,3,1,4,1,2,0,0,3,1,53.01
Architecture,Social Media Manager,4.448272279758271,8,2,0,1,0,1,2,2,1,1,1,1,1,0,Interdisciplinary,Bachelors,31-35,2,0,0,Remote,Tier1_City,3,2,1,1,2,1,5,44.21,Other,5,5,5,5,2,4,2,5,5,5,1,0,5,3,46.92
Music,Aerospace Engineer,4.729941911156063,0,2,2,1,5,0,2,3,3,0,4,1,1,0,Arts,Bachelors,18-24,6,0,0,Hybrid,Tier1_City,2,4,2,5,5,3,5,23.94,Education,4,5,1,2,4,4,4,1,5,4,0,0,3,3,59.61
Law,Education Administrator,2.500556143579164,7,1,4,1,5,1,3,2,2,2,3,0,2,0,Arts,PhD,25-30,9,1,43,Hybrid,Tier2_City,5,4,4,3,2,3,2,14.57,Finance,3,5,1,4,0,4,3,1,2,2,1,0,2,5,62.38
Business,School Counselor,3.1052114987181154,9,2,2,1,0,1,0,3,0,3,4,0,1,0,Commerce,Bachelors,25-30,7,0,0,Office,Tier1_City,5,2,4,1,5,5,4,13.59,Healthcare,4,4,1,4,4,1,5,2,3,1,0,0,2,3,51.63
Physics,Financial Analyst,4.8625447781867175,3,0,1,1,8,0,1,4,1,3,4,2,0,1,Science,Bachelors,36-40,9,1,49,Office,Tier3_City,1,5,5,5,0,2,1,4.6,Healthcare,3,4,2,2,1,0,5,5,1,2,0,1,2,2,49.83
Finance,Aerospace Engineer,4.491344735830232,1,1,2,0,6,1,0,1,2,1,3,2,1,0,Commerce,Masters,36-40,9,0,0,Hybrid,Any,2,3,2,5,5,1,5,42.61,Finance,2,4,5,1,1,1,4,4,3,4,0,1,4,1,55.51
Medicine,Geneticist,4.410521144479493,2,1,1,0,7,1,3,3,4,1,2,4,0,0,Science,Masters,36-40,2,0,0,Office,Tier1_City,2,3,0,4,5,1,3,15.45,Other,4,2,3,2,2,5,3,1,5,1,0,1,4,2,59.0
Physics,Education Administrator,3.073349328158839,8,2,4,0,8,1,0,2,0,0,1,4,2,1,Science,Bachelors,25-30,6,0,0,Remote,Tier2_City,2,5,5,4,2,2,2,19.87,Manufacturing,5,2,2,3,1,2,1,2,3,5,0,0,3,5,48.25
Biology,Analytical Chemist,4.315015754984702,1,1,1,0,7,1,4,3,1,1,3,0,2,1,Science,Bachelors,31-35,6,0,0,Office,Tier2_City,2,3,0,4,1,5,4,41.03,Tech,5,3,5,5,1,2,3,4,2,3,1,0,5,1,50.99
Law,Biologist,4.592467060626097,1,1,1,0,8,0,3,1,2,2,1,0,2,0,Arts,High School,18-24,3,0,0,Remote,Tier1_City,1,4,4,1,2,5,4,8.64,Manufacturing,2,5,1,2,2,4,3,5,1,2,0,1,5,5,31.35
Law,Risk Analyst,2.714131451268135,3,0,2,1,5,0,2,3,4,4,1,0,1,0,Arts,Masters,25-30,9,0,0,Office,Tier2_City,1,3,3,1,2,1,2,24.68,Other,1,4,2,1,3,1,4,2,2,2,1,1,2,1,57.23
Engineering,Biologist,4.31401774351589,1,0,4,1,2,1,3,0,3,3,3,0,3,0,Science,Bachelors,18-24,8,0,0,Remote,Tier2_City,1,3,0,3,2,5,4,8.75,Finance,3,5,4,3,0,1,5,4,1,3,1,1,5,3,51.08
Medicine,Risk Analyst,3.335563794927124,8,2,4,1,8,1,1,1,0,2,3,2,1,1,Science,Bachelors,25-30,0,0,0,Remote,Tier2_City,5,4,0,4,3,4,5,23.77,Education,1,1,4,2,4,4,2,5,2,3,1,0,2,3,37.11
Engineering,Marketing Manager,2.8378730099577227,7,0,4,0,5,1,2,2,3,3,2,3,0,0,Science,PhD,31-35,0,1,37,Remote,Tier3_City,2,1,3,5,3,4,4,5.22,Manufacturing,1,1,1,2,2,0,5,1,5,4,1,1,2,4,56.7
Music,Special Education Teacher,4.785154694928379,4,0,1,0,5,0,2,2,1,1,1,4,4,0,Arts,Bachelors,25-30,4,0,0,Flexible,Tier1_City,3,2,5,2,3,2,1,27.33,Healthcare,2,4,5,3,1,0,3,5,4,5,1,1,4,4,53.57
Medicine,Musician,2.936816066480412,3,1,3,0,2,1,3,2,2,2,2,3,0,1,Science,Bachelors,18-24,12,0,0,Hybrid,Tier2_City,4,3,0,3,2,3,3,40.4,Education,2,2,5,1,4,1,5,2,2,4,1,0,4,4,59.99
Psychology,Surgeon,3.245193084102083,2,2,1,0,8,0,0,2,4,2,3,1,2,0,Arts,Bachelors,18-24,2,0,0,Hybrid,Tier3_City,1,2,3,1,1,4,5,34.79,Finance,4,3,2,5,3,1,4,1,2,1,1,0,1,4,41.51
Chemistry,Web Developer,3.058959327500448,1,0,1,1,0,1,3,0,1,2,0,1,4,0,Science,Masters,18-24,9,0,0,Office,Tier1_City,1,2,2,3,2,5,2,26.93,Tech,4,2,4,5,5,0,2,3,3,4,0,0,1,3,56.57
Physics,Inorganic Chemist,3.686809152890871,1,1,3,1,6,1,3,4,4,1,2,2,1,0,Science,Bachelors,18-24,12,0,0,Hybrid,Any,5,5,5,3,0,2,3,41.95,Manufacturing,4,5,5,3,0,3,2,2,5,3,0,1,1,5,63.59
Music,Construction Manager,3.737365242899572,9,1,1,0,7,0,0,4,3,3,1,3,0,0,Arts,Bachelors,18-24,8,0,0,Hybrid,Tier1_City,5,5,1,3,1,4,5,13.71,Education,4,2,2,4,0,3,1,3,4,5,1,0,3,2,61.97
Finance,Urban Planner,4.06702559172647,1,1,1,0,4,1,1,1,2,4,0,0,1,0,Commerce,Masters,18-24,4,0,0,Hybrid,Tier3_City,4,5,1,3,3,0,3,42.05,Education,4,4,2,1,1,2,5,5,4,4,0,0,5,4,50.39
Music,Biologist,3.0130407930494414,7,0,4,0,9,1,3,3,4,4,1,0,2,0,Arts,Bachelors,18-24,6,0,0,Remote,Tier3_City,5,1,2,2,5,2,4,15.99,Healthcare,5,2,4,4,3,1,5,4,1,1,1,0,1,5,53.73
Medicine,Financial Controller,3.5402671687456992,6,0,1,1,5,0,3,1,1,1,1,3,1,1,Science,Bachelors,40+,0,0,0,Remote,Tier2_City,1,1,0,4,5,1,2,20.04,Manufacturing,2,1,1,4,0,0,4,1,1,3,1,0,2,4,39.91
Biology,Chemist,3.87224513863166,5,0,0,0,7,0,0,2,0,1,3,1,1,0,Science,Bachelors,25-30,1,1,28,Remote,Tier1_City,2,2,1,5,4,4,2,9.04,Tech,3,4,2,4,4,4,5,2,4,2,0,0,3,4,41.91
Marketing,Conductor,2.685437035038405,1,2,3,1,5,0,0,3,4,3,1,2,0,0,Commerce,High School,18-24,14,0,0,Office,Tier1_City,2,2,2,3,1,1,1,7.78,Education,3,4,1,1,4,4,4,1,4,3,0,0,5,3,50.8
Education,Accountant,3.137016451795053,9,0,1,0,6,1,0,0,2,3,3,2,0,0,Arts,Bachelors,25-30,10,1,31,Remote,Tier1_City,5,2,1,3,3,2,4,46.81,Healthcare,3,4,4,4,5,3,1,5,5,1,0,1,1,5,57.18
Marketing,Game Developer,4.63198876604878,2,2,3,0,9,0,4,4,3,0,2,1,2,0,Commerce,Bachelors,36-40,11,0,0,Hybrid,Tier2_City,4,2,0,3,1,4,1,11.93,Manufacturing,3,2,2,3,1,0,3,5,4,4,1,1,5,4,61.01
Chemistry,Mechanical Engineer,4.483753679884605,3,0,0,0,8,0,3,1,4,1,3,0,4,1,Science,Bachelors,31-35,3,0,0,Hybrid,Tier1_City,2,4,5,4,1,1,1,18.66,Manufacturing,3,1,3,2,3,3,5,4,1,4,0,1,1,3,46.29
Chemistry,Legal Secretary,2.7937565236133257,5,0,3,1,0,0,0,0,0,3,2,4,1,0,Science,High School,25-30,14,0,0,Remote,Tier2_City,1,2,3,1,5,3,4,27.87,Tech,5,2,4,3,4,3,3,4,1,4,1,1,2,1,50.5
Music,Aerospace Engineer,3.9188878748733806,8,1,3,0,8,1,1,0,4,4,0,1,1,0,Arts,Masters,25-30,8,1,32,Flexible,Tier1_City,2,5,2,1,2,3,5,19.35,Healthcare,2,5,4,2,0,1,1,2,3,2,0,1,4,4,53.72
Business,Physician Assistant,2.6267933910007994,5,2,2,1,4,0,1,1,4,4,2,3,2,1,Commerce,PhD,31-35,4,0,0,Flexible,Tier1_City,4,2,5,2,0,0,1,43.9,Tech,4,3,3,5,4,1,5,1,4,1,0,0,5,1,56.84
Physics,Aerospace Engineer,4.319778212387722,4,0,3,1,9,1,4,3,4,1,2,0,2,1,Science,Masters,31-35,4,0,0,Remote,Tier1_City,5,5,1,1,4,5,3,45.33,Education,4,3,4,4,5,0,5,2,5,5,0,1,4,2,65.2
Law,Lawyer,4.925049586652852,8,0,2,1,9,1,1,2,2,3,0,3,2,0,Arts,Masters,31-35,8,0,0,Office,Tier2_City,3,5,0,3,3,2,5,18.32,Other,4,3,3,5,0,2,3,3,2,2,1,0,4,3,52.52
Physics,Artist,3.120750241543647,2,2,1,0,4,0,4,3,4,1,0,4,0,0,Science,Bachelors,36-40,7,0,0,Hybrid,Tier3_City,2,2,5,3,1,5,4,7.33,Finance,2,5,3,5,3,1,1,5,1,3,1,0,2,1,57.78
Business,Musician,4.551546351558858,8,0,3,1,6,0,2,4,3,0,0,2,2,0,Commerce,PhD,36-40,1,1,21,Office,Tier1_City,1,2,1,3,4,5,2,12.88,Finance,2,5,4,1,1,2,1,3,2,1,0,1,4,5,43.47
Art,Advertising Manager,2.819821918105144,6,2,1,1,4,1,1,0,1,4,0,2,4,0,Arts,Bachelors,25-30,6,1,48,Remote,Tier1_City,4,3,0,2,1,1,5,25.3,Tech,5,5,3,4,5,3,3,3,1,1,0,0,5,5,34.47
Medicine,Mechanical Engineer,4.598018298976286,9,0,2,0,1,0,1,2,4,2,3,1,1,1,Science,PhD,25-30,0,1,29,Remote,Any,2,5,0,3,5,0,1,16.56,Tech,5,1,3,5,5,5,3,1,5,5,0,0,3,3,62.06
Education,Acoustics Specialist,2.9433695906924604,4,0,1,1,9,0,3,3,4,2,0,2,0,0,Arts,PhD,31-35,9,0,0,Flexible,Tier1_City,3,2,0,1,0,2,3,24.31,Other,4,4,4,2,1,3,5,3,2,1,0,1,5,2,56.42
Architecture,Paralegal,3.9530508511941953,2,1,3,1,2,1,4,3,0,1,0,1,4,0,Interdisciplinary,Masters,36-40,10,1,16,Flexible,Tier3_City,5,2,0,4,5,3,4,38.66,Other,2,5,3,2,1,0,1,3,3,3,0,0,1,4,55.98
Education,Paralegal,3.430728069738076,9,0,1,0,3,1,3,3,3,3,0,2,0,0,Arts,PhD,18-24,10,0,0,Hybrid,Tier2_City,2,3,2,4,4,5,2,22.77,Other,4,3,1,1,2,0,2,4,5,2,1,0,1,1,68.13
Psychology,Analytical Chemist,2.9169910236137766,4,0,2,1,9,1,1,2,1,1,0,2,2,0,Arts,Masters,40+,14,0,0,Flexible,Tier1_City,4,4,5,5,3,1,3,12.26,Other,5,3,4,5,1,5,1,2,1,3,1,1,1,5,49.64
Finance,Curriculum Developer,4.994894921412273,7,0,1,1,1,1,1,0,4,1,0,2,4,1,Commerce,Bachelors,18-24,8,1,31,Office,Tier2_City,2,5,3,1,1,5,2,19.82,Finance,4,2,4,5,1,3,5,4,4,3,1,0,5,1,51.84
Physics,Special Education Teacher,3.558634844540266,8,0,0,1,2,1,0,4,4,1,3,1,2,1,Science,Bachelors,25-30,2,0,0,Remote,Any,5,5,2,3,0,4,4,37.92,Education,5,4,1,5,0,2,3,1,2,1,0,0,5,5,38.06
Architecture,Inorganic Chemist,2.7948908764938665,2,0,0,1,9,1,2,0,1,3,1,3,2,0,Interdisciplinary,Masters,36-40,12,0,0,Hybrid,Any,4,3,1,4,5,3,5,22.93,Other,1,5,5,1,5,2,5,2,4,2,1,1,4,5,55.78
Biology,AI Researcher,4.351737240879412,6,1,0,0,4,0,4,2,1,0,2,2,4,0,Science,Bachelors,18-24,1,0,0,Remote,Tier2_City,3,4,2,1,4,5,1,14.73,Other,3,4,2,4,3,3,2,2,1,5,1,0,4,1,47.57
Biology,Counselor,2.964375944594128,9,2,2,1,8,0,3,2,2,0,4,1,1,1,Science,Masters,25-30,3,0,0,Office,Tier2_City,1,1,2,4,5,4,4,23.09,Tech,1,5,3,5,3,4,1,5,2,3,1,0,5,3,52.0
Finance,Music Therapist,3.620877379165024,3,2,0,1,7,0,4,3,1,2,4,3,4,0,Commerce,PhD,18-24,3,0,0,Flexible,Tier1_City,5,3,1,3,1,4,3,24.38,Other,4,3,3,5,4,4,2,5,2,4,0,1,3,3,65.31
Finance,Investment Banker,3.0803528389451054,8,1,2,0,7,1,1,3,0,1,2,2,1,1,Commerce,Bachelors,25-30,2,0,0,Hybrid,Tier1_City,2,2,3,4,1,1,5,16.93,Education,4,4,2,3,1,2,1,3,2,2,0,0,2,1,35.47
Computer Science,Entrepreneur,3.4935564337922016,8,2,3,0,2,0,3,2,0,3,2,0,1,1,Science,Masters,18-24,1,1,58,Office,Tier1_City,3,2,2,5,3,1,2,49.8,Education,2,4,3,2,3,4,5,2,5,1,0,0,4,4,43.1
Chemistry,Acoustics Specialist,4.961706155667197,4,0,0,1,6,0,1,2,4,4,1,1,1,0,Science,PhD,25-30,4,1,59,Office,Any,4,2,0,5,0,4,5,39.08,Healthcare,3,5,3,4,3,5,2,2,5,3,1,0,4,2,58.38
Psychology,Civil Engineer,4.535724045492153,5,1,0,0,3,1,2,1,4,3,2,3,4,1,Arts,PhD,25-30,3,1,8,Remote,Tier1_City,4,1,2,4,2,0,5,35.55,Education,5,5,1,4,5,5,5,5,5,3,0,1,5,3,64.57
Art,Astronomer,3.486263583948392,4,1,3,0,3,1,4,2,4,2,0,0,1,1,Arts,PhD,40+,4,0,0,Hybrid,Tier1_City,4,2,1,1,5,5,3,43.18,Other,4,4,1,4,3,1,5,3,5,3,0,1,3,5,66.51
Business,Chemical Engineer,2.649481118297505,0,2,0,1,8,0,2,4,1,0,2,4,4,1,Commerce,Bachelors,40+,12,1,7,Hybrid,Tier2_City,2,1,3,1,1,4,1,34.32,Manufacturing,5,5,1,5,3,0,5,5,1,3,0,1,4,5,54.96
Marketing,Conductor,2.9590144514187102,9,2,4,0,8,1,1,1,3,4,3,2,2,0,Commerce,PhD,18-24,11,1,15,Hybrid,Tier2_City,5,3,2,1,4,4,5,40.18,Other,5,4,1,3,0,0,2,2,3,3,1,1,1,4,71.01
Chemistry,Brand Manager,4.810830759487105,4,2,1,1,3,1,2,1,4,3,4,2,2,1,Science,Masters,31-35,11,0,0,Flexible,Tier1_City,3,1,2,4,5,1,5,22.39,Finance,5,2,4,4,1,4,1,1,1,3,1,1,1,1,70.03
Medicine,Astronomer,4.019000546325563,9,2,0,0,0,0,4,3,2,2,4,4,2,0,Science,Bachelors,18-24,7,0,0,Remote,Tier1_City,4,2,1,1,3,5,1,26.52,Finance,1,4,3,1,3,3,5,5,2,5,1,1,4,4,64.55
Architecture,Doctor,3.900573259608311,3,2,4,0,2,1,1,0,0,3,2,3,2,0,Interdisciplinary,Bachelors,18-24,10,0,0,Hybrid,Tier2_City,1,5,4,3,3,2,1,5.21,Tech,5,1,2,1,0,1,5,4,5,4,0,1,5,1,56.53
Law,Manager,3.562734347792877,4,2,0,0,5,1,4,0,3,4,3,3,0,1,Arts,Masters,18-24,14,0,0,Office,Tier3_City,5,2,4,5,1,3,2,16.19,Tech,2,4,3,2,2,4,3,5,2,5,1,1,5,5,66.33
Physics,Civil Engineer,2.984927905891859,6,1,2,0,6,0,0,2,4,0,4,4,2,1,Science,Bachelors,40+,1,0,0,Remote,Tier2_City,3,1,5,3,1,1,2,20.3,Healthcare,1,2,4,3,4,5,3,2,5,5,0,1,5,4,54.98
Physics,Surgeon,4.476687423554208,9,0,4,1,0,0,0,4,2,1,0,4,1,0,Science,Masters,36-40,8,0,0,Hybrid,Tier1_City,3,1,2,1,1,5,1,32.4,Other,1,2,4,4,0,3,2,3,4,3,0,0,3,3,58.95
Medicine,Digital Marketing Specialist,3.373629290101388,9,2,4,1,7,1,2,1,0,2,3,4,2,1,Science,Masters,18-24,9,0,0,Remote,Tier2_City,4,4,5,3,2,5,4,24.82,Healthcare,4,3,3,3,4,5,4,2,4,3,1,1,1,1,57.94
Physics,Architect,4.671104163463118,9,0,3,1,3,1,2,2,2,3,1,3,2,0,Science,Bachelors,18-24,0,0,0,Hybrid,Tier2_City,1,4,0,1,1,0,1,31.57,Manufacturing,3,3,3,1,4,3,5,3,5,3,1,0,2,1,44.71
Marketing,Analytical Chemist,4.047057941055742,1,2,3,0,3,1,1,2,1,0,0,0,2,1,Commerce,Masters,18-24,7,0,0,Office,Tier1_City,4,4,2,4,5,3,2,36.53,Tech,3,1,1,4,2,2,2,2,4,2,0,0,4,3,45.99
Finance,Biologist,4.724496766323259,1,2,1,1,9,1,2,1,4,3,4,3,2,1,Commerce,Masters,25-30,11,1,9,Remote,Tier1_City,5,2,5,3,5,1,3,5.01,Finance,4,5,4,5,2,1,1,4,5,1,0,1,3,5,76.32
Chemistry,AI Researcher,4.88809618902852,7,1,3,0,8,1,4,2,3,3,4,3,1,0,Science,Bachelors,25-30,4,1,45,Office,Tier3_City,2,1,4,4,0,1,3,15.14,Manufacturing,3,5,3,1,2,1,2,4,3,1,0,1,3,2,50.32
Medicine,Urban Planner,3.228846641081743,3,0,3,0,0,1,1,0,4,3,4,4,0,0,Science,High School,18-24,1,0,0,Hybrid,Tier2_City,5,4,2,4,4,2,5,11.03,Tech,5,2,2,2,0,2,5,3,2,4,0,0,5,5,45.11
Engineering,Chemical Engineer,3.961807613954933,8,1,4,0,6,1,1,1,0,1,4,2,2,0,Science,High School,31-35,7,0,0,Remote,Tier1_City,1,5,0,2,1,0,3,11.81,Manufacturing,2,2,2,4,2,3,1,4,1,5,1,1,4,3,42.8
Art,Conductor,2.5421286841804704,7,1,2,0,8,1,4,4,3,3,3,0,0,0,Arts,Bachelors,25-30,4,0,0,Hybrid,Tier1_City,2,3,3,1,5,0,2,26.65,Other,5,3,1,2,5,3,3,1,1,5,1,0,3,3,55.46
Education,Human Resources Specialist,3.5803742165292327,1,2,0,0,0,1,4,4,3,3,4,2,1,0,Arts,PhD,36-40,9,0,0,Flexible,Tier3_City,3,3,2,5,5,5,3,37.78,Education,3,2,1,3,3,5,5,1,1,4,0,0,1,1,77.03
Law,Nuclear Physicist,4.562507219497473,6,1,0,0,2,0,0,3,1,3,2,0,4,1,Arts,Bachelors,31-35,14,0,0,Remote,Tier2_City,4,4,1,1,5,5,4,15.82,Education,3,4,3,2,0,4,3,4,5,4,0,1,2,4,62.27
Education,Principal,4.529647733552758,3,2,2,1,7,0,3,4,3,3,2,1,3,0,Arts,Masters,25-30,13,1,48,Hybrid,Any,5,4,0,5,2,1,1,41.75,Manufacturing,2,4,2,2,1,0,5,5,5,2,1,1,4,5,66.87
Psychology,Physical Chemist,3.364757370152728,2,2,0,1,4,0,2,3,2,0,2,3,3,1,Arts,Bachelors,31-35,9,0,0,Office,Tier2_City,4,4,2,1,4,2,1,44.95,Tech,1,1,4,5,2,5,1,4,3,4,0,1,3,1,61.69
Art,Legal Secretary,3.2310333028365577,8,2,3,0,8,1,3,1,2,3,1,0,4,1,Arts,Bachelors,36-40,12,1,58,Hybrid,Tier1_City,5,3,4,4,3,1,2,19.48,Education,1,4,5,2,0,2,5,3,5,4,0,0,3,2,59.05
Medicine,Digital Marketing Specialist,4.718516179532432,1,2,0,1,1,1,2,1,2,3,4,4,2,0,Science,Masters,25-30,13,1,24,Remote,Tier3_City,4,4,5,3,5,4,5,35.02,Education,2,1,2,5,2,4,5,4,1,4,0,0,1,3,71.24
Finance,Aerospace Engineer,2.7032937641611223,0,1,2,1,6,1,0,4,4,2,4,0,2,0,Commerce,Masters,25-30,2,0,0,Hybrid,Tier1_City,2,5,2,3,1,5,1,8.5,Manufacturing,1,3,4,2,4,1,2,4,4,3,1,1,4,1,52.98
Marketing,Legal Consultant,2.9615101182761023,5,2,0,1,8,1,2,2,0,0,2,3,1,0,Commerce,Bachelors,36-40,6,0,0,Office,Tier1_City,4,5,5,2,5,4,3,37.97,Education,3,4,2,5,3,1,4,3,2,2,1,1,3,5,50.41
Architecture,School Psychologist,2.794779450567264,1,2,0,1,3,0,3,2,2,0,4,4,2,1,Interdisciplinary,Bachelors,18-24,3,0,0,Flexible,Tier1_City,1,5,4,5,4,2,4,10.76,Other,1,1,3,1,4,1,2,1,5,3,1,1,2,4,57.61
Computer Science,Animator,2.9342406933458145,1,2,3,1,5,0,2,1,1,2,2,4,1,0,Science,High School,18-24,10,0,0,Remote,Tier1_City,1,5,1,5,3,1,5,35.31,Finance,3,5,5,5,2,0,4,5,1,2,0,1,2,3,47.68
Psychology,Nuclear Physicist,4.639327145323021,7,0,1,1,9,0,1,4,1,2,2,1,3,0,Arts,Bachelors,25-30,10,0,0,Hybrid,Tier3_City,4,1,3,5,2,5,5,22.83,Education,4,1,5,1,0,2,4,2,2,1,1,0,2,4,48.98
Finance,Human Resources Specialist,3.0923837342115688,5,0,0,0,3,0,4,3,4,2,0,4,1,0,Commerce,Masters,36-40,9,1,7,Remote,Tier2_City,3,4,4,4,0,2,5,46.64,Other,5,4,3,1,5,5,1,5,2,5,0,0,4,5,61.66
Marketing,Legal Consultant,4.99125359898728,3,1,3,0,6,1,2,1,3,1,3,3,4,0,Commerce,Bachelors,31-35,11,1,56,Office,Tier1_City,1,2,2,5,1,1,1,24.83,Manufacturing,1,1,3,4,3,0,5,2,5,5,0,1,2,3,64.98
Marketing,Market Research Analyst,4.794792963431952,7,2,2,1,3,1,2,4,2,3,4,0,0,1,Commerce,Bachelors,36-40,14,1,8,Remote,Tier2_City,5,1,1,3,0,1,5,4.45,Education,4,3,1,1,4,3,3,4,5,1,0,1,5,4,56.89
Architecture,Surgeon,3.109963998332378,8,2,3,1,0,1,0,4,1,2,1,2,1,1,Interdisciplinary,Bachelors,25-30,5,0,0,Remote,Tier2_City,4,2,0,4,2,4,2,25.59,Education,1,2,4,4,3,3,5,1,5,4,0,0,2,3,50.47
Architecture,Data Scientist,4.678340936047492,9,1,4,1,6,0,4,2,3,1,1,4,3,0,Interdisciplinary,PhD,18-24,9,0,0,Office,Any,4,2,2,1,4,3,3,40.39,Healthcare,4,5,4,5,3,1,4,4,3,1,1,1,4,2,66.29
Law,Interior Designer,2.609913197232089,0,0,2,1,6,1,1,4,1,4,1,4,3,0,Arts,PhD,25-30,7,0,0,Remote,Any,1,1,5,5,4,0,4,33.41,Manufacturing,2,3,1,3,2,2,4,2,1,2,0,1,1,3,59.76
Business,Fluid Mechanics Engineer,4.800636159137738,1,0,1,0,8,0,0,1,1,2,2,1,4,0,Commerce,High School,31-35,0,0,0,Hybrid,Tier1_City,3,4,5,5,2,5,3,48.42,Manufacturing,4,5,4,4,3,4,1,1,5,1,0,0,5,3,32.12
Law,Biomedical Engineer,2.7332322104360776,4,1,4,1,4,1,1,2,4,2,3,1,3,1,Arts,Masters,18-24,1,0,0,Flexible,Any,5,1,5,1,5,0,2,42.63,Other,3,5,5,3,1,3,2,2,2,5,1,0,3,3,53.73
Chemistry,Geneticist,4.466076575961535,3,2,0,0,2,0,3,4,2,3,0,3,4,0,Science,Bachelors,18-24,13,0,0,Flexible,Tier1_City,1,3,0,5,2,2,2,27.75,Healthcare,2,1,2,5,1,4,4,4,3,5,0,0,2,3,67.21
Law,Paralegal,2.534012770106436,9,2,1,1,0,0,2,4,3,4,1,0,2,0,Arts,Bachelors,18-24,12,0,0,Remote,Tier1_City,1,5,5,1,1,0,3,12.71,Healthcare,2,2,5,4,4,5,4,2,1,4,0,0,1,2,54.5
Music,Investment Banker,2.642502164460375,5,2,3,0,0,1,0,0,0,0,0,1,4,0,Arts,Masters,25-30,7,1,59,Hybrid,Tier1_City,2,1,5,4,3,4,1,3.18,Other,3,1,1,5,4,4,2,1,4,1,1,1,5,2,43.27
Business,Counselor,2.7009622676035208,1,0,4,1,6,1,3,3,1,3,1,3,2,1,Commerce,PhD,36-40,14,1,50,Hybrid,Tier1_City,1,1,4,3,0,3,2,49.08,Finance,1,1,4,3,5,5,3,5,5,4,1,1,3,3,69.95
Law,Lawyer,4.298374771111185,4,0,1,1,7,0,3,2,4,1,0,1,3,1,Arts,PhD,31-35,6,0,0,Hybrid,Tier3_City,5,3,5,1,0,5,5,47.1,Education,2,4,4,5,0,5,2,4,5,3,1,1,3,3,61.6
Chemistry,Legal Secretary,3.6463010063454258,5,2,3,1,6,1,1,1,1,2,2,4,2,0,Science,Masters,40+,9,1,21,Flexible,Tier2_City,2,5,1,2,4,1,4,15.88,Tech,1,1,2,3,2,3,2,2,4,2,1,0,2,5,56.87
Chemistry,Curriculum Developer,4.059167135165934,8,1,4,0,4,0,4,0,4,3,3,0,2,0,Science,Bachelors,18-24,8,0,0,Office,Tier2_City,3,2,3,1,5,1,4,33.0,Tech,5,2,2,1,4,4,2,2,5,4,1,1,3,5,67.13
Business,Market Research Analyst,3.9827565310737953,9,0,4,0,8,1,1,1,2,2,2,4,0,1,Commerce,Masters,36-40,1,0,0,Office,Any,3,3,2,5,4,4,2,37.27,Healthcare,4,3,2,3,0,4,4,5,1,5,0,1,2,5,51.8
Chemistry,Nurse,3.328129876590453,1,2,3,0,9,1,4,3,2,3,1,3,1,1,Science,Bachelors,36-40,7,1,54,Remote,Tier1_City,1,4,1,4,1,5,5,30.17,Manufacturing,4,1,5,3,5,5,3,1,3,2,1,0,2,3,56.51
Computer Science,Electrical Engineer,2.903948886200774,5,2,2,1,2,0,1,0,1,4,1,4,0,0,Science,Masters,25-30,5,0,0,Hybrid,Tier1_City,5,1,1,4,2,0,3,42.62,Manufacturing,3,2,1,1,4,5,1,3,2,3,1,1,5,5,44.59
Music,Actuary,3.9420442442255417,2,2,2,1,9,0,1,4,2,4,1,3,1,0,Arts,Bachelors,40+,14,1,39,Hybrid,Tier2_City,3,1,3,1,0,1,4,6.66,Other,3,1,1,4,0,4,1,3,4,1,0,1,1,1,59.5
Biology,Brand Manager,4.946372553722957,2,1,0,0,8,1,3,1,4,3,1,4,3,1,Science,Masters,25-30,0,0,0,Remote,Any,5,3,5,3,1,0,5,45.14,Finance,4,5,1,2,2,0,1,3,1,3,1,1,5,2,46.09
Education,School Psychologist,4.372030255391203,5,0,2,0,6,0,1,4,1,4,1,4,1,0,Arts,Bachelors,36-40,3,1,50,Remote,Any,5,1,4,2,4,4,5,21.42,Tech,5,1,5,4,2,5,5,4,1,1,1,1,5,4,46.2
Physics,Lawyer,3.465346410567424,5,0,0,1,4,1,4,2,4,1,1,3,2,0,Science,Bachelors,36-40,13,1,13,Remote,Tier1_City,2,5,5,4,4,1,1,25.59,Other,3,4,3,2,4,2,5,3,4,1,0,0,4,3,60.53
Medicine,Civil Engineer,3.8725018771886255,1,2,0,0,8,0,1,3,2,1,4,0,4,1,Science,PhD,31-35,14,0,0,Remote,Tier3_City,1,5,5,5,0,2,2,23.9,Other,5,5,4,1,1,1,1,3,3,4,0,1,4,2,60.34
Architecture,Marketing Manager,3.083585807999733,1,2,3,1,6,0,3,4,4,0,1,2,4,1,Interdisciplinary,Bachelors,25-30,1,0,0,Remote,Tier3_City,5,3,3,5,4,3,5,27.97,Manufacturing,3,2,5,4,3,0,3,5,3,2,0,1,2,2,44.96
Architecture,Illustrator,4.682217224321197,6,0,3,0,0,0,3,0,2,4,0,3,1,0,Interdisciplinary,Bachelors,18-24,6,0,0,Remote,Tier1_City,5,3,3,3,5,0,3,31.11,Finance,2,1,1,5,4,4,2,3,2,2,0,1,1,4,54.27
Education,School Counselor,2.6516376986058776,0,1,1,1,7,0,3,0,4,1,3,3,2,1,Arts,Bachelors,25-30,8,0,0,Remote,Tier2_City,5,3,3,4,4,5,4,36.39,Finance,1,5,5,5,0,0,2,2,2,3,1,1,3,4,58.09
Education,Sound Engineer,3.4302612842690383,0,2,3,0,2,1,1,3,0,1,4,1,2,1,Arts,High School,25-30,5,0,0,Hybrid,Tier1_City,1,4,5,1,3,0,1,27.67,Healthcare,4,5,5,4,2,0,4,5,2,5,1,1,1,1,48.53
Biology,Landscape Architect,3.481019540238902,8,0,4,1,6,1,0,4,1,0,1,4,3,1,Science,High School,31-35,3,1,46,Hybrid,Tier2_City,2,1,0,5,2,0,3,35.18,Tech,1,3,3,5,4,2,4,2,3,3,1,0,3,1,39.25
Finance,Financial Advisor,3.392745133560997,0,0,0,1,1,1,2,3,3,4,3,3,3,0,Commerce,Bachelors,31-35,4,0,0,Hybrid,Any,5,2,5,3,4,0,4,18.9,Finance,4,5,2,1,2,2,4,4,5,3,0,0,2,1,60.76
Music,Astronomer,2.785873820287462,1,2,3,0,7,1,1,2,3,3,4,4,1,1,Arts,Masters,36-40,10,1,41,Flexible,Tier3_City,4,2,2,4,3,4,2,47.02,Finance,3,2,1,5,4,4,2,5,5,4,0,1,1,4,78.79
Architecture,Urban Planner,2.639607907077651,5,2,1,0,5,0,0,3,1,0,2,1,4,0,Interdisciplinary,Bachelors,18-24,0,1,55,Hybrid,Tier2_City,2,2,3,4,1,4,3,6.03,Finance,1,1,5,5,2,5,5,2,5,5,1,1,5,5,42.6
Engineering,Biochemist,4.150524823198438,2,0,4,0,4,1,4,4,2,2,2,3,1,0,Science,PhD,36-40,12,0,0,Office,Tier3_City,1,3,2,4,4,5,4,28.64,Tech,5,5,2,2,1,0,5,2,4,4,0,0,4,3,76.18
Marketing,Graphic Designer,3.070808918602247,1,2,2,1,2,1,3,4,1,1,4,2,0,1,Commerce,Masters,36-40,3,0,0,Flexible,Tier1_City,3,4,5,4,5,4,1,7.11,Healthcare,3,2,4,2,0,2,1,1,4,2,1,0,3,2,54.7
Psychology,Principal,2.8650153146355986,9,2,1,1,2,0,0,3,0,0,4,2,4,1,Arts,Bachelors,31-35,12,0,0,Remote,Tier1_City,5,4,5,4,1,5,4,23.81,Education,2,3,4,3,4,2,4,1,4,4,1,0,2,1,54.94
Computer Science,Brand Manager,2.621704528462556,2,0,0,1,9,1,1,1,0,3,1,0,0,0,Science,Masters,18-24,9,0,0,Hybrid,Tier1_City,4,2,3,5,4,5,5,15.11,Manufacturing,1,1,4,1,2,0,5,1,4,3,1,1,2,5,54.04
Marketing,Special Education Teacher,4.877984019133818,3,1,3,1,3,0,3,4,1,1,2,0,4,1,Commerce,Bachelors,18-24,2,0,0,Hybrid,Tier3_City,3,2,4,3,0,4,1,47.03,Other,1,4,5,5,4,2,4,1,3,2,1,1,5,5,44.03
Art,Industrial-Organizational Psychologist,2.527544270946422,6,0,1,0,8,1,2,4,1,1,1,3,1,0,Arts,Masters,18-24,8,0,0,Hybrid,Any,3,4,4,4,3,1,3,3.61,Other,2,5,5,1,0,3,2,3,4,4,1,0,2,4,60.72
Music,Physical Chemist,2.5138851414780103,4,2,4,0,1,1,0,2,4,0,1,4,2,0,Arts,Bachelors,31-35,5,0,0,Remote,Tier2_City,5,3,3,2,3,4,2,21.39,Tech,4,5,3,1,4,2,3,4,2,1,1,0,1,2,40.64
Architecture,Composer,3.753038812989102,5,1,2,1,0,0,3,0,1,1,1,3,1,0,Interdisciplinary,Bachelors,31-35,14,0,0,Office,Any,5,3,1,2,0,1,1,39.76,Tech,3,3,1,2,3,4,4,3,4,3,1,0,4,5,50.07
Finance,Legal Analyst,3.980944665938487,5,2,1,0,4,0,3,0,3,4,4,3,0,1,Commerce,Masters,40+,3,1,58,Remote,Tier3_City,3,2,2,3,2,2,1,11.86,Other,2,2,2,5,2,4,1,4,1,3,0,1,1,3,55.9
Law,Physician Assistant,2.539489085338739,9,0,1,1,1,0,4,1,2,3,2,4,1,1,Arts,PhD,25-30,2,1,56,Flexible,Tier2_City,4,5,4,1,5,4,1,41.33,Tech,5,3,4,3,0,1,3,5,5,4,1,0,1,1,69.17
Medicine,Graphic Designer,3.661515247940061,8,0,0,0,0,0,0,4,3,1,3,1,3,1,Science,Masters,25-30,11,0,0,Office,Tier2_City,2,3,0,1,3,2,4,43.41,Education,3,2,2,4,5,1,3,4,1,5,0,1,5,1,61.61
Architecture,Advertising Manager,3.589400983659756,3,1,4,1,6,0,2,0,0,3,2,4,2,0,Interdisciplinary,Bachelors,31-35,14,0,0,Hybrid,Tier3_City,5,5,1,1,1,4,5,36.28,Manufacturing,2,1,3,3,1,0,5,3,1,1,0,1,5,4,47.73
Art,School Psychologist,3.14185382886942,3,0,3,1,6,1,2,2,3,0,0,0,3,1,Arts,Masters,36-40,12,1,22,Remote,Tier1_City,5,1,4,2,5,2,2,12.83,Manufacturing,2,5,4,2,3,5,3,5,2,4,1,0,3,5,53.1
Art,Music Teacher,3.714330198662672,1,2,1,0,1,1,0,3,3,0,4,2,0,1,Arts,Bachelors,36-40,3,1,14,Hybrid,Tier1_City,1,3,1,1,3,3,2,15.79,Finance,1,4,2,3,4,4,1,5,3,3,1,1,2,3,47.01
Art,Music Teacher,3.168241380863717,6,1,2,1,4,1,3,0,2,2,2,4,3,1,Arts,Bachelors,36-40,7,0,0,Remote,Tier1_City,5,5,5,5,2,2,5,10.85,Other,1,3,1,2,5,1,5,5,2,3,0,1,3,5,54.11
Computer Science,Biologist,4.484237076082152,8,1,0,1,2,1,2,0,1,2,4,2,1,1,Science,Bachelors,25-30,11,0,0,Remote,Any,1,1,2,4,1,1,4,11.65,Other,1,4,1,2,4,0,3,1,3,3,0,0,5,4,56.63
Art,AI Researcher,3.46733071627503,8,1,2,0,1,1,2,2,3,4,3,0,3,0,Arts,Masters,31-35,4,0,0,Office,Any,3,1,5,2,5,0,4,4.72,Other,3,4,3,1,3,1,3,3,2,4,0,1,3,4,56.97
Marketing,Accountant,2.5095778376023428,2,2,3,1,6,1,0,1,0,2,2,4,3,0,Commerce,Bachelors,36-40,12,0,0,Hybrid,Tier1_City,4,2,5,3,1,5,5,43.29,Finance,4,5,2,5,1,2,1,1,3,2,1,0,4,1,50.54
Architecture,Architectural Technologist,3.926097502163142,1,0,4,1,8,0,1,1,0,4,4,3,2,0,Interdisciplinary,Bachelors,25-30,14,0,0,Hybrid,Any,1,5,1,3,0,2,5,27.84,Other,3,5,3,4,1,3,5,2,4,5,0,0,1,4,64.08
Medicine,Special Education Teacher,4.294071772738703,0,0,3,1,0,1,4,0,0,1,4,3,4,0,Science,Masters,18-24,10,0,0,Office,Tier2_City,1,2,0,4,4,0,3,18.4,Healthcare,1,4,3,2,4,1,5,5,2,4,0,1,5,1,65.47
Law,Pharmacist,3.159830792362076,2,0,3,1,0,1,4,2,0,1,0,3,0,1,Arts,Bachelors,18-24,0,0,0,Remote,Tier2_City,2,1,1,2,0,3,4,16.61,Tech,1,1,3,2,4,2,3,5,1,4,1,0,2,2,30.85
Education,Forensic Psychologist,4.489136163539005,7,2,3,1,2,0,2,0,2,2,0,1,1,0,Arts,Bachelors,18-24,4,0,0,Hybrid,Tier3_City,3,3,5,1,5,3,1,28.6,Healthcare,3,4,5,1,1,3,1,5,2,3,0,0,5,1,38.57
Law,Chemist,4.806201473705709,1,2,0,0,5,0,4,0,4,2,1,1,1,1,Arts,Bachelors,31-35,7,0,0,Hybrid,Tier2_City,1,3,4,1,4,1,2,18.35,Tech,2,2,1,4,1,1,2,3,1,5,0,1,5,4,59.72
Finance,Architect,4.64796105346514,1,2,4,0,2,0,2,3,3,3,2,4,3,0,Commerce,PhD,18-24,10,0,0,Hybrid,Tier2_City,1,3,0,5,0,1,4,43.59,Manufacturing,2,2,5,2,1,4,1,5,3,3,1,0,1,4,68.79
Music,Legal Analyst,4.788194308686181,9,1,1,1,3,1,2,3,0,2,3,0,4,1,Arts,Bachelors,18-24,14,1,48,Office,Tier1_City,3,5,5,5,4,2,5,12.91,Other,1,2,5,5,5,3,3,3,4,1,0,0,2,4,57.47
Medicine,AI Researcher,2.546175745517951,3,1,0,0,8,0,4,2,4,4,0,3,4,1,Science,Bachelors,25-30,11,0,0,Flexible,Tier1_City,5,4,2,1,3,4,1,44.47,Healthcare,1,2,1,5,4,5,3,2,4,1,0,0,3,5,66.61
Chemistry,Psychologist,4.614080284661676,1,2,0,0,9,0,4,2,2,4,0,4,3,0,Science,Masters,25-30,3,1,42,Hybrid,Tier2_City,4,2,4,3,1,3,3,34.21,Manufacturing,4,3,3,1,2,5,2,2,4,3,0,0,2,1,53.62
Medicine,Nuclear Physicist,4.975655183884022,8,1,4,0,7,0,2,4,2,3,3,3,1,0,Science,Masters,25-30,13,0,0,Hybrid,Tier1_City,3,4,2,3,4,0,3,47.96,Finance,2,1,2,2,3,2,2,2,1,1,0,1,3,3,63.06
Education,Credit Analyst,2.7275478812038245,8,1,3,0,5,0,3,3,0,4,1,0,0,1,Arts,Bachelors,31-35,1,0,0,Hybrid,Tier3_City,2,4,5,5,3,4,1,3.71,Other,4,3,3,4,1,4,5,1,5,1,1,1,3,2,41.4
Psychology,Marketing Manager,4.955808514569764,1,1,0,0,1,1,2,2,2,0,0,4,0,1,Arts,Masters,18-24,12,0,0,Office,Tier2_City,2,1,3,4,2,3,1,5.78,Manufacturing,1,3,3,1,4,2,3,5,5,3,1,0,5,3,61.28
Medicine,Manager,4.963638582862608,3,0,0,0,6,1,4,4,0,3,2,1,0,1,Science,Masters,18-24,14,0,0,Office,Tier2_City,4,2,4,1,0,2,5,26.54,Education,1,2,5,1,0,5,5,2,2,1,1,1,5,3,53.56
Biology,Nurse,3.455444079409287,7,1,4,1,4,1,2,4,2,3,1,3,3,1,Science,Masters,25-30,2,0,0,Remote,Tier3_City,2,1,1,5,2,3,5,45.88,Healthcare,4,1,2,3,4,1,3,4,5,2,1,0,5,5,52.81
Engineering,Financial Controller,3.3317172952994056,7,1,1,1,0,1,2,4,0,0,0,1,4,1,Science,Bachelors,25-30,13,0,0,Remote,Any,3,4,2,5,5,1,2,37.35,Other,4,1,1,1,2,2,1,3,5,3,1,1,1,3,53.96
Engineering,Marketing Specialist,4.8616507680641865,2,0,3,0,0,0,0,2,4,1,4,4,1,0,Science,Masters,25-30,10,1,7,Flexible,Tier1_City,5,1,1,1,3,0,2,32.24,Other,1,4,4,3,2,0,4,4,5,2,0,1,5,2,68.53
Music,Cybersecurity Analyst,3.827958808475083,4,2,1,1,3,1,3,4,0,1,0,4,1,1,Arts,Bachelors,18-24,8,1,31,Remote,Tier2_City,2,1,5,1,2,0,3,4.49,Tech,5,3,1,3,5,2,5,2,5,4,1,1,3,2,57.93
Art,Lawyer,3.2108560972487687,5,1,1,1,9,1,3,2,2,1,0,3,3,1,Arts,Bachelors,36-40,13,0,0,Hybrid,Tier3_City,3,5,0,3,2,1,1,19.65,Manufacturing,1,1,2,2,1,2,5,1,1,2,1,0,5,5,47.16
Law,Marketing Manager,2.614055422301422,2,2,1,1,1,1,1,3,4,4,3,2,1,1,Arts,Bachelors,31-35,6,1,47,Office,Tier1_City,2,2,2,4,3,4,3,19.26,Other,2,5,1,5,3,4,5,1,4,4,1,0,2,3,64.75
Chemistry,AI Researcher,4.797486853377446,7,1,1,0,2,0,0,3,1,3,4,3,0,0,Science,High School,18-24,2,0,0,Hybrid,Tier1_City,1,2,2,4,1,1,5,28.48,Other,1,3,5,4,4,2,4,4,3,5,0,1,4,1,49.35
Law,Social Media Manager,4.083867320853802,8,2,4,1,6,0,1,4,4,4,3,0,4,1,Arts,Bachelors,18-24,4,0,0,Hybrid,Tier2_City,1,4,0,1,4,0,4,15.12,Healthcare,3,1,2,1,3,3,4,2,1,1,0,1,2,1,47.11
Computer Science,Architect,2.852429889856106,9,1,0,0,7,0,0,3,2,3,2,2,4,1,Science,Masters,40+,2,0,0,Remote,Tier2_City,5,3,0,2,5,2,5,15.56,Tech,1,5,4,2,0,2,2,5,5,5,0,0,1,4,55.4
Chemistry,Marketing Manager,4.318413787010847,9,2,2,1,5,1,4,0,4,4,4,4,3,0,Science,High School,31-35,9,0,0,Flexible,Tier1_City,1,1,0,5,5,4,4,32.18,Other,5,5,4,4,3,5,3,3,5,1,0,0,1,4,69.85
Business,Paralegal,4.913478902111248,8,0,4,0,0,1,3,2,2,2,2,3,0,1,Commerce,Bachelors,25-30,3,0,0,Remote,Tier2_City,1,2,5,5,0,5,1,47.39,Other,2,5,2,1,3,1,1,3,1,4,1,1,5,3,45.99
Chemistry,Software Developer,2.539142224997852,1,2,1,0,5,0,0,3,1,0,2,0,1,0,Science,Bachelors,31-35,11,0,0,Hybrid,Tier2_City,2,3,0,1,4,3,1,34.03,Healthcare,1,2,1,5,1,0,5,1,3,3,1,0,1,2,55.0
Biology,Mechanical Engineer,3.902499444532725,5,1,3,0,4,0,2,3,3,1,1,4,3,1,Science,Bachelors,31-35,7,0,0,Hybrid,Tier2_City,2,2,3,2,0,5,1,34.4,Healthcare,4,4,4,5,0,0,2,4,4,1,0,0,3,4,52.44
Chemistry,Pharmacist,4.4025489611897175,9,2,3,1,6,1,1,1,4,2,3,1,2,0,Science,PhD,31-35,13,0,0,Office,Tier3_City,4,4,2,3,5,2,2,49.35,Education,2,4,2,3,5,5,5,2,5,2,0,0,3,4,72.83
Law,Software Developer,3.5656558899482764,7,1,2,1,1,0,2,0,1,2,2,2,4,0,Arts,Bachelors,25-30,2,0,0,Remote,Tier3_City,5,1,5,1,4,5,2,10.21,Manufacturing,2,1,2,3,2,2,3,2,2,4,0,0,2,1,40.84
Business,Aerospace Engineer,4.290022246143424,1,0,1,0,0,1,2,1,0,0,4,0,0,0,Commerce,Bachelors,25-30,2,0,0,Hybrid,Tier2_City,1,5,5,1,2,4,4,4.59,Education,5,1,2,4,3,0,4,5,3,2,0,1,3,4,37.15
Psychology,Data Scientist,3.942176648517627,8,0,1,0,2,0,3,3,0,3,3,3,2,0,Arts,Bachelors,18-24,10,0,0,Remote,Tier2_City,4,4,3,5,1,0,3,38.04,Finance,4,4,3,1,0,4,3,5,5,1,0,1,4,1,57.79
Finance,Legal Analyst,3.506474996074095,8,0,3,1,4,0,1,4,2,3,2,2,3,0,Commerce,Bachelors,36-40,10,0,0,Hybrid,Tier3_City,2,4,3,1,2,0,3,23.62,Other,3,5,1,3,0,0,3,2,2,4,1,0,1,1,57.18
Finance,Electrical Engineer,4.091215378470897,7,1,4,0,3,0,2,3,3,1,4,2,2,0,Commerce,High School,31-35,7,1,38,Office,Tier2_City,4,4,1,1,1,2,4,23.15,Healthcare,1,1,2,2,2,1,3,2,1,2,0,1,1,1,46.88
Music,Physicist,4.62580979138504,5,0,4,1,2,0,1,0,4,3,1,0,3,0,Arts,Masters,18-24,9,0,0,Remote,Any,1,3,2,1,3,5,2,13.59,Manufacturing,3,2,2,3,1,2,2,3,4,4,1,0,4,3,59.97
Business,Financial Advisor,4.842197773346502,3,0,3,1,2,0,3,0,1,3,2,4,1,0,Commerce,PhD,36-40,12,0,0,Office,Tier2_City,4,4,2,5,0,4,5,26.82,Finance,4,2,3,4,0,0,3,4,2,4,0,0,2,1,62.52
Marketing,Legal Secretary,3.492495938940108,5,2,0,1,8,1,0,0,2,3,0,3,4,1,Commerce,Bachelors,36-40,9,0,0,Office,Tier2_City,3,5,5,3,0,3,4,23.78,Other,2,4,5,2,2,5,3,3,5,1,0,1,3,1,46.0
Physics,Physician Assistant,4.040393499924878,6,2,1,0,0,1,4,2,4,2,0,3,2,1,Science,Masters,40+,6,1,29,Flexible,Tier1_City,5,1,2,3,3,5,3,19.24,Finance,5,1,3,5,4,1,3,5,2,1,0,1,3,3,55.05
Art,Education Administrator,4.647562824541962,9,1,2,0,8,1,1,0,1,3,3,4,4,0,Arts,Masters,36-40,6,0,0,Hybrid,Tier3_City,1,2,2,1,4,5,4,23.81,Education,5,1,2,2,0,5,1,1,1,5,0,0,1,4,57.98
Art,Advertising Manager,3.771853272197524,5,2,0,0,7,1,2,3,0,4,1,1,0,0,Arts,Masters,40+,9,0,0,Hybrid,Tier2_City,3,3,0,5,3,3,4,21.04,Finance,2,5,1,4,4,0,2,2,5,3,0,1,2,1,64.7
Biology,Music Teacher,4.573753277458601,5,1,0,1,4,1,3,3,1,2,1,2,1,1,Science,Bachelors,18-24,1,0,0,Hybrid,Tier3_City,4,4,4,3,5,1,1,47.18,Tech,5,1,3,5,4,1,2,2,3,1,1,1,5,1,45.99
Business,Social Media Manager,4.518703483902227,2,1,2,0,4,1,3,3,3,3,2,0,1,0,Commerce,Bachelors,36-40,11,1,23,Flexible,Tier2_City,1,2,1,3,3,2,2,49.07,Tech,3,4,2,1,0,5,1,4,2,3,1,0,5,1,58.19
Education,School Counselor,4.201292428374394,5,2,4,1,4,1,1,3,3,0,2,1,0,0,Arts,Bachelors,36-40,6,0,0,Flexible,Tier1_City,4,4,1,3,1,4,1,42.48,Tech,2,1,1,4,2,2,2,5,3,3,0,1,3,3,46.08
Psychology,Legal Secretary,2.564973627231946,0,0,3,1,6,1,4,1,0,1,2,3,4,1,Arts,Masters,18-24,9,0,0,Hybrid,Tier2_City,5,1,0,5,5,2,2,49.55,Other,1,1,3,3,4,1,5,2,1,4,0,1,1,1,58.67
Computer Science,Chemical Engineer,2.524572596324838,9,0,3,0,9,0,3,3,0,4,1,1,0,0,Science,Masters,18-24,10,0,0,Flexible,Tier1_City,5,5,3,5,3,3,4,15.49,Finance,1,2,4,4,1,0,2,3,2,1,1,1,3,5,56.8
Music,Principal,2.8246811189873284,7,2,1,1,5,1,0,2,4,3,4,0,3,0,Arts,Bachelors,40+,9,0,0,Office,Tier1_City,2,5,4,1,0,4,2,42.62,Other,4,4,1,4,3,1,2,4,4,3,0,0,3,1,56.77
Education,Civil Engineer,3.424481662474543,3,2,3,0,5,0,1,2,4,0,4,1,1,1,Arts,Bachelors,25-30,2,0,0,Flexible,Tier1_City,3,3,1,4,2,0,3,22.11,Other,2,3,2,4,5,2,3,2,1,5,1,1,2,1,46.66
Engineering,Physical Chemist,3.5812130828219595,0,1,4,0,8,1,2,0,1,4,4,3,4,1,Science,PhD,36-40,13,1,30,Office,Tier1_City,5,2,3,3,1,0,1,38.07,Healthcare,3,4,1,5,4,1,1,1,2,2,1,1,4,4,64.31
Business,Electrical Engineer,4.984133926119306,9,1,3,0,8,0,0,0,0,0,4,1,3,0,Commerce,Masters,18-24,6,0,0,Flexible,Tier1_City,3,2,2,4,1,4,4,12.47,Manufacturing,2,4,1,4,4,4,4,5,2,3,0,1,3,4,45.17
Architecture,Principal,3.561988859808366,7,0,4,0,8,0,1,2,4,3,3,1,3,1,Interdisciplinary,PhD,18-24,12,0,0,Flexible,Tier3_City,4,5,5,5,4,2,3,41.16,Tech,2,3,2,1,3,5,3,4,4,2,1,0,2,4,67.12
Law,Biologist,3.221760121297649,7,1,0,1,8,1,2,0,0,1,0,3,3,1,Arts,Masters,25-30,3,0,0,Remote,Tier3_City,3,1,4,5,2,2,2,6.92,Tech,3,3,4,4,2,0,5,3,2,5,0,0,1,2,43.18
Computer Science,Industrial-Organizational Psychologist,3.06344244067173,5,2,0,1,6,0,3,2,1,0,4,0,3,1,Science,Bachelors,18-24,12,0,0,Flexible,Tier1_City,1,3,4,5,1,0,2,15.72,Tech,5,2,1,3,1,5,2,5,2,2,1,0,5,4,51.69
Art,Geneticist,2.911252365622968,1,1,1,0,3,1,1,3,4,1,2,4,3,1,Arts,Masters,31-35,7,0,0,Hybrid,Tier2_City,2,4,5,4,3,0,3,41.63,Education,3,5,2,2,1,1,3,2,3,5,0,0,3,4,63.46
Architecture,Dentist,3.982901588913205,0,2,4,1,5,0,2,1,4,3,3,1,4,1,Interdisciplinary,Masters,25-30,7,0,0,Hybrid,Tier2_City,3,3,2,5,1,3,2,38.12,Education,2,4,1,5,4,4,4,1,3,1,1,1,4,4,54.59
Business,Manager,3.311378122956957,3,0,0,0,5,0,4,3,3,3,0,4,0,0,Commerce,Bachelors,18-24,5,0,0,Office,Tier1_City,3,5,1,1,1,4,1,26.56,Tech,2,4,5,3,0,5,5,3,5,1,1,0,3,4,56.88
Engineering,Credit Analyst,3.3466225520429105,1,2,0,0,7,1,0,0,3,1,2,3,1,0,Science,Bachelors,18-24,12,0,0,Office,Tier1_City,5,4,4,5,1,2,5,34.62,Tech,2,4,4,1,0,4,2,5,2,3,0,1,3,4,47.05
Chemistry,Education Administrator,4.618268251300235,7,1,1,1,4,1,2,0,3,2,0,0,3,1,Science,Masters,25-30,11,0,0,Flexible,Tier1_City,1,3,0,2,4,3,2,11.72,Other,2,4,5,4,5,3,2,2,1,4,0,0,2,4,58.0
Marketing,Human Resources Specialist,2.690479590281469,0,2,4,1,0,0,3,3,2,0,0,1,4,0,Commerce,Bachelors,18-24,2,1,12,Hybrid,Any,5,1,0,4,1,2,4,34.38,Education,4,2,1,5,4,1,4,4,1,1,1,0,1,2,33.87
Marketing,Entrepreneur,3.787926234733432,1,2,0,1,2,0,1,3,0,3,2,4,2,0,Commerce,Masters,31-35,5,0,0,Hybrid,Tier3_City,3,2,0,2,1,0,2,3.37,Manufacturing,5,4,4,5,5,3,4,2,2,1,0,0,1,1,45.64
Chemistry,Dentist,2.645225298659552,1,2,0,1,5,0,1,2,4,2,3,2,2,0,Science,Masters,25-30,5,1,56,Remote,Tier2_City,4,4,5,5,4,4,4,42.16,Healthcare,2,3,2,5,0,4,4,4,5,1,0,1,4,2,62.16
Psychology,Legal Consultant,2.8107083956678283,6,0,0,1,7,0,0,0,2,2,3,2,4,1,Arts,PhD,18-24,2,0,0,Hybrid,Tier3_City,5,3,4,1,5,1,2,27.27,Manufacturing,4,3,5,3,1,5,5,4,3,1,0,1,4,2,46.6
Education,Manager,2.655875959377921,6,1,3,1,8,1,0,2,1,3,4,3,0,1,Arts,High School,25-30,10,0,0,Office,Tier2_City,5,1,1,3,2,4,2,47.36,Other,2,1,4,2,1,5,5,2,3,5,1,1,4,5,54.82
Psychology,Teacher,3.857385714454569,2,2,3,0,6,0,0,4,3,1,2,1,3,1,Arts,Bachelors,18-24,3,0,0,Hybrid,Tier1_City,1,3,5,5,5,5,4,25.47,Healthcare,5,2,4,2,3,5,3,1,5,3,1,0,4,5,51.18
Architecture,Chemist,3.7650705461270535,6,0,4,1,8,1,4,0,1,1,0,3,3,0,Interdisciplinary,Masters,18-24,14,0,0,Hybrid,Tier3_City,5,4,3,1,0,1,1,23.36,Finance,5,1,1,1,1,2,4,4,2,5,1,1,5,3,53.08
Art,Urban Planner,3.4383557795489894,1,2,4,0,6,0,0,1,2,0,2,4,0,0,Arts,Bachelors,18-24,1,0,0,Remote,Tier1_City,5,1,1,4,4,3,5,24.15,Finance,3,4,5,3,5,1,2,4,5,1,0,0,4,1,43.55
Marketing,Biochemist,4.546935330613939,5,0,1,0,3,1,4,0,4,4,4,3,1,1,Commerce,Masters,36-40,14,1,27,Office,Tier3_City,2,2,3,2,4,1,5,19.91,Manufacturing,4,2,2,3,2,3,1,2,1,5,0,1,2,4,75.21
Computer Science,Legal Consultant,4.083704867570981,7,1,3,0,7,1,0,3,3,4,4,3,4,0,Science,Masters,36-40,0,1,10,Remote,Tier2_City,3,1,4,2,1,1,1,10.83,Education,5,2,3,3,1,0,2,4,2,4,1,0,1,4,50.91
Biology,Physical Chemist,4.50271810568372,2,2,3,0,7,1,3,0,0,2,2,0,0,0,Science,Bachelors,36-40,1,0,0,Office,Tier2_City,1,3,2,2,1,3,2,42.58,Tech,1,5,1,4,4,5,4,3,2,4,1,1,1,3,38.45
Architecture,Pharmacist,3.944439547792946,6,0,3,1,5,0,1,0,0,1,1,2,3,1,Interdisciplinary,Bachelors,25-30,6,1,26,Hybrid,Tier2_City,5,3,3,4,0,4,5,21.29,Finance,2,5,4,3,5,5,2,5,5,1,1,1,2,4,38.37
Law,Financial Analyst,2.615673881254116,8,2,1,0,2,1,2,1,4,1,1,1,1,1,Arts,Bachelors,25-30,9,0,0,Remote,Tier3_City,3,3,3,1,1,3,1,27.87,Other,5,1,5,3,0,2,3,2,5,3,0,1,1,3,58.94
Chemistry,Construction Manager,3.54709630029479,3,2,0,0,2,0,1,1,0,1,4,4,0,1,Science,Bachelors,25-30,4,1,34,Flexible,Tier1_City,1,3,1,4,3,5,1,3.93,Education,4,1,3,5,0,3,4,3,4,2,0,1,1,1,50.61
Law,Geneticist,2.529091535672853,2,2,4,1,0,1,3,4,2,2,0,4,1,0,Arts,PhD,31-35,8,0,0,Hybrid,Tier1_City,5,3,4,2,1,0,5,5.83,Education,4,3,4,5,1,1,5,4,4,3,0,0,5,4,70.71
Chemistry,Financial Analyst,4.326886853855999,5,1,4,1,0,1,4,0,0,2,0,2,3,0,Science,Masters,40+,2,1,22,Hybrid,Any,4,5,1,5,1,0,4,31.07,Healthcare,4,3,5,5,1,0,1,4,3,4,1,0,5,2,44.95
Education,Acoustics Specialist,4.885648832915829,7,0,0,0,1,1,1,4,3,4,1,4,0,0,Arts,Masters,18-24,1,0,0,Office,Tier3_City,2,1,4,3,3,1,3,44.32,Finance,3,3,5,3,0,2,4,4,4,4,0,1,4,3,60.06
Architecture,Astronomer,4.063660116240712,2,0,4,1,3,0,3,3,2,4,0,2,4,1,Interdisciplinary,Masters,18-24,14,1,29,Office,Tier3_City,1,1,3,4,0,3,4,26.19,Manufacturing,2,2,3,3,0,4,2,5,3,3,1,1,4,4,59.52
Medicine,Legal Analyst,2.8122359453376164,6,0,2,1,1,1,4,1,2,3,3,4,4,1,Science,Bachelors,31-35,3,0,0,Office,Tier2_City,4,1,2,4,3,3,2,10.75,Other,1,4,4,5,1,3,2,1,1,1,1,1,3,1,48.03
Art,Dentist,3.901291164037647,4,2,4,1,9,0,2,1,2,3,1,1,4,1,Arts,PhD,36-40,1,0,0,Office,Tier2_City,1,1,5,1,4,3,4,8.46,Education,4,1,3,1,2,2,4,2,4,5,1,1,5,2,52.54
Music,Lawyer,4.2356858078846455,1,2,4,0,1,0,4,1,2,4,1,3,1,1,Arts,Masters,36-40,10,0,0,Hybrid,Tier2_City,1,4,4,1,3,5,3,45.29,Manufacturing,2,3,2,1,2,4,5,3,5,4,0,1,2,3,71.94
Business,Actuary,3.692286336695423,6,2,0,1,8,0,2,4,4,1,1,4,2,0,Commerce,Masters,31-35,6,1,34,Hybrid,Tier1_City,2,3,3,4,2,5,3,35.98,Manufacturing,4,2,1,2,0,5,5,1,3,4,1,1,2,5,63.57
Marketing,Illustrator,3.807322762964336,2,2,2,1,4,0,1,0,3,0,4,4,3,0,Commerce,Masters,40+,9,0,0,Remote,Tier3_City,4,5,5,2,4,4,1,48.41,Other,4,5,1,4,3,1,4,2,3,2,0,0,3,5,59.26
Business,Legal Consultant,3.235559176547265,6,1,0,0,2,0,1,4,4,4,3,0,0,1,Commerce,Bachelors,25-30,5,0,0,Flexible,Tier3_City,5,4,5,3,1,2,2,6.87,Finance,1,4,2,4,2,5,2,4,1,5,0,0,5,5,57.52
Computer Science,Architect,3.8192682575321695,2,1,3,0,6,0,1,4,2,4,2,1,4,1,Science,Masters,36-40,7,0,0,Flexible,Any,3,1,2,1,4,2,1,45.42,Other,2,5,4,2,4,1,2,4,4,3,1,1,5,2,64.12
Psychology,Digital Marketing Specialist,2.657866114718101,4,0,0,0,0,1,1,4,3,1,4,0,0,0,Arts,Bachelors,40+,12,1,39,Hybrid,Tier2_City,4,1,1,2,0,2,4,42.74,Manufacturing,4,5,3,5,5,4,5,3,5,4,1,1,2,4,65.27
Music,AI Researcher,3.767085162157816,5,2,4,1,9,0,1,2,3,1,1,4,1,1,Arts,Bachelors,36-40,4,0,0,Remote,Tier2_City,1,5,1,5,0,4,4,44.98,Manufacturing,3,4,1,5,0,2,2,1,3,5,0,1,5,4,50.04
Business,Entrepreneur,4.7875595797885655,3,0,0,1,0,0,2,3,4,2,4,0,0,1,Commerce,Bachelors,25-30,1,0,0,Remote,Tier3_City,4,1,4,1,3,3,5,3.27,Tech,4,2,2,3,2,3,1,4,1,3,0,1,4,4,48.5
Computer Science,Mechanical Engineer,2.679236524883772,9,1,4,0,7,0,1,4,2,0,2,1,4,0,Science,PhD,18-24,12,1,51,Office,Tier3_City,3,1,4,2,4,2,1,37.87,Other,2,5,5,4,1,1,1,5,1,5,1,1,5,1,67.13
Music,Judge,2.77041169818461,2,2,0,0,2,0,0,0,3,2,4,0,2,0,Arts,Masters,25-30,3,0,0,Remote,Any,4,1,4,2,1,3,1,28.8,Manufacturing,5,2,1,3,3,1,1,2,4,2,1,0,5,3,43.71
Psychology,Nuclear Physicist,2.5698491926523483,8,2,3,0,1,1,0,2,3,1,1,3,3,1,Arts,Masters,25-30,0,0,0,Office,Tier2_City,3,1,1,3,0,1,1,29.94,Tech,4,5,1,3,5,2,1,3,5,4,0,1,2,1,49.17
Medicine,Sound Engineer,3.760564772031724,6,2,3,0,3,1,4,3,2,0,0,4,3,1,Science,Masters,36-40,1,0,0,Flexible,Any,2,4,4,3,5,2,1,25.05,Finance,3,3,2,4,5,5,3,5,4,4,0,1,5,2,55.32
Psychology,Musician,4.609197570790943,7,1,0,0,5,1,1,1,4,4,1,3,4,0,Arts,Masters,18-24,3,1,50,Flexible,Tier1_City,1,4,3,5,1,1,3,37.91,Manufacturing,3,4,3,5,1,1,1,3,3,2,1,0,1,1,51.4
Marketing,Counselor,3.320301892915989,1,1,0,1,1,0,0,0,0,0,4,3,4,0,Commerce,PhD,25-30,5,0,0,Remote,Tier2_City,5,4,5,2,5,4,5,49.99,Education,4,1,1,1,5,0,3,2,5,2,0,0,5,3,53.24
Computer Science,Financial Analyst,3.608836752799015,8,0,3,0,7,0,1,4,4,4,4,4,3,0,Science,Bachelors,31-35,3,0,0,Flexible,Tier1_City,4,1,0,2,2,0,2,36.4,Other,2,4,3,5,1,4,2,1,4,1,0,1,2,4,57.98
Engineering,Analytical Chemist,3.641280395439616,5,0,4,1,5,1,4,1,4,2,2,2,0,1,Science,Bachelors,18-24,3,1,31,Office,Tier3_City,2,2,0,3,5,5,2,34.87,Manufacturing,4,5,2,5,3,3,5,5,5,3,1,0,1,2,58.3
Psychology,Architectural Technologist,4.268830538739207,0,1,3,0,4,1,2,3,3,4,4,1,2,0,Arts,Bachelors,25-30,13,0,0,Remote,Tier2_City,4,4,4,1,0,4,2,33.76,Tech,3,5,5,3,0,2,1,4,1,4,1,0,4,2,61.8
Chemistry,Risk Analyst,3.425016581110208,2,2,0,1,8,0,3,1,4,3,2,2,0,0,Science,Masters,25-30,10,1,53,Hybrid,Tier1_City,2,3,3,1,3,4,3,35.67,Education,4,3,1,3,5,0,1,3,1,5,1,1,1,5,68.37
Education,Data Scientist,3.365992782442685,3,2,2,0,9,1,3,4,4,0,3,3,4,0,Arts,Masters,31-35,9,0,0,Office,Tier2_City,3,3,3,4,2,4,5,19.08,Finance,3,3,3,3,1,1,1,1,2,2,0,0,5,2,63.35
Music,Surgeon,3.3569817564643287,3,0,2,0,7,1,0,3,0,3,3,2,2,0,Arts,Bachelors,18-24,9,0,0,Flexible,Tier1_City,2,2,3,3,4,2,5,18.05,Other,5,4,3,4,5,1,3,2,1,1,0,1,5,1,47.58
Psychology,Risk Analyst,4.967295780690484,7,0,4,0,3,0,1,3,0,4,3,2,3,1,Arts,High School,36-40,1,0,0,Remote,Tier1_City,3,5,5,4,1,1,3,39.86,Healthcare,4,1,4,4,0,0,1,4,4,2,1,1,3,2,41.53
Chemistry,Sound Engineer,4.165713048918599,0,2,3,1,7,1,3,1,0,2,1,0,1,1,Science,Masters,25-30,8,0,0,Remote,Tier1_City,2,3,2,3,0,5,1,5.5,Healthcare,1,4,3,2,0,1,3,3,1,2,1,1,4,2,44.63
Finance,Aerospace Engineer,4.650429362078883,3,1,3,0,8,1,2,2,0,2,3,1,1,0,Commerce,High School,36-40,11,0,0,Hybrid,Tier2_City,4,5,5,5,2,2,4,38.68,Tech,4,1,3,3,0,4,1,1,3,4,1,1,2,3,54.93
Finance,Nuclear Physicist,3.710277743379031,4,1,0,0,9,1,2,2,3,2,0,3,1,1,Commerce,Masters,25-30,9,0,0,Flexible,Tier1_City,5,3,3,2,2,0,1,41.25,Finance,3,2,2,4,5,1,5,2,1,3,1,1,2,4,56.21
Law,Industrial-Organizational Psychologist,3.064267017591445,6,0,2,1,5,1,0,4,3,4,4,1,0,1,Arts,PhD,25-30,7,1,29,Flexible,Tier1_City,1,2,1,5,0,5,2,27.52,Finance,2,5,3,2,1,3,1,1,4,4,1,1,2,2,68.32
Art,Chemist,4.17399315618343,2,2,1,1,9,1,1,2,1,3,3,4,1,0,Arts,Bachelors,18-24,7,0,0,Remote,Tier1_City,5,4,1,3,4,4,1,45.78,Manufacturing,3,2,4,3,0,4,3,2,3,5,0,1,3,2,58.9
Law,Nurse,3.225961936824522,8,1,2,0,6,0,4,2,4,2,2,3,3,0,Arts,Bachelors,18-24,4,1,54,Hybrid,Tier1_City,2,5,3,2,4,3,3,25.24,Healthcare,5,4,5,3,1,2,5,4,2,2,0,1,2,1,53.15
Architecture,Aerospace Engineer,3.614703041044597,5,0,4,1,5,1,1,2,1,4,3,2,0,0,Interdisciplinary,Masters,25-30,2,0,0,Flexible,Tier1_City,3,5,0,1,3,0,2,11.37,Manufacturing,2,1,4,1,0,4,2,5,1,5,0,1,1,1,51.35
Architecture,Music Therapist,2.744358958465978,4,1,4,0,5,1,4,1,4,3,2,4,4,0,Interdisciplinary,Masters,18-24,5,0,0,Office,Tier2_City,4,2,2,1,5,1,4,19.99,Finance,1,1,5,4,4,2,2,3,2,5,0,1,4,5,68.75
Biology,Financial Analyst,3.670693604183003,1,0,2,0,7,0,0,4,1,3,0,0,1,1,Science,Bachelors,25-30,13,1,44,Flexible,Tier2_City,1,5,5,4,4,0,2,45.58,Tech,1,2,1,2,1,2,5,5,4,2,1,1,5,1,51.15
Business,Marketing Specialist,4.399219441814117,7,2,4,0,2,1,2,4,3,1,3,0,0,0,Commerce,PhD,25-30,8,0,0,Flexible,Any,1,3,1,3,3,2,1,49.71,Tech,5,3,5,3,4,4,2,4,5,3,1,1,2,2,67.03
Marketing,AI Researcher,3.583813951186749,0,2,1,0,7,0,4,4,2,4,1,1,0,1,Commerce,Bachelors,25-30,7,1,25,Remote,Tier1_City,4,4,1,3,5,3,5,22.83,Education,5,3,5,4,0,3,5,5,4,5,0,0,4,1,67.87
Music,Conductor,4.404341789565732,3,2,3,1,9,1,4,0,1,3,1,4,2,1,Arts,Bachelors,18-24,6,0,0,Office,Any,2,1,1,1,2,2,5,10.84,Tech,5,2,4,2,1,1,1,3,1,5,0,0,5,4,49.26
Business,Brand Manager,4.267044080582343,1,0,4,0,1,1,3,1,2,2,3,3,0,0,Commerce,Masters,31-35,13,0,0,Remote,Tier1_City,1,2,5,5,0,5,5,16.46,Healthcare,5,3,2,1,5,5,2,4,2,5,1,0,5,3,63.48
Physics,Marketing Specialist,4.503920619988532,0,1,2,1,3,0,3,2,3,1,2,2,4,1,Science,Masters,36-40,10,0,0,Office,Tier1_City,4,5,2,2,4,4,2,29.0,Education,4,1,2,2,3,4,4,3,4,2,0,1,1,3,66.07
Education,Software Developer,3.225033441616944,6,0,3,0,2,0,2,4,4,0,1,2,3,1,Arts,Bachelors,18-24,14,0,0,Hybrid,Tier1_City,2,5,3,5,3,4,5,29.89,Healthcare,3,4,5,3,4,2,4,5,2,3,1,1,1,5,59.31
Architecture,Inorganic Chemist,2.6481458144881174,8,0,4,0,8,1,1,4,4,2,1,2,2,0,Interdisciplinary,Masters,18-24,7,0,0,Flexible,Tier1_City,4,5,2,5,2,0,3,32.61,Manufacturing,4,3,4,5,2,4,5,1,3,2,1,0,5,5,56.49
Chemistry,Musician,4.711874945624675,3,2,2,0,2,1,2,3,2,4,0,3,3,1,Science,Masters,40+,3,1,39,Flexible,Tier2_City,1,5,3,1,4,4,4,42.26,Manufacturing,2,1,2,5,2,2,4,1,2,2,0,0,2,5,52.29
Finance,Social Media Manager,4.768823836255208,2,2,2,1,7,0,3,1,4,2,0,0,1,0,Commerce,Bachelors,18-24,5,0,0,Remote,Tier3_City,5,2,4,1,1,4,5,36.43,Tech,1,4,2,1,3,2,5,3,4,3,1,1,3,3,45.61
Chemistry,Urban Planner,2.922477112785036,4,0,1,1,3,0,1,0,0,1,1,0,3,1,Science,Bachelors,40+,14,0,0,Remote,Any,1,3,1,1,2,5,3,15.26,Education,1,1,4,3,3,0,2,1,3,5,0,1,3,4,47.03
Business,Astronomer,3.110501643428698,8,0,2,0,3,1,4,3,1,0,1,4,1,0,Commerce,Masters,18-24,14,1,15,Hybrid,Any,1,3,5,4,4,1,3,21.57,Healthcare,2,5,5,3,5,5,5,3,4,1,0,1,2,2,63.78
Business,Physical Chemist,2.9804130464127114,9,1,2,1,4,1,2,3,3,3,3,1,0,0,Commerce,Bachelors,36-40,13,1,49,Flexible,Tier3_City,5,4,0,5,2,1,2,42.47,Healthcare,1,4,1,4,2,3,5,5,5,3,1,0,5,4,66.46
Education,Digital Marketing Specialist,3.109830613323837,1,2,3,1,7,0,4,1,3,1,3,3,1,1,Arts,Bachelors,25-30,4,0,0,Office,Tier2_City,2,4,2,3,0,2,2,32.77,Finance,5,5,4,5,1,5,1,2,1,3,1,1,2,2,51.5
Education,Judge,4.457245548851596,6,1,1,1,5,1,0,0,1,3,2,1,0,1,Arts,Bachelors,36-40,11,0,0,Flexible,Tier2_City,4,1,5,2,0,2,4,10.82,Tech,5,3,4,4,0,3,2,4,4,4,0,0,3,1,51.93
Business,Investment Banker,4.828864488706278,6,1,2,0,8,0,3,4,0,0,2,2,1,0,Commerce,Masters,25-30,1,0,0,Hybrid,Any,2,3,2,4,0,1,4,18.3,Other,5,3,4,3,1,5,5,5,3,1,0,0,5,3,39.85
Engineering,Fluid Mechanics Engineer,4.530240877278402,8,1,3,1,7,1,2,4,4,1,0,1,1,1,Science,Masters,31-35,7,0,0,Remote,Tier3_City,2,2,5,3,5,0,1,40.18,Manufacturing,2,1,5,1,2,2,2,2,5,1,0,1,1,3,56.17
Finance,School Counselor,4.051234795347545,9,2,4,0,9,0,4,2,3,3,2,3,2,1,Commerce,Masters,18-24,2,0,0,Remote,Tier1_City,4,3,1,5,1,1,4,11.09,Other,3,2,5,5,4,2,4,5,2,1,1,0,1,5,50.64
Psychology,Marketing Manager,4.900690004810577,4,0,0,1,1,1,4,1,2,1,4,3,1,0,Arts,Bachelors,18-24,13,1,12,Remote,Tier2_City,2,3,1,1,0,2,2,35.48,Finance,2,1,4,4,4,1,5,2,4,2,1,1,3,3,62.53
Marketing,Biochemist,2.5146873255499145,0,0,4,0,0,0,4,0,2,4,3,0,1,1,Commerce,Masters,31-35,4,0,0,Office,Tier2_City,3,4,5,5,1,3,3,29.49,Manufacturing,3,5,2,1,0,2,4,3,4,4,0,1,1,1,53.95
Psychology,Biologist,3.0088483534199195,1,0,3,0,3,1,0,2,3,1,0,0,4,0,Arts,Masters,25-30,7,0,0,Flexible,Tier2_City,1,5,0,2,0,4,1,9.93,Manufacturing,1,4,1,3,0,2,1,4,2,5,1,1,2,4,50.49
Marketing,Software Developer,2.762354757629176,5,0,0,0,1,0,3,0,0,0,2,4,0,1,Commerce,Masters,36-40,10,1,16,Hybrid,Any,3,5,0,4,5,5,4,35.38,Healthcare,1,2,3,2,5,5,1,3,3,1,0,0,4,1,56.48
Medicine,Lawyer,4.37026946446053,1,1,2,0,5,1,4,3,1,0,4,0,3,0,Science,PhD,25-30,14,0,0,Flexible,Tier2_City,4,3,1,4,2,3,3,9.69,Manufacturing,1,1,4,2,2,3,2,4,2,5,1,0,4,4,64.47
Law,Paralegal,4.932004776563237,1,0,4,0,9,0,1,3,2,0,2,0,1,1,Arts,High School,36-40,8,1,59,Hybrid,Any,5,3,5,2,4,3,2,21.73,Education,3,5,4,5,2,2,1,2,5,1,0,0,1,5,47.21
Chemistry,Acoustics Specialist,4.77636363444013,3,2,0,0,8,0,4,3,2,2,1,1,1,1,Science,Masters,25-30,12,0,0,Hybrid,Any,5,3,3,3,4,4,5,17.5,Manufacturing,1,5,5,1,0,1,5,1,4,5,1,1,2,4,69.45
Law,Human Resources Specialist,4.083073414075446,2,0,3,0,6,0,4,0,2,2,1,4,0,0,Arts,Bachelors,40+,14,0,0,Hybrid,Tier1_City,4,3,1,3,0,1,1,35.43,Education,2,3,5,4,4,0,2,1,2,2,1,0,1,4,51.71
Education,Surgeon,2.811349182726893,7,0,2,0,9,0,0,1,0,4,3,4,4,1,Arts,Bachelors,40+,8,1,34,Hybrid,Tier1_City,4,4,0,4,4,0,3,39.77,Manufacturing,3,1,3,1,3,0,4,1,4,1,1,0,1,4,47.79
Art,Music Teacher,2.565679319017452,1,1,2,1,2,0,1,1,3,2,0,0,4,1,Arts,Bachelors,25-30,13,0,0,Flexible,Tier1_City,2,3,1,4,0,3,2,10.91,Finance,5,1,5,5,3,5,3,1,4,1,1,1,5,5,48.81
Marketing,Biotechnologist,4.837972045501422,8,2,1,1,5,1,1,3,3,2,0,1,2,0,Commerce,Bachelors,36-40,4,1,40,Hybrid,Any,1,3,0,1,0,0,2,41.16,Healthcare,3,5,5,3,3,1,1,5,4,4,0,0,2,3,45.07
Medicine,Geneticist,3.944703605809968,3,1,2,1,5,1,1,4,4,1,4,2,3,1,Science,Bachelors,36-40,1,0,0,Remote,Tier1_City,3,1,4,3,3,5,1,3.34,Finance,2,1,2,1,4,5,5,5,2,5,1,1,3,3,48.8
Art,Composer,3.740126179656059,3,2,3,0,8,0,4,1,2,3,0,1,3,0,Arts,Masters,18-24,6,1,40,Office,Tier2_City,4,1,3,2,3,5,1,27.91,Healthcare,2,3,1,5,1,2,4,1,2,1,1,1,2,3,51.57
Chemistry,Cybersecurity Analyst,4.298235168817399,9,2,3,1,8,0,1,0,0,2,3,2,4,1,Science,Bachelors,31-35,10,0,0,Flexible,Tier2_City,5,3,5,3,3,5,4,27.29,Finance,2,2,2,5,1,1,3,3,1,1,0,0,2,2,45.62
Marketing,Architectural Technologist,4.284953189279367,5,2,4,1,2,0,3,3,3,4,2,2,1,0,Commerce,Masters,18-24,10,0,0,Hybrid,Tier3_City,1,5,0,1,1,2,4,32.32,Tech,1,5,4,4,4,0,2,2,2,2,1,1,1,2,66.48
Finance,Musician,4.048599890361696,4,0,3,1,7,0,3,3,1,2,0,2,0,0,Commerce,Bachelors,36-40,6,0,0,Remote,Tier1_City,1,2,5,4,3,3,1,14.27,Manufacturing,5,3,2,3,1,5,5,1,5,5,1,1,5,2,56.52
Law,Physician Assistant,2.90668654899014,6,0,1,0,4,1,4,2,4,3,1,0,0,0,Arts,Bachelors,18-24,14,0,0,Remote,Tier1_City,2,1,2,4,0,5,1,3.46,Manufacturing,5,3,3,1,3,3,3,3,3,1,0,0,5,1,51.23
Music,Education Administrator,3.776601056642373,7,1,1,1,5,0,3,3,4,0,2,4,1,1,Arts,Masters,18-24,11,0,0,Remote,Tier1_City,5,3,2,1,5,2,3,24.37,Tech,4,4,2,5,4,2,5,3,1,3,1,1,1,3,68.39
Finance,Data Scientist,2.697676783035393,8,0,1,0,4,1,2,4,0,2,4,4,4,0,Commerce,Bachelors,25-30,12,0,0,Remote,Tier2_City,1,1,5,2,5,5,4,6.36,Tech,2,2,5,3,0,2,4,3,4,2,0,0,5,4,64.96
Medicine,Aerospace Engineer,2.732399064688052,0,2,0,1,7,0,1,4,4,4,2,1,4,0,Science,Bachelors,25-30,7,0,0,Flexible,Tier1_City,5,3,3,4,2,1,2,44.93,Education,1,3,3,4,4,5,4,5,2,5,0,0,2,5,58.49
Law,Animator,3.086156629680847,9,0,4,1,2,0,3,2,0,1,0,2,1,1,Arts,Masters,36-40,7,0,0,Remote,Tier3_City,3,5,3,5,3,3,4,11.16,Finance,3,4,3,5,2,5,1,4,3,4,1,0,3,5,55.64
Marketing,Doctor,2.6107783045342097,5,1,3,0,1,1,2,4,2,2,4,0,2,1,Commerce,Bachelors,40+,4,1,16,Hybrid,Tier1_City,5,5,2,4,5,2,4,22.99,Manufacturing,1,4,4,4,3,4,4,5,3,3,1,0,3,2,56.77
Education,Credit Analyst,4.756569507269747,5,2,3,0,9,1,4,4,0,1,0,3,1,1,Arts,Bachelors,25-30,14,0,0,Office,Tier2_City,1,1,5,5,3,5,1,23.4,Education,2,1,4,3,5,2,2,1,3,2,0,1,3,1,53.34
Education,Organic Chemist,3.464090497095805,0,1,0,0,7,1,2,3,3,2,3,2,1,0,Arts,Bachelors,18-24,0,0,0,Flexible,Any,5,2,5,1,2,2,1,28.98,Other,1,3,5,4,3,4,2,1,4,1,0,0,5,2,44.1
Marketing,Ecologist,2.8361380909466534,9,0,1,0,4,1,2,0,1,3,2,1,0,1,Commerce,PhD,31-35,12,0,0,Remote,Tier2_City,5,2,5,1,5,5,4,39.78,Manufacturing,2,5,1,1,2,4,5,1,1,2,1,0,4,2,52.73
Business,Actuary,2.636067452648237,9,0,2,0,2,1,1,3,1,0,0,0,4,0,Commerce,Masters,25-30,10,0,0,Hybrid,Tier1_City,5,2,5,4,0,1,5,25.19,Tech,3,1,3,4,3,3,2,2,3,3,0,0,1,4,47.47
Biology,Human Resources Specialist,3.971152948579211,1,1,2,0,8,1,3,0,0,4,4,0,0,1,Science,Masters,25-30,12,1,54,Remote,Tier3_City,1,2,5,3,1,0,5,4.21,Education,3,2,5,2,5,4,4,2,1,2,0,0,4,3,51.22
Education,Biotechnologist,2.938880790198787,9,2,4,1,2,0,2,1,3,4,3,4,1,1,Arts,Masters,25-30,3,0,0,Remote,Tier1_City,3,4,4,5,3,5,4,39.24,Other,5,5,4,2,2,4,3,4,5,3,1,0,1,2,62.35
Medicine,Teacher,4.693627867365074,0,0,1,0,7,1,1,4,3,1,4,3,4,0,Science,Bachelors,25-30,3,0,0,Hybrid,Tier1_City,5,3,4,2,5,0,5,6.86,Education,4,5,4,2,5,4,2,5,5,3,0,0,4,5,58.38
Architecture,Human Resources Specialist,4.643039360041658,6,0,1,0,2,1,0,2,1,3,4,0,4,1,Interdisciplinary,Bachelors,25-30,14,0,0,Hybrid,Tier1_City,3,5,0,4,5,3,4,33.15,Education,1,4,1,2,2,4,4,3,3,3,0,0,1,3,54.2
Chemistry,Surgeon,3.6848193226088286,7,1,3,1,0,0,3,4,3,3,2,3,4,0,Science,Masters,31-35,10,1,41,Remote,Tier1_City,1,2,3,2,2,1,1,40.76,Finance,4,3,3,1,3,4,4,5,3,5,1,1,3,1,68.77
Art,Sound Engineer,3.452225304666502,6,1,4,1,3,1,1,3,3,3,2,0,4,1,Arts,Bachelors,25-30,2,0,0,Hybrid,Tier2_City,4,4,2,4,0,3,1,16.29,Other,1,4,3,5,4,1,5,1,5,2,1,1,3,3,46.97
Engineering,Nuclear Physicist,2.8278598370479995,8,0,4,0,2,1,0,1,4,3,0,0,3,0,Science,Bachelors,36-40,7,1,50,Remote,Tier2_City,5,3,5,3,4,0,1,24.11,Education,5,4,5,2,2,4,5,4,1,5,1,0,2,1,50.4
Biology,Ecologist,4.806635333108326,2,1,3,1,9,1,2,3,0,2,1,4,0,0,Science,Bachelors,25-30,2,0,0,Flexible,Tier2_City,3,4,5,3,5,1,2,3.67,Manufacturing,5,3,1,2,0,5,2,2,1,4,0,0,4,2,42.64
Marketing,Principal,2.924713333618362,3,1,4,1,4,1,0,1,4,2,2,2,0,0,Commerce,Bachelors,18-24,12,1,11,Hybrid,Tier1_City,5,1,3,3,1,4,1,40.78,Finance,3,3,2,5,2,1,2,4,1,4,1,0,1,2,52.69
Chemistry,Organic Chemist,3.85125975835781,9,1,1,0,9,0,0,4,2,3,4,2,2,0,Science,PhD,36-40,4,0,0,Flexible,Tier2_City,2,1,2,3,2,1,1,36.05,Manufacturing,3,3,5,2,0,1,4,3,2,2,0,1,3,3,56.21
Biology,Digital Marketing Specialist,2.550485661390181,0,0,1,1,2,1,4,2,3,2,1,3,1,0,Science,Bachelors,25-30,1,1,25,Remote,Tier1_City,2,2,2,1,5,1,4,13.88,Other,3,4,3,5,4,1,2,4,5,2,1,1,1,1,53.8
Computer Science,AI Researcher,3.273112429355157,5,1,2,1,4,1,0,4,3,2,4,3,2,0,Science,Bachelors,18-24,5,0,0,Office,Tier1_City,1,1,0,1,5,4,5,21.34,Education,1,3,5,2,2,5,3,4,2,1,0,0,3,2,48.56
Music,Brand Manager,4.884531341676565,9,0,0,0,2,1,2,0,4,3,3,4,1,1,Arts,Bachelors,31-35,14,0,0,Hybrid,Tier1_City,3,3,3,5,2,2,5,35.68,Education,4,3,5,5,2,2,1,4,2,1,1,0,1,3,62.19
Chemistry,Judge,4.683398119196564,9,1,3,1,8,1,3,3,4,3,4,3,1,0,Science,PhD,25-30,5,1,26,Remote,Tier2_City,3,2,4,2,2,2,1,19.83,Other,4,5,5,5,2,1,1,1,5,5,0,1,4,1,77.36
Physics,Landscape Architect,3.2288616061364874,9,1,3,1,2,0,4,3,0,1,2,2,0,1,Science,Bachelors,36-40,7,0,0,Office,Tier2_City,5,4,3,4,3,2,1,10.63,Manufacturing,3,4,5,3,0,2,4,3,2,1,0,0,1,4,46.59
Biology,Financial Advisor,4.276321021448432,4,2,4,0,3,1,3,1,0,0,4,4,2,0,Science,Bachelors,25-30,7,0,0,Office,Tier1_City,2,5,2,4,5,0,1,27.37,Healthcare,5,3,3,4,4,1,1,2,2,4,0,1,3,2,55.08
Psychology,Lawyer,4.095922623611875,8,1,1,0,7,0,1,1,2,0,1,2,4,0,Arts,Masters,31-35,0,1,51,Flexible,Any,5,5,4,1,4,1,4,37.01,Education,4,4,1,5,3,1,4,5,4,1,1,0,1,5,43.38
Marketing,Teacher,4.455589199156151,9,2,4,1,2,1,0,2,3,4,2,2,1,0,Commerce,Masters,18-24,4,0,0,Office,Tier1_City,5,5,2,4,1,5,4,18.08,Education,5,2,1,2,5,1,4,2,5,4,1,0,3,5,57.67
Psychology,Electrical Engineer,3.195332932911329,3,1,1,0,9,0,4,0,0,4,0,4,0,1,Arts,Bachelors,25-30,1,0,0,Remote,Tier3_City,1,3,3,1,0,4,4,8.72,Finance,3,1,4,1,5,3,3,4,3,5,0,1,2,2,44.1
Architecture,Chemical Engineer,4.526792901748377,0,1,4,0,1,1,1,3,2,1,4,2,2,0,Interdisciplinary,Bachelors,40+,9,0,0,Hybrid,Tier1_City,4,2,2,5,0,5,5,41.99,Manufacturing,1,5,4,5,1,2,5,4,3,3,1,1,5,3,54.78
Psychology,Credit Analyst,4.072784349513119,2,0,3,0,4,1,0,1,0,4,2,4,4,0,Arts,Bachelors,36-40,11,0,0,Hybrid,Tier2_City,1,1,5,2,4,0,2,14.88,Education,2,5,2,2,2,2,2,5,1,4,0,0,5,3,54.12
Law,Graphic Designer,3.058407642409477,1,2,1,1,7,1,4,4,4,1,0,3,3,0,Arts,Bachelors,18-24,4,1,42,Remote,Tier2_City,1,2,1,5,2,4,5,27.1,Manufacturing,4,4,1,5,2,3,3,3,1,5,0,1,4,4,55.96
Chemistry,AI Researcher,4.012573182437032,5,2,0,0,0,0,2,2,0,1,3,3,0,0,Science,Bachelors,25-30,9,0,0,Office,Tier2_City,1,4,4,3,2,5,4,35.49,Finance,3,3,5,3,2,4,5,4,3,2,1,1,3,4,51.7
Business,Physician Assistant,4.985471524712208,7,0,4,0,0,0,1,4,4,0,1,3,3,0,Commerce,Bachelors,25-30,11,0,0,Hybrid,Tier1_City,5,5,5,3,2,0,3,17.9,Manufacturing,3,4,4,1,3,1,4,1,1,4,0,0,4,5,54.3
Finance,Chemical Engineer,4.835830333845615,2,1,3,1,0,0,3,1,2,1,1,1,0,1,Commerce,Bachelors,31-35,8,0,0,Flexible,Tier2_City,5,2,0,3,5,0,2,33.49,Manufacturing,4,1,5,1,4,0,3,1,2,4,1,1,4,3,52.03
Finance,Nurse,3.410843210930562,6,1,4,1,3,0,3,0,1,1,4,4,3,1,Commerce,Bachelors,31-35,3,0,0,Hybrid,Tier3_City,5,2,1,5,2,0,1,24.61,Finance,2,5,2,2,0,2,4,2,3,2,0,0,1,5,43.08
Psychology,Microbiologist,3.6353844703686247,9,1,1,1,3,1,4,1,4,4,0,1,4,1,Arts,Masters,31-35,7,1,31,Hybrid,Tier3_City,5,1,5,4,2,4,5,29.81,Education,1,5,1,4,3,2,1,1,3,3,1,0,5,5,61.11
Chemistry,Musician,4.984851272308572,8,0,1,1,0,1,4,2,1,1,4,4,4,1,Science,PhD,25-30,0,1,45,Remote,Tier1_City,2,4,2,2,5,5,2,30.76,Manufacturing,4,1,3,3,4,0,4,2,1,1,0,0,4,3,50.67
Marketing,Human Resources Specialist,4.543378457676082,3,1,3,1,5,0,2,4,0,1,0,3,3,0,Commerce,Masters,36-40,7,0,0,Remote,Tier1_City,3,5,3,3,5,5,3,41.74,Healthcare,1,4,2,4,1,0,1,4,1,4,0,1,3,5,53.3
Art,Geneticist,3.9448135862898974,8,1,2,0,1,1,3,1,0,2,0,3,2,1,Arts,Bachelors,25-30,5,0,0,Office,Tier1_City,2,1,2,3,4,3,2,33.85,Education,3,5,3,1,5,5,4,1,2,1,1,1,3,3,38.81
Engineering,Doctor,3.262605952169258,7,1,1,0,1,0,4,0,4,3,2,0,4,1,Science,Bachelors,18-24,7,1,13,Flexible,Tier1_City,3,5,0,3,3,0,5,15.42,Finance,4,3,1,1,4,0,4,1,2,1,0,1,2,2,47.6
Engineering,Chemical Engineer,3.3185122312273974,0,2,0,1,0,1,2,2,0,0,3,1,4,1,Science,PhD,25-30,5,0,0,Hybrid,Tier1_City,5,1,3,2,5,2,4,5.8,Tech,1,4,3,4,4,3,5,5,4,4,1,1,5,1,57.42
Biology,Interior Designer,3.155881847990409,9,2,4,1,7,0,4,2,0,2,4,0,2,0,Science,Bachelors,40+,10,0,0,Office,Tier1_City,2,1,4,3,1,1,1,3.09,Other,5,3,1,5,0,1,4,2,3,4,1,0,4,3,58.23
Physics,Actuary,3.2467007075224448,8,2,3,1,1,1,1,1,2,4,3,1,0,1,Science,Bachelors,31-35,2,0,0,Hybrid,Tier3_City,3,5,4,2,2,3,4,45.51,Healthcare,5,2,5,4,4,1,4,5,2,4,1,1,2,2,43.74
Chemistry,Music Therapist,3.2077455684880776,8,0,4,0,2,0,4,4,1,4,2,0,2,0,Science,Masters,25-30,14,0,0,Flexible,Tier2_City,4,4,2,3,3,3,4,47.28,Education,5,1,2,4,4,0,4,3,2,5,1,1,3,2,69.85
Medicine,Electrical Engineer,2.8133503535163933,4,1,1,0,7,0,1,2,1,3,3,4,4,1,Science,Masters,31-35,11,1,25,Remote,Tier3_City,1,3,1,5,0,4,5,7.42,Other,1,5,5,5,5,4,2,5,2,2,1,0,5,2,60.32
Law,Lawyer,2.901670888926811,4,0,3,0,2,1,1,4,2,0,3,0,2,0,Arts,Masters,36-40,14,0,0,Hybrid,Tier3_City,3,3,3,5,4,3,4,25.89,Finance,5,1,1,5,2,1,2,1,2,1,0,1,3,4,57.28
Music,Legal Consultant,3.680621206163692,3,0,3,1,6,0,1,2,4,1,1,0,2,0,Arts,Bachelors,25-30,10,1,56,Hybrid,Tier2_City,2,2,5,2,3,5,4,10.12,Healthcare,3,1,1,5,0,4,3,1,3,4,1,1,4,5,55.3
Chemistry,Interior Designer,4.1916148620256095,9,2,3,1,4,1,4,2,2,4,1,4,4,1,Science,High School,25-30,7,0,0,Hybrid,Tier2_City,2,2,1,5,5,4,5,47.59,Education,1,3,5,3,4,1,5,3,1,3,1,1,1,2,54.6
Art,Marketing Manager,4.7625814768657175,1,0,1,1,5,0,1,4,0,4,0,0,3,0,Arts,PhD,40+,4,0,0,Remote,Any,4,4,2,2,2,4,5,14.6,Other,3,5,5,1,4,5,2,2,1,5,1,1,5,4,44.74
Chemistry,Actuary,3.3647088658923616,7,0,2,0,0,0,4,0,1,0,0,1,0,1,Science,Bachelors,36-40,11,1,27,Hybrid,Tier2_City,3,3,5,5,2,2,3,26.58,Tech,2,2,5,1,2,4,3,2,5,4,1,0,2,4,50.47
Marketing,Risk Analyst,3.991790235882677,2,0,2,0,3,1,3,0,4,4,4,4,0,1,Commerce,Masters,25-30,9,1,21,Hybrid,Tier2_City,1,2,5,5,2,0,4,10.78,Education,1,1,2,5,0,3,3,2,1,2,1,0,2,5,63.52
Physics,Counselor,3.417094623996616,9,2,4,1,5,1,3,4,0,2,3,0,4,1,Science,Masters,25-30,4,1,47,Remote,Any,2,3,3,2,3,3,2,18.64,Tech,5,3,2,5,1,1,3,3,1,5,0,1,1,2,52.38
Finance,Conductor,3.365451389321698,7,2,2,1,4,1,0,0,2,1,0,3,0,0,Commerce,Masters,25-30,14,0,0,Office,Tier1_City,5,3,4,4,2,0,1,15.54,Tech,5,3,1,3,0,1,5,4,5,1,1,0,2,1,48.81
Marketing,Financial Controller,3.7282860326462086,6,2,0,1,3,1,3,4,2,1,2,4,2,1,Commerce,Bachelors,18-24,11,1,47,Office,Tier2_City,5,3,4,5,5,0,1,25.35,Manufacturing,2,5,4,3,3,2,1,4,4,1,1,0,1,3,60.8
Chemistry,Curriculum Developer,3.733755721946771,7,0,2,0,6,0,4,4,1,2,0,1,4,1,Science,Bachelors,40+,6,0,0,Flexible,Tier1_City,3,2,2,3,3,0,5,22.73,Finance,4,4,5,2,4,1,5,3,4,1,0,1,5,1,49.93
Education,Digital Marketing Specialist,4.311649069390735,7,2,0,0,8,1,0,2,3,1,4,1,2,0,Arts,Masters,25-30,5,0,0,Hybrid,Tier3_City,4,2,3,4,2,4,5,18.55,Manufacturing,2,4,3,4,5,2,3,5,5,4,0,0,4,2,59.36
Music,Judge,3.751842490233108,5,2,2,1,8,0,3,1,3,3,1,1,0,0,Arts,Masters,36-40,8,0,0,Remote,Tier3_City,1,4,5,2,0,0,3,7.98,Tech,5,2,3,1,3,5,4,3,5,5,1,0,4,3,64.9
Law,Analytical Chemist,4.284592787016765,4,0,2,0,5,1,1,4,3,4,0,2,4,0,Arts,PhD,18-24,6,0,0,Hybrid,Tier2_City,3,1,2,4,0,3,4,25.77,Finance,5,3,3,1,3,0,3,4,3,2,0,0,5,3,54.53
Computer Science,Physician Assistant,4.728741802562124,0,1,3,1,6,0,2,0,2,0,3,0,4,0,Science,Bachelors,25-30,2,1,24,Remote,Tier2_City,3,2,4,1,1,4,5,42.96,Finance,4,4,5,3,1,2,4,4,5,2,1,0,2,3,42.98
Engineering,Doctor,3.095525959827768,7,2,2,0,7,1,4,3,2,3,4,3,2,0,Science,Bachelors,18-24,10,0,0,Hybrid,Tier3_City,1,5,5,1,2,3,5,37.32,Finance,2,1,4,4,4,0,5,5,3,2,1,1,1,4,65.22
Business,Music Therapist,3.146466915752025,7,1,0,0,7,0,2,2,2,2,2,0,3,1,Commerce,PhD,31-35,10,0,0,Remote,Tier2_City,2,1,5,5,2,4,1,36.87,Healthcare,3,2,4,3,0,1,1,1,4,5,1,1,5,4,67.59
Biology,Actuary,3.616765104542628,2,2,1,1,2,0,0,4,0,3,3,3,1,0,Science,Masters,25-30,11,0,0,Hybrid,Any,5,3,0,5,3,1,4,20.21,Education,2,1,2,2,5,2,2,1,3,5,1,1,5,1,65.57
Art,Chemical Engineer,2.790080901662693,5,0,0,0,9,1,0,1,2,1,1,2,4,0,Arts,Masters,31-35,4,0,0,Remote,Tier2_City,2,4,1,3,3,1,3,36.3,Tech,3,4,4,2,2,0,2,1,1,3,1,0,4,5,40.97
Marketing,Actuary,2.5279603321094983,7,0,0,1,2,1,4,2,0,1,0,3,3,1,Commerce,Bachelors,18-24,8,0,0,Remote,Any,4,5,2,4,2,1,5,24.88,Finance,5,3,3,2,4,5,1,2,1,1,1,1,5,5,38.68
Biology,Education Administrator,3.676602316093753,0,0,3,0,6,1,3,0,4,3,0,3,0,0,Science,Masters,18-24,10,0,0,Flexible,Tier2_City,1,5,5,1,1,1,5,10.06,Other,5,4,3,3,3,2,4,4,5,2,0,1,3,4,63.43
Engineering,Brand Manager,3.933101342768104,8,1,1,1,0,1,3,0,0,0,3,2,4,1,Science,Masters,18-24,12,0,0,Flexible,Tier2_City,2,1,0,5,2,4,5,22.7,Healthcare,2,2,5,4,3,0,4,3,4,2,0,0,5,1,56.4
Computer Science,Legal Consultant,3.539336007308349,7,2,2,1,0,1,0,1,3,0,3,4,2,0,Science,Masters,25-30,14,0,0,Hybrid,Tier1_City,3,4,4,4,5,0,1,9.24,Healthcare,5,2,2,5,4,2,1,5,5,5,0,0,1,3,70.78
Engineering,Human Resources Specialist,4.3370685414112575,0,0,0,1,5,1,2,0,3,3,2,3,3,1,Science,Bachelors,31-35,9,1,14,Remote,Tier1_City,3,1,2,5,3,2,5,8.38,Other,4,1,1,1,1,5,1,4,4,2,0,0,5,2,57.56
Law,Counselor,2.653694004108272,3,1,4,1,7,0,3,3,2,4,1,2,0,0,Arts,High School,25-30,13,0,0,Flexible,Any,4,2,4,5,2,5,5,4.08,Tech,1,1,2,5,0,0,3,1,3,3,0,0,1,2,60.71
Art,Teacher,4.792063039985614,4,2,4,0,0,0,2,3,3,3,4,1,4,0,Arts,Masters,31-35,1,0,0,Flexible,Tier2_City,4,3,4,1,3,2,1,16.29,Manufacturing,3,2,1,4,5,5,5,5,1,2,0,1,4,5,50.17
Business,Teacher,4.80701153487764,0,0,4,1,3,1,3,3,4,3,3,3,0,0,Commerce,Bachelors,25-30,0,1,49,Flexible,Tier2_City,1,4,2,1,2,1,5,18.55,Healthcare,5,1,2,3,2,4,3,3,2,5,0,1,3,3,53.88
Art,Pharmacist,3.939783391854813,1,2,1,0,9,0,4,4,2,1,1,2,0,0,Arts,Bachelors,25-30,10,0,0,Hybrid,Tier2_City,2,2,0,5,4,0,4,35.87,Tech,3,5,4,3,5,1,3,4,2,2,0,1,3,5,56.99
Education,AI Researcher,2.8863691979318067,0,1,0,1,8,1,3,0,3,1,1,1,1,1,Arts,PhD,18-24,7,1,31,Remote,Tier1_City,3,3,2,2,3,3,4,28.29,Healthcare,2,2,2,3,5,1,5,3,3,2,1,0,4,1,53.54
Finance,Nurse,4.337365219397515,5,0,1,1,1,1,1,2,4,1,4,2,1,0,Commerce,Bachelors,18-24,7,0,0,Remote,Tier2_City,1,3,5,5,1,0,1,43.35,Tech,4,1,5,2,1,2,2,4,2,1,1,1,2,5,49.07
Biology,Physician Assistant,2.6284105972064187,1,0,4,0,6,1,0,0,2,4,0,4,2,1,Science,Masters,36-40,1,1,47,Flexible,Tier1_City,1,2,4,5,4,3,4,11.29,Finance,3,4,1,2,5,0,5,4,4,3,1,1,1,2,47.7
Architecture,Landscape Architect,3.2601287514366613,1,2,4,0,2,1,2,2,3,0,1,3,3,1,Interdisciplinary,Bachelors,31-35,13,0,0,Flexible,Any,3,4,3,3,5,2,3,15.5,Manufacturing,5,3,4,2,5,4,2,1,3,4,1,1,3,1,57.52
Computer Science,Digital Marketing Specialist,4.592995589399873,2,1,3,1,9,1,1,3,2,2,0,1,2,0,Science,Masters,18-24,12,0,0,Hybrid,Tier2_City,2,5,4,3,2,0,5,47.23,Other,1,5,4,5,0,1,5,5,2,2,1,1,1,1,53.02
Physics,Market Research Analyst,4.673151323461118,4,1,4,1,8,0,2,1,3,0,2,4,2,1,Science,PhD,18-24,7,0,0,Hybrid,Tier3_City,5,1,5,3,5,0,3,23.87,Healthcare,4,5,2,1,4,2,2,1,2,4,1,0,1,2,60.95
Medicine,Music Teacher,3.662028928952207,0,2,2,1,4,1,0,4,4,1,1,2,0,1,Science,Bachelors,36-40,4,0,0,Hybrid,Tier2_City,4,4,2,2,3,5,4,40.09,Other,2,3,4,3,1,1,4,4,1,3,0,0,4,5,45.87
Music,Surgeon,4.467113839849334,7,0,4,0,9,1,1,1,3,2,3,0,2,1,Arts,High School,31-35,1,1,35,Office,Tier1_City,2,5,0,2,4,2,1,26.13,Healthcare,5,3,3,3,5,5,4,1,4,4,1,0,1,1,41.21
Music,Animator,4.581966198976472,9,1,1,0,0,0,2,3,1,4,3,4,2,1,Arts,Bachelors,31-35,6,0,0,Office,Any,5,5,4,5,5,0,1,25.14,Healthcare,4,4,3,5,2,4,5,4,2,1,1,1,3,5,54.76
Computer Science,Zoologist,4.236297588842268,1,1,1,0,7,0,3,4,3,0,1,2,2,0,Science,Bachelors,25-30,6,0,0,Hybrid,Tier1_City,5,5,0,3,1,3,3,9.96,Education,5,3,3,1,0,1,1,1,1,3,1,1,5,3,46.55
Psychology,Financial Controller,3.9204822911161417,5,2,4,1,6,0,1,3,4,0,2,2,0,1,Arts,Masters,25-30,2,0,0,Remote,Tier2_City,3,1,5,2,3,0,4,43.01,Education,2,5,2,1,4,5,4,4,1,2,1,0,1,1,44.95
Chemistry,Curriculum Developer,2.851606963931819,7,0,1,0,2,1,0,2,0,4,1,0,4,0,Science,PhD,40+,13,1,41,Remote,Tier1_City,5,1,0,1,4,3,5,6.68,Other,2,4,1,5,0,5,5,2,2,5,1,0,3,2,63.7
Medicine,Legal Analyst,4.352318510795008,1,0,4,0,4,0,0,3,3,4,1,0,2,0,Science,Bachelors,31-35,0,1,15,Office,Tier2_City,4,1,1,5,5,1,4,17.58,Finance,1,3,2,3,2,5,5,2,5,5,0,1,1,2,52.29
Education,Legal Secretary,3.390775887760066,8,0,2,0,5,1,0,3,1,3,4,4,0,1,Arts,Bachelors,25-30,10,0,0,Office,Tier1_City,1,5,5,4,4,0,4,34.65,Healthcare,4,4,5,4,4,3,4,3,2,4,1,1,3,5,61.7
Architecture,Financial Controller,2.707655337146635,3,2,2,1,1,0,4,0,3,4,1,4,0,1,Interdisciplinary,Bachelors,36-40,3,0,0,Remote,Tier3_City,2,2,0,5,4,3,1,26.84,Manufacturing,1,4,4,4,3,5,5,4,1,4,1,0,3,4,52.3
Architecture,Investment Banker,2.735026904134971,9,1,4,0,4,1,4,3,2,0,1,2,3,1,Interdisciplinary,Masters,31-35,1,0,0,Remote,Any,4,1,4,4,5,2,2,44.42,Education,1,1,3,1,3,4,1,1,1,3,0,0,2,3,43.38
Biology,Entrepreneur,2.505106671379928,0,0,3,0,8,0,4,0,3,3,3,1,3,1,Science,High School,25-30,3,0,0,Office,Tier3_City,5,5,4,3,0,1,5,4.85,Tech,1,3,2,1,1,0,2,4,2,1,1,0,1,4,38.39
Biology,Web Developer,4.681473984904311,1,2,3,1,3,1,1,4,2,2,1,0,3,0,Science,Masters,25-30,7,0,0,Hybrid,Tier1_City,1,4,2,4,2,0,5,33.52,Tech,3,1,2,3,4,4,5,1,5,4,0,1,5,5,56.09
Chemistry,Risk Analyst,3.747653195067646,4,1,3,0,9,1,1,2,4,0,2,4,3,1,Science,Masters,18-24,1,0,0,Hybrid,Tier2_City,1,5,2,3,3,5,1,25.44,Tech,2,5,4,1,4,2,4,3,3,2,0,0,4,4,45.42
Finance,Paralegal,3.70131528177381,1,1,0,0,5,1,3,3,2,3,0,3,2,0,Commerce,Masters,18-24,0,1,51,Hybrid,Any,5,1,0,1,3,3,4,10.25,Finance,1,4,2,5,1,0,1,4,5,5,1,0,1,5,60.47
Psychology,Curriculum Developer,4.610537872224596,3,0,1,0,9,1,0,1,1,2,1,0,1,0,Arts,Bachelors,31-35,10,1,44,Office,Tier1_City,4,1,5,4,3,5,1,37.93,Healthcare,3,5,3,4,5,1,1,3,5,2,0,0,5,3,48.45
Computer Science,School Psychologist,2.595346155095979,7,1,0,0,0,0,1,0,2,3,4,3,0,0,Science,Masters,25-30,13,0,0,Office,Tier1_City,5,1,5,5,4,0,4,22.33,Healthcare,3,4,4,4,0,4,5,1,5,2,1,0,4,5,70.07
Law,School Psychologist,2.849241211690364,1,2,1,0,9,0,2,0,4,4,0,3,0,0,Arts,Bachelors,36-40,14,0,0,Remote,Tier1_City,2,2,3,3,5,3,2,27.98,Other,3,3,1,1,1,0,3,5,2,2,1,1,3,5,57.7
Psychology,Manager,2.761628570263224,4,1,0,0,9,0,2,1,0,2,2,3,4,1,Arts,Bachelors,40+,14,1,15,Hybrid,Tier2_City,1,3,5,5,2,0,2,48.46,Education,1,2,3,5,5,1,4,1,3,5,1,1,5,5,62.49
Business,Sound Engineer,4.492369271236123,9,1,3,1,6,1,0,2,1,0,4,4,2,0,Commerce,Masters,18-24,2,0,0,Remote,Tier3_City,3,2,5,2,1,1,3,25.85,Tech,3,3,5,1,4,5,1,3,5,2,1,1,2,3,46.35
Chemistry,Cybersecurity Analyst,2.517322688525306,5,2,4,0,1,0,1,3,3,4,4,0,2,0,Science,Masters,25-30,9,0,0,Office,Tier2_City,1,4,4,3,3,1,4,41.7,Finance,1,4,5,1,5,4,4,4,5,3,0,1,2,4,64.71
Education,Ecologist,3.1128847174212706,4,0,3,1,2,1,0,1,2,2,1,2,2,1,Arts,High School,36-40,6,1,13,Office,Tier2_City,5,1,0,4,5,0,1,39.17,Other,4,2,4,5,3,0,5,4,4,2,0,1,3,5,47.58
Medicine,Clinical Psychologist,2.895150692900683,8,2,0,1,1,1,0,0,1,3,0,2,2,0,Science,Bachelors,31-35,12,0,0,Remote,Tier3_City,5,3,5,3,2,0,1,34.15,Manufacturing,2,2,3,5,0,5,5,3,5,3,1,0,4,4,55.48
Music,Microbiologist,4.402009927218204,4,1,3,1,5,0,0,1,1,1,4,0,4,1,Arts,Bachelors,31-35,11,0,0,Remote,Tier2_City,3,4,2,5,2,4,1,45.15,Healthcare,5,3,3,2,5,2,3,4,4,3,0,0,4,2,48.81
Marketing,Special Education Teacher,4.407327570247666,1,1,4,0,9,0,2,0,3,0,2,3,0,1,Commerce,Bachelors,25-30,5,0,0,Remote,Tier2_City,3,5,4,1,0,0,3,14.83,Healthcare,1,5,3,4,4,5,3,2,3,4,0,0,2,2,48.08
Computer Science,Surgeon,3.815918960521472,0,0,0,1,8,0,4,1,3,0,1,4,2,0,Science,Bachelors,25-30,5,0,0,Hybrid,Tier1_City,1,3,1,3,5,0,5,41.58,Finance,2,3,5,1,2,1,5,5,5,4,0,0,2,2,59.21
Psychology,Urban Planner,4.463233539572896,2,0,4,0,1,1,1,0,0,4,4,2,0,1,Arts,Bachelors,25-30,6,0,0,Remote,Tier1_City,5,2,5,4,3,5,1,20.76,Other,1,4,4,3,3,1,2,3,1,2,1,1,1,3,45.33
Medicine,Teacher,3.311041547466353,1,2,2,1,6,1,3,2,1,2,2,4,3,1,Science,Bachelors,40+,7,0,0,Office,Tier1_City,1,1,2,2,4,5,2,41.19,Other,4,5,5,1,3,2,2,5,2,4,0,0,3,5,54.94
Medicine,Nuclear Physicist,2.8289240526596418,2,1,3,1,9,0,1,0,0,0,2,4,0,1,Science,Masters,25-30,2,0,0,Office,Tier3_City,4,3,5,1,2,1,1,26.21,Education,2,4,2,1,1,2,1,3,1,4,1,1,5,5,34.55
Chemistry,Forensic Psychologist,4.545782264732834,2,0,2,1,8,1,4,4,2,1,1,2,2,1,Science,Masters,36-40,2,1,47,Hybrid,Tier3_City,5,4,1,2,2,5,1,43.31,Finance,2,5,1,3,4,2,3,5,5,4,1,0,1,5,58.21
Engineering,Construction Manager,4.146568539005299,8,1,3,0,0,0,0,4,4,2,3,4,3,1,Science,Masters,25-30,9,0,0,Flexible,Tier1_City,1,2,4,3,1,0,1,45.06,Other,3,1,5,4,4,0,1,1,5,3,1,1,1,1,67.47
Education,Advertising Manager,3.909042727486306,2,2,1,0,6,0,4,1,2,1,0,4,1,0,Arts,Bachelors,40+,12,0,0,Hybrid,Tier1_City,5,4,3,5,0,2,5,31.09,Education,1,5,4,2,1,2,4,3,4,3,1,0,1,2,53.45
Engineering,Architect,4.913811236841673,5,1,1,1,6,1,4,3,2,1,0,0,1,0,Science,PhD,31-35,7,0,0,Flexible,Tier3_City,5,4,0,5,2,0,1,26.86,Other,1,1,5,5,4,5,5,4,3,4,1,0,4,3,59.01
Business,Music Teacher,2.814264356110212,0,0,4,1,2,1,3,3,4,3,1,1,3,0,Commerce,Masters,25-30,11,0,0,Remote,Tier2_City,2,1,0,4,2,4,5,39.81,Healthcare,5,4,2,2,4,5,5,5,1,1,0,0,4,4,59.01
Physics,Pharmacist,3.0983218536038546,2,1,1,0,5,0,1,2,2,3,4,2,1,1,Science,Masters,31-35,12,1,17,Remote,Tier1_City,1,3,3,5,4,3,5,15.55,Education,3,3,2,1,5,3,2,1,5,4,0,0,4,5,70.8
Computer Science,Actuary,3.730225081939667,7,2,3,0,4,0,3,2,0,1,1,2,1,1,Science,Masters,25-30,13,0,0,Hybrid,Tier1_City,5,4,0,1,4,1,3,3.72,Other,3,4,2,1,3,5,1,1,2,3,1,1,4,4,54.87
Psychology,Animator,3.72182449174582,4,1,1,0,9,0,4,0,0,4,1,4,4,0,Arts,PhD,25-30,12,0,0,Hybrid,Tier1_City,3,2,5,5,1,5,2,22.13,Education,5,3,2,3,0,0,1,1,2,1,0,0,5,5,59.74
Medicine,Marketing Specialist,2.886174048567216,7,1,0,0,7,1,4,4,3,3,2,1,3,0,Science,Bachelors,18-24,6,0,0,Remote,Tier2_City,3,4,5,4,5,2,1,26.87,Education,3,1,1,3,2,2,4,4,3,2,1,0,4,2,57.95
Engineering,Doctor,4.791201426530943,3,2,2,1,6,0,4,0,0,4,4,3,4,0,Science,Bachelors,18-24,9,0,0,Hybrid,Tier1_City,2,4,0,3,1,3,1,16.97,Other,3,3,3,1,2,2,1,1,1,1,1,1,5,2,47.97
Physics,Electrical Engineer,3.07161649579459,6,2,3,1,3,0,0,1,4,1,1,1,0,0,Science,Masters,25-30,4,0,0,Hybrid,Tier2_City,5,2,1,3,1,2,1,21.02,Education,4,4,2,2,0,3,4,5,4,1,1,1,3,1,44.75
Engineering,Animator,4.111918195320161,0,1,1,1,5,1,4,4,1,2,0,3,2,0,Science,Masters,31-35,3,0,0,Flexible,Any,1,5,0,5,4,1,5,9.25,Tech,2,4,1,2,2,4,1,4,4,2,1,0,1,1,54.28
Medicine,Biomedical Engineer,4.798314552698768,5,0,1,1,3,0,2,1,2,0,3,3,4,1,Science,Masters,31-35,5,0,0,Hybrid,Tier1_City,1,4,1,2,5,5,4,16.03,Tech,5,4,5,4,0,2,3,3,4,1,1,0,2,5,56.41
Psychology,Game Developer,3.6404549668875386,4,2,2,1,1,0,0,2,1,4,4,1,2,0,Arts,Bachelors,18-24,8,1,13,Hybrid,Tier1_City,3,2,0,3,4,4,2,14.28,Other,4,5,2,1,4,1,5,4,4,3,1,0,1,4,58.26
Engineering,Artist,4.407767908088877,6,1,1,1,6,1,1,1,1,4,2,3,0,0,Science,Bachelors,36-40,5,1,44,Flexible,Tier1_City,4,1,5,5,0,1,1,17.15,Tech,4,4,5,5,1,2,4,3,2,3,0,0,5,1,46.37
Psychology,Counselor,4.320025626181323,8,2,3,0,7,0,2,2,0,0,4,0,3,1,Arts,Bachelors,31-35,7,1,36,Office,Tier2_City,5,3,0,4,3,2,4,17.06,Tech,4,5,5,5,5,0,5,3,2,2,0,1,4,3,46.99
Computer Science,Acoustics Specialist,3.773876583171529,2,1,2,1,6,1,0,1,4,3,0,4,3,0,Science,PhD,40+,0,1,52,Hybrid,Tier2_City,2,2,2,5,3,2,4,29.27,Finance,3,2,4,2,4,0,5,3,5,2,1,0,5,2,49.51
Biology,Civil Engineer,3.799647525280981,4,2,4,1,5,0,4,0,2,0,0,3,4,1,Science,Masters,31-35,11,1,13,Hybrid,Tier1_City,2,2,3,3,0,1,4,14.78,Manufacturing,5,1,1,3,1,2,1,3,5,5,1,1,2,4,65.02
Education,Software Developer,4.926267985329053,1,1,1,1,9,0,4,1,0,4,4,4,1,0,Arts,Bachelors,18-24,13,1,20,Hybrid,Tier1_City,5,3,2,4,3,0,2,47.23,Other,3,2,1,3,0,0,1,4,1,1,1,1,1,5,56.81
Biology,Counselor,4.972516032663641,7,0,1,1,3,0,1,4,0,1,3,2,2,0,Science,Bachelors,25-30,5,0,0,Remote,Tier3_City,5,2,0,5,5,1,4,27.03,Education,3,2,2,2,4,5,4,2,1,2,1,1,1,5,44.73
Business,Cybersecurity Analyst,4.200827913588307,3,1,3,0,4,1,2,2,0,2,1,2,2,1,Commerce,Bachelors,31-35,13,0,0,Remote,Tier3_City,2,5,1,1,4,5,1,9.06,Finance,4,5,2,4,0,1,2,2,3,4,1,1,3,2,57.4
Marketing,School Counselor,4.088033150146215,8,1,3,1,8,0,0,2,2,3,1,0,3,0,Commerce,Masters,18-24,13,1,10,Hybrid,Tier1_City,2,1,0,4,3,5,1,16.14,Other,1,5,2,1,5,5,2,1,2,5,1,1,5,4,55.69
Music,Inorganic Chemist,4.167525980383315,3,1,0,1,4,1,3,0,2,0,2,0,1,1,Arts,Masters,18-24,1,0,0,Office,Tier1_City,1,5,4,1,5,4,3,37.3,Tech,5,1,1,5,5,2,5,5,3,1,1,0,3,3,40.36
Art,Composer,3.860929476125166,4,1,3,1,3,1,3,0,4,4,1,2,0,0,Arts,Masters,18-24,2,0,0,Remote,Tier2_City,2,4,4,2,4,1,5,3.64,Education,5,1,5,2,3,1,2,5,4,3,0,0,4,5,56.42
Finance,Astronomer,2.970845148558171,8,2,3,1,5,0,2,4,3,0,3,2,4,0,Commerce,Bachelors,25-30,5,0,0,Remote,Tier1_City,3,1,4,4,5,3,4,47.08,Manufacturing,4,1,5,3,5,3,3,5,5,5,0,0,3,2,61.15
Physics,Paralegal,4.411740385561027,9,1,0,0,6,0,3,0,3,4,0,4,2,1,Science,Masters,25-30,1,0,0,Remote,Tier1_City,2,4,4,1,0,5,5,23.92,Other,4,4,2,1,5,4,1,1,5,4,1,0,1,1,53.42
Art,Forensic Psychologist,3.530789656723273,2,1,1,1,0,1,3,0,4,0,2,0,1,1,Arts,Bachelors,25-30,3,0,0,Office,Tier3_City,2,3,0,3,1,5,5,27.49,Education,2,4,5,5,0,3,5,5,3,3,0,1,1,2,47.53
Architecture,Quantum Physicist,4.616517945546696,9,1,2,0,8,0,1,0,2,3,2,2,4,0,Interdisciplinary,Masters,18-24,5,0,0,Hybrid,Tier1_City,3,2,4,3,0,5,5,49.46,Healthcare,4,1,2,4,5,2,1,4,3,3,1,0,1,2,51.13
Physics,Ecologist,4.419117159764747,2,1,2,1,6,0,3,0,2,4,3,2,0,0,Science,Bachelors,31-35,4,0,0,Office,Tier3_City,3,2,3,2,3,0,5,26.66,Healthcare,3,5,3,2,4,4,2,2,2,5,0,1,4,1,51.48
Art,Legal Secretary,4.803238771321235,3,2,4,1,8,1,4,1,0,4,3,0,0,1,Arts,Bachelors,25-30,5,1,57,Hybrid,Tier2_City,5,1,0,4,4,3,5,47.54,Other,4,2,5,1,1,2,3,3,4,5,0,1,5,3,54.75
Finance,Physicist,3.9834185606615846,0,1,2,0,9,0,4,4,1,4,1,1,0,1,Commerce,Masters,25-30,14,1,49,Flexible,Tier1_City,2,2,2,4,5,1,1,46.02,Finance,5,1,1,5,3,5,3,5,1,1,1,0,1,2,59.76
Finance,Legal Secretary,4.022422359036765,4,2,0,1,3,1,2,1,2,3,0,1,0,1,Commerce,PhD,18-24,5,1,42,Hybrid,Tier2_City,3,2,0,4,3,0,2,47.24,Manufacturing,1,1,4,4,4,5,4,1,1,3,0,1,2,2,48.81
Finance,Credit Analyst,4.578156398618959,6,0,3,0,0,0,4,2,0,2,0,4,2,1,Commerce,Bachelors,18-24,7,1,38,Hybrid,Tier2_City,1,4,1,2,3,5,4,41.18,Finance,1,2,1,3,4,5,5,1,3,5,1,1,5,2,58.55
Education,Composer,4.790850607346832,9,1,2,1,2,0,2,1,2,3,3,3,3,0,Arts,Masters,25-30,8,0,0,Flexible,Tier1_City,4,5,3,4,1,3,4,16.93,Education,3,3,1,1,4,4,3,4,3,2,1,1,3,4,53.05
Biology,Risk Analyst,4.558794107380399,5,1,3,0,6,1,0,0,4,0,2,4,0,1,Science,Bachelors,18-24,4,0,0,Flexible,Tier1_City,3,2,0,3,3,3,1,19.28,Manufacturing,1,1,4,2,3,2,5,3,3,2,1,1,5,5,43.32
Marketing,Animator,2.948346070198972,1,1,4,1,4,1,4,4,4,3,1,1,3,1,Commerce,Bachelors,25-30,5,0,0,Office,Tier2_City,4,4,2,1,1,0,1,20.15,Other,4,1,2,5,4,4,5,3,1,5,1,1,4,4,58.57
Biology,Forensic Psychologist,4.955407874784802,3,1,2,1,3,0,1,1,4,4,1,1,3,0,Science,High School,31-35,5,1,55,Flexible,Tier2_City,2,5,1,3,4,5,5,49.02,Finance,1,4,5,3,5,1,5,1,5,5,1,1,4,2,58.45
Chemistry,Composer,4.380813551526583,7,0,2,0,3,0,1,3,1,3,0,4,2,1,Science,Bachelors,25-30,5,0,0,Hybrid,Tier2_City,1,2,5,3,4,0,2,19.96,Education,4,2,1,3,1,0,1,5,5,1,1,0,5,2,50.75
Law,Nurse,4.717560094890485,7,2,0,1,9,1,4,1,1,1,0,3,1,1,Arts,Bachelors,18-24,1,1,22,Hybrid,Tier1_City,1,1,1,1,5,2,4,8.11,Tech,2,1,5,5,5,2,5,4,1,5,1,0,3,1,46.81
Art,Risk Analyst,4.398611882067754,0,1,0,0,3,1,3,2,3,1,2,0,1,1,Arts,Bachelors,25-30,3,0,0,Hybrid,Any,5,1,2,3,1,5,3,39.58,Education,5,1,4,5,4,3,2,4,5,2,0,0,1,1,49.35
Biology,Art Therapist,2.9263190631324165,3,0,1,0,9,0,0,4,4,2,4,4,1,1,Science,Bachelors,31-35,0,1,49,Hybrid,Tier2_City,5,1,5,2,0,0,1,20.2,Finance,3,3,4,5,2,3,3,3,2,5,1,1,1,4,51.55
Physics,Surgeon,2.786460315476555,3,1,3,1,6,1,2,3,2,1,0,3,1,1,Science,PhD,36-40,13,0,0,Hybrid,Tier2_City,2,3,2,1,4,1,3,32.18,Other,2,2,5,1,0,2,1,4,3,5,0,0,3,2,65.54
Physics,Physician Assistant,2.954547961390463,8,2,1,1,9,1,4,0,2,1,4,4,3,1,Science,Bachelors,31-35,11,1,44,Hybrid,Tier2_City,3,1,2,3,5,5,4,46.44,Other,1,1,5,2,2,1,3,2,4,3,0,0,3,1,67.64
Finance,Advertising Manager,2.6139935487528843,0,0,3,0,1,1,1,3,4,3,4,4,1,1,Commerce,Masters,25-30,0,0,0,Flexible,Tier1_City,1,2,2,5,0,4,1,30.05,Manufacturing,3,3,4,3,5,2,2,3,4,3,0,1,1,1,54.97
Marketing,Biotechnologist,2.903547527445803,0,0,1,0,3,0,1,1,3,2,2,1,4,1,Commerce,Bachelors,25-30,0,0,0,Hybrid,Any,2,2,4,3,4,5,4,32.97,Manufacturing,4,1,2,4,1,4,1,1,5,5,0,1,5,3,51.52
Education,Legal Secretary,4.949438594778753,3,2,2,0,4,1,2,2,1,3,2,4,2,0,Arts,Masters,25-30,6,0,0,Remote,Tier1_City,2,1,3,2,4,2,1,33.21,Tech,2,5,5,5,1,0,4,4,1,2,1,0,3,3,55.11
Psychology,Art Therapist,4.267192826100716,9,2,3,1,4,1,2,3,2,3,0,1,1,1,Arts,Bachelors,36-40,0,1,28,Remote,Tier3_City,3,1,2,4,5,0,4,31.78,Finance,5,3,3,2,0,1,2,3,2,4,0,0,4,2,42.25
Law,Special Education Teacher,2.990757993419024,4,1,2,0,5,1,4,0,0,2,2,4,1,0,Arts,Bachelors,18-24,5,0,0,Flexible,Tier2_City,1,4,4,3,5,4,3,10.51,Other,5,5,3,4,1,5,4,5,4,4,1,1,4,1,56.45
Business,Illustrator,4.332574438066584,9,1,0,1,0,1,0,3,1,3,1,1,0,1,Commerce,Bachelors,40+,1,1,41,Office,Any,1,5,0,4,2,2,2,24.45,Other,2,1,5,1,1,0,3,5,4,5,0,1,4,4,40.28
Psychology,Legal Analyst,4.516715696758325,0,2,2,1,7,0,3,4,0,0,0,2,1,1,Arts,Bachelors,31-35,5,1,36,Hybrid,Tier3_City,1,1,1,5,3,1,1,3.36,Tech,2,3,1,3,4,3,2,2,5,5,0,1,1,5,50.7
Psychology,Sound Engineer,2.6579890608411345,2,0,1,0,0,1,1,0,2,2,3,2,0,1,Arts,Bachelors,31-35,5,1,25,Office,Tier2_City,5,4,0,3,3,5,3,32.43,Healthcare,2,2,4,2,0,0,4,1,1,3,1,1,5,4,41.6
Law,Music Teacher,3.1013626020631024,6,2,3,1,1,0,0,2,2,3,0,1,4,0,Arts,Masters,18-24,11,0,0,Office,Any,1,2,0,1,0,4,4,30.04,Other,1,4,2,2,2,0,4,5,4,3,0,1,3,2,53.48
Art,Music Teacher,4.140626074765784,2,2,3,0,5,0,4,1,3,2,4,2,0,1,Arts,Masters,31-35,10,0,0,Flexible,Any,4,1,5,4,3,0,3,17.95,Education,5,1,3,3,4,2,1,3,2,4,1,0,1,5,70.82
Physics,Web Developer,2.692424355859217,0,0,4,1,7,1,1,0,2,1,2,3,3,0,Science,Masters,25-30,2,0,0,Hybrid,Tier1_City,3,4,4,5,0,0,1,27.62,Healthcare,5,3,3,3,4,5,1,4,3,3,1,0,1,4,44.39
Biology,Advertising Manager,3.873943772910578,9,1,0,0,8,1,1,4,0,0,4,4,1,0,Science,Masters,18-24,14,1,41,Hybrid,Tier1_City,1,4,4,1,4,1,3,26.17,Healthcare,1,5,1,5,2,3,3,5,1,1,1,0,1,4,59.18
Chemistry,Financial Controller,2.555734979377544,3,1,3,1,4,1,1,4,1,4,3,3,3,0,Science,Bachelors,25-30,7,1,9,Remote,Tier2_City,3,5,2,1,2,2,4,14.79,Tech,3,3,5,3,1,0,2,5,3,5,0,1,5,5,59.13
Chemistry,Actuary,3.449291031971353,9,1,0,1,8,0,2,4,4,4,3,2,2,0,Science,Bachelors,36-40,10,1,29,Flexible,Any,3,2,2,1,2,4,5,16.78,Tech,5,2,1,2,3,4,4,2,3,3,1,1,1,3,67.09
Computer Science,Interior Designer,2.765195878963102,3,1,0,0,5,1,0,2,0,4,2,1,2,1,Science,Bachelors,25-30,3,0,0,Flexible,Tier2_City,4,5,4,1,4,1,2,38.84,Education,3,3,2,5,5,0,2,4,1,2,0,0,4,4,37.47
Law,Paralegal,3.461748776231949,1,1,1,1,1,1,0,1,1,2,2,4,3,1,Arts,Bachelors,25-30,12,0,0,Office,Tier1_City,1,5,3,3,5,2,2,38.52,Tech,3,5,5,3,3,2,5,4,2,4,0,0,4,2,55.23
Art,Architect,3.5400419395259246,0,2,4,1,4,1,4,0,0,4,1,4,0,0,Arts,Bachelors,18-24,6,1,12,Hybrid,Tier2_City,3,5,5,3,1,3,5,25.08,Tech,3,1,3,4,5,1,3,5,2,3,0,1,3,4,51.28
Law,Physician Assistant,4.503520890587849,7,2,0,0,4,1,3,4,1,1,1,2,0,1,Arts,Bachelors,31-35,3,0,0,Hybrid,Tier1_City,1,2,5,3,1,3,1,36.72,Tech,5,5,3,4,1,1,3,4,5,3,0,1,3,1,48.88
Computer Science,Biologist,4.208631060666569,6,0,4,0,9,0,3,3,1,3,3,3,2,1,Science,Bachelors,31-35,0,1,49,Hybrid,Tier2_City,4,1,2,5,3,2,3,24.19,Other,4,5,4,3,4,1,1,1,1,2,0,1,5,4,43.18
Engineering,Industrial-Organizational Psychologist,4.473552217983039,9,1,0,0,3,1,1,1,3,2,1,2,4,0,Science,Bachelors,31-35,5,0,0,Remote,Tier1_City,5,5,5,5,5,0,3,43.01,Tech,3,5,2,2,2,4,4,1,1,3,1,1,3,4,45.64
Architecture,Conductor,4.438257208094793,9,1,3,0,1,1,3,4,4,2,2,3,0,1,Interdisciplinary,Masters,25-30,4,0,0,Hybrid,Tier2_City,5,3,0,5,0,0,5,18.64,Tech,4,4,3,5,3,0,2,5,5,2,0,0,2,4,65.29
Psychology,Legal Consultant,3.219682161018508,3,1,4,1,3,1,4,3,1,2,0,4,3,0,Arts,Masters,25-30,8,1,24,Remote,Any,5,2,2,2,2,3,5,46.58,Healthcare,1,1,1,5,4,5,4,5,2,1,0,0,1,2,53.79
Art,Sound Engineer,2.805082583032004,9,2,0,1,7,1,0,1,1,0,1,4,1,0,Arts,Bachelors,25-30,14,0,0,Flexible,Tier2_City,5,4,2,5,3,0,4,28.49,Healthcare,4,4,3,5,3,5,3,1,1,1,1,0,4,4,42.16
Marketing,Construction Manager,2.550516152704093,0,0,1,1,1,1,3,1,0,3,4,1,4,0,Commerce,PhD,18-24,13,0,0,Hybrid,Tier1_City,2,4,3,3,4,0,4,28.18,Education,4,3,1,1,2,3,4,4,1,1,0,1,2,2,56.67
Marketing,Web Developer,4.329117761523895,4,1,3,1,6,0,3,0,3,4,3,0,3,0,Commerce,PhD,36-40,13,1,31,Flexible,Tier2_City,3,2,4,3,5,2,2,34.53,Manufacturing,2,1,1,3,4,0,3,2,3,3,1,0,5,2,70.16
Architecture,Cybersecurity Analyst,4.874459767777487,3,1,1,1,0,0,3,1,3,2,0,4,0,1,Interdisciplinary,Bachelors,25-30,14,0,0,Office,Tier1_City,2,4,3,2,2,5,1,19.02,Education,3,1,5,1,0,1,5,2,3,1,1,1,5,4,51.56
Business,Chemist,2.6475594805310005,9,0,0,0,0,0,4,4,3,4,1,1,4,1,Commerce,Bachelors,25-30,8,1,38,Remote,Tier3_City,1,2,2,2,0,2,1,37.04,Other,5,3,5,1,4,1,4,2,2,4,0,0,1,4,57.9
Marketing,Software Developer,3.739830435731487,6,0,0,1,3,1,3,1,3,3,1,1,1,1,Commerce,Bachelors,25-30,11,1,20,Remote,Tier2_City,5,1,3,5,0,0,5,18.06,Other,2,3,3,4,0,3,3,4,3,3,0,1,3,4,56.99
Computer Science,Software Developer,4.105435763649161,3,0,3,0,1,1,3,4,1,4,0,0,2,0,Science,PhD,36-40,10,0,0,Flexible,Tier3_City,1,2,5,4,1,2,2,21.68,Other,4,5,3,5,1,0,4,2,3,5,0,1,2,4,69.63
Architecture,Physicist,4.952796933292562,6,1,3,1,2,1,2,4,2,0,2,1,4,1,Interdisciplinary,Masters,18-24,12,0,0,Office,Any,4,1,2,2,3,4,2,34.71,Finance,1,1,1,1,2,1,4,1,2,5,0,1,3,2,62.91
Law,Illustrator,3.732958861288264,3,0,4,1,3,1,4,4,3,0,4,2,2,1,Arts,Bachelors,25-30,7,0,0,Remote,Tier1_City,3,2,3,1,4,3,4,20.79,Education,5,2,5,2,3,3,2,4,2,1,0,0,2,2,53.72
Chemistry,Marketing Manager,3.43780093430358,4,1,2,1,5,1,4,3,0,4,2,3,1,1,Science,Bachelors,31-35,14,0,0,Remote,Any,4,5,1,3,2,5,3,12.4,Education,1,5,3,3,1,2,4,1,5,4,1,1,1,4,69.89
Marketing,Market Research Analyst,3.088619477748116,3,1,1,1,1,0,2,3,3,3,4,4,2,0,Commerce,Masters,25-30,6,0,0,Office,Tier1_City,3,3,1,1,0,4,1,43.98,Tech,4,1,5,2,1,1,4,4,1,1,1,0,5,2,54.37
Business,Social Media Manager,2.7823628771512587,7,1,3,1,7,1,1,3,3,4,4,0,0,1,Commerce,Bachelors,31-35,13,1,48,Hybrid,Tier2_City,4,1,2,3,2,4,2,46.34,Tech,1,3,2,5,5,2,4,2,1,2,0,0,5,1,59.88
Law,Pharmacist,2.7993874451373024,8,0,0,0,8,1,1,0,0,3,4,0,4,0,Arts,Bachelors,18-24,1,0,0,Remote,Tier1_City,4,3,3,3,4,0,4,32.46,Tech,2,3,1,4,5,0,3,2,2,3,1,0,1,3,36.18
Computer Science,Astronomer,3.80408697927382,6,0,4,0,1,1,1,1,2,4,2,3,3,0,Science,Masters,31-35,13,0,0,Office,Tier1_City,3,4,2,2,2,0,4,41.12,Manufacturing,1,2,5,2,4,4,3,5,2,5,0,1,5,5,64.57
Business,Inorganic Chemist,3.750742864852256,8,1,3,1,1,0,3,1,1,3,0,4,4,0,Commerce,Masters,18-24,7,0,0,Office,Tier2_City,1,1,3,2,3,4,4,49.37,Other,2,1,3,2,4,5,4,3,4,4,1,0,5,3,57.69
Business,Dentist,4.387845753886772,7,0,0,1,9,1,3,3,4,1,4,3,4,0,Commerce,Masters,18-24,2,0,0,Hybrid,Tier1_City,4,4,4,1,1,4,3,31.89,Tech,3,4,1,1,5,0,5,1,3,4,0,0,4,3,60.03
Finance,Biologist,4.861382325843081,5,2,2,1,4,1,0,0,3,1,1,0,3,0,Commerce,Masters,36-40,5,0,0,Flexible,Tier1_City,3,5,3,3,2,1,2,45.71,Finance,5,5,4,2,5,4,4,2,4,3,0,1,3,5,43.58
Architecture,Web Developer,4.48550877222065,8,1,1,1,7,1,3,3,2,2,3,1,2,1,Interdisciplinary,Masters,25-30,9,1,33,Office,Tier1_City,3,5,3,1,5,1,5,19.88,Healthcare,1,1,1,4,0,3,4,4,1,1,1,0,1,4,59.89
Physics,Manager,4.35253655547031,1,1,0,0,6,1,1,3,4,0,3,0,1,1,Science,Bachelors,25-30,6,0,0,Flexible,Tier2_City,4,1,2,4,1,3,5,35.92,Finance,2,4,2,2,0,4,3,5,2,1,0,0,3,3,44.45
Architecture,Mechanical Engineer,3.5577580378545965,1,0,3,1,1,0,0,4,0,2,3,3,0,0,Interdisciplinary,Masters,18-24,11,0,0,Remote,Tier1_City,1,1,3,1,4,4,4,5.62,Manufacturing,4,3,1,2,1,3,1,1,5,1,1,1,5,4,63.05
Chemistry,Risk Analyst,2.701878712790303,4,0,1,1,1,1,2,4,2,4,4,4,0,1,Science,Bachelors,31-35,5,0,0,Remote,Tier2_City,5,3,2,5,1,2,4,40.08,Tech,4,3,5,5,1,1,1,2,1,5,1,0,3,4,59.54
Marketing,Education Administrator,3.2146737814346578,1,2,2,1,7,1,0,4,4,1,3,4,0,1,Commerce,Masters,25-30,4,0,0,Remote,Tier2_City,2,4,2,1,2,5,3,42.0,Education,2,4,5,4,4,0,4,5,2,2,0,1,1,1,54.89
Art,Mechanical Engineer,3.6587954119018034,3,2,2,1,6,1,1,3,0,3,0,1,1,0,Arts,Bachelors,40+,3,0,0,Hybrid,Tier2_City,5,3,0,5,2,1,4,21.86,Healthcare,5,4,3,2,4,3,5,2,1,4,0,1,3,2,33.63
Law,Judge,4.579341309965185,8,0,4,1,8,1,1,3,0,2,4,4,1,1,Arts,Masters,40+,1,1,59,Flexible,Tier1_City,4,1,2,5,5,0,2,33.03,Other,3,2,3,5,3,0,2,2,4,2,0,0,1,5,51.69
Finance,Music Teacher,4.73003158469841,3,1,4,1,4,0,4,1,2,3,0,1,4,1,Commerce,Bachelors,31-35,8,0,0,Flexible,Tier2_City,4,3,3,5,0,4,4,43.34,Manufacturing,3,1,1,3,2,0,3,2,2,3,1,1,1,5,48.24
Law,Industrial-Organizational Psychologist,3.4717910807945,4,2,0,1,1,0,3,4,1,2,3,4,1,1,Arts,Bachelors,25-30,13,0,0,Office,Tier2_City,3,1,1,4,5,2,4,44.53,Finance,5,3,1,2,3,3,2,5,3,2,1,0,4,5,64.83
Law,Pharmacist,4.320770259073233,0,1,4,1,9,0,0,0,2,0,1,0,4,0,Arts,Bachelors,25-30,6,0,0,Hybrid,Tier2_City,1,2,4,1,2,5,2,8.01,Tech,1,5,1,2,2,3,2,3,5,4,0,1,4,2,44.43
Art,Data Scientist,3.751436406388256,3,0,3,0,6,1,0,4,4,1,4,1,2,0,Arts,High School,31-35,6,0,0,Office,Tier2_City,1,4,3,1,1,2,1,41.89,Manufacturing,2,3,5,5,1,4,5,2,2,1,1,0,3,5,45.39
Finance,Digital Marketing Specialist,2.794501018332914,7,1,2,0,4,1,2,3,0,1,4,0,4,0,Commerce,Masters,18-24,3,0,0,Hybrid,Tier1_City,4,5,5,4,5,2,5,15.89,Manufacturing,3,1,5,5,4,1,5,1,1,1,0,1,3,3,45.37
Education,Fluid Mechanics Engineer,2.574647945271812,3,2,4,1,5,0,2,1,3,0,3,4,3,0,Arts,Masters,25-30,13,0,0,Remote,Tier2_City,1,5,3,3,5,0,4,37.18,Education,5,4,4,5,3,1,1,5,2,5,0,1,2,5,70.55
Chemistry,Marketing Manager,3.978328449156759,1,0,4,1,0,1,2,1,4,3,0,2,4,1,Science,Bachelors,18-24,4,0,0,Hybrid,Tier1_City,2,3,3,2,0,1,2,18.28,Other,3,2,4,2,5,2,3,2,3,5,1,0,4,1,51.04
Music,School Psychologist,4.790705441526271,1,2,2,1,9,0,3,0,0,3,0,0,0,1,Arts,Bachelors,18-24,5,0,0,Hybrid,Tier1_City,1,5,0,1,2,2,5,5.65,Education,3,3,4,1,2,4,1,5,3,5,1,1,4,4,45.08
Music,Forensic Psychologist,4.781564054647943,0,0,2,0,6,0,2,0,2,2,4,0,3,1,Arts,Bachelors,18-24,11,0,0,Remote,Tier1_City,1,2,1,2,2,5,3,12.86,Education,1,2,3,1,5,4,5,1,2,4,1,0,3,4,52.63
Psychology,Physicist,3.213640516234862,0,0,4,1,2,0,3,1,2,2,2,2,2,0,Arts,High School,25-30,10,0,0,Remote,Tier3_City,3,2,3,4,4,1,1,22.21,Other,3,4,5,5,5,0,5,1,4,5,0,1,4,1,61.06
Engineering,Financial Analyst,4.007373960326713,4,2,3,0,6,0,0,2,2,4,1,0,0,1,Science,Bachelors,31-35,11,0,0,Remote,Tier2_City,4,3,5,3,0,3,4,37.84,Finance,2,1,1,1,0,0,3,4,5,5,0,0,1,2,54.44
Law,Financial Controller,4.345037065609928,9,2,4,0,2,1,1,1,3,4,2,1,4,0,Arts,Masters,25-30,1,1,33,Hybrid,Any,1,5,2,3,4,0,1,7.73,Education,5,3,1,3,2,3,3,4,5,2,1,0,4,2,48.83
Business,Clinical Psychologist,2.997351467401187,8,1,0,0,5,1,2,2,3,3,4,2,1,0,Commerce,Bachelors,25-30,3,0,0,Remote,Any,4,5,1,3,4,1,4,41.21,Other,1,1,4,1,2,2,4,3,3,2,0,0,4,5,52.5
Chemistry,Education Administrator,2.899655519252114,5,0,3,1,4,1,4,0,4,0,1,0,3,0,Science,Bachelors,18-24,14,1,7,Office,Any,1,1,1,4,4,1,4,49.86,Manufacturing,1,5,3,1,5,0,4,4,1,2,1,1,1,5,45.86
Education,Acoustics Specialist,4.372861369116457,4,1,1,1,3,0,0,1,2,2,2,0,4,0,Arts,Bachelors,25-30,12,0,0,Hybrid,Tier1_City,1,3,3,5,3,2,4,40.05,Manufacturing,5,1,3,2,4,4,2,5,3,5,0,0,1,3,53.72
Education,Electrical Engineer,2.6983039632309342,7,2,2,1,0,0,0,3,1,2,2,0,4,1,Arts,Bachelors,25-30,3,0,0,Hybrid,Tier2_City,1,1,2,5,4,5,1,25.27,Other,2,4,4,1,3,2,3,4,4,5,0,0,4,4,46.5
Computer Science,Acoustics Specialist,3.1321287696141704,4,1,2,1,1,1,2,3,2,1,3,3,4,0,Science,Bachelors,31-35,11,0,0,Office,Tier2_City,3,2,1,2,5,2,3,29.7,Manufacturing,3,4,1,5,1,4,3,5,3,3,0,0,2,5,66.89
Psychology,Legal Secretary,3.632935428331337,5,0,0,0,7,1,1,2,4,4,3,1,2,1,Arts,Masters,40+,12,1,18,Hybrid,Tier2_City,1,3,4,5,1,5,2,3.29,Healthcare,3,5,3,2,3,4,1,5,4,5,1,1,3,1,70.54
Art,Landscape Architect,3.958023317574664,5,1,3,1,4,1,0,4,2,2,4,3,1,1,Arts,Bachelors,18-24,3,0,0,Hybrid,Tier1_City,5,1,2,5,5,0,2,12.84,Healthcare,2,1,2,1,1,4,1,3,4,5,1,0,1,2,57.84
Architecture,Architectural Technologist,2.602951924675069,0,1,2,1,6,1,0,2,0,0,1,0,1,1,Interdisciplinary,Bachelors,18-24,6,0,0,Flexible,Tier1_City,2,2,1,3,5,1,3,45.25,Other,4,4,4,3,5,1,4,5,1,5,1,1,4,5,41.15
Physics,Mechanical Engineer,3.361142854416375,9,0,4,1,9,1,3,4,3,3,0,0,1,1,Science,Bachelors,25-30,12,0,0,Hybrid,Tier3_City,1,5,1,3,2,4,3,4.02,Other,5,4,1,2,0,4,2,4,2,2,0,1,5,2,53.08
Engineering,Education Administrator,4.2802259705971935,1,2,0,0,7,0,1,4,3,3,4,0,3,1,Science,Bachelors,40+,6,0,0,Flexible,Any,5,3,2,2,3,5,4,45.53,Finance,2,4,2,2,5,1,5,4,1,5,0,0,2,4,57.98
Law,Art Therapist,3.794083846690315,8,2,3,0,8,1,4,3,4,2,0,2,0,0,Arts,Bachelors,31-35,6,0,0,Hybrid,Tier2_City,4,1,0,1,4,5,4,8.32,Other,3,4,5,2,5,0,4,2,1,2,1,0,3,3,48.65
Business,Game Developer,4.025193427793567,0,2,2,0,2,0,1,2,1,4,1,3,1,1,Commerce,PhD,36-40,6,0,0,Remote,Tier1_City,3,4,2,2,2,2,2,9.25,Education,5,2,1,1,4,4,1,3,2,2,1,1,2,2,54.03
Business,Investment Banker,3.483914704214321,6,1,4,0,6,0,3,0,3,4,1,0,4,1,Commerce,Masters,25-30,1,0,0,Hybrid,Any,4,5,4,2,0,2,4,11.24,Manufacturing,5,3,2,5,2,5,5,1,2,4,0,1,1,2,47.04
Medicine,Legal Consultant,3.981097425809065,0,0,0,0,5,1,2,4,4,0,2,1,1,0,Science,Masters,40+,4,0,0,Remote,Tier1_City,3,1,0,4,0,3,4,40.57,Education,3,2,5,4,5,3,2,1,2,5,1,1,1,5,53.26
Engineering,Geneticist,2.644330329588063,5,1,0,1,3,1,4,4,2,4,3,2,0,1,Science,Bachelors,18-24,9,0,0,Remote,Any,4,1,3,4,2,5,3,25.47,Other,2,4,3,4,3,5,1,2,1,2,0,0,3,5,61.89
Psychology,Chemist,4.251371608647419,3,0,1,0,3,1,0,3,1,2,2,1,4,0,Arts,Bachelors,18-24,1,0,0,Remote,Any,4,3,0,2,1,0,1,9.82,Manufacturing,4,1,1,4,3,3,4,4,3,2,0,0,4,4,35.74
Engineering,Biochemist,4.876767693305443,5,2,4,0,5,1,4,2,3,4,1,3,0,1,Science,Bachelors,36-40,4,0,0,Remote,Tier2_City,2,4,4,2,2,1,5,35.28,Healthcare,5,2,1,1,1,5,4,3,3,2,1,1,1,3,48.69
Architecture,Illustrator,3.899928157571735,4,2,2,0,8,1,2,2,0,1,3,4,4,0,Interdisciplinary,Masters,36-40,11,0,0,Office,Tier2_City,2,5,4,2,2,1,5,47.21,Manufacturing,5,5,3,3,3,1,2,4,1,5,1,0,5,5,57.82
Art,Human Resources Specialist,3.117330901679808,8,0,0,1,8,0,2,1,0,1,1,3,1,0,Arts,Masters,18-24,5,0,0,Office,Tier3_City,2,5,4,5,3,1,4,29.91,Finance,5,3,1,2,2,1,4,2,2,3,1,0,5,3,45.39
Music,Illustrator,4.372607296124242,8,2,2,0,0,1,2,3,1,2,2,3,4,1,Arts,Bachelors,18-24,2,0,0,Flexible,Tier2_City,4,3,1,4,0,5,4,7.64,Tech,2,1,4,2,1,2,2,1,1,5,0,0,4,3,43.69
Music,Architect,3.4656470412867035,2,2,4,0,5,0,2,0,1,4,2,3,0,1,Arts,Bachelors,18-24,5,0,0,Remote,Tier1_City,3,3,0,2,0,2,5,5.57,Manufacturing,5,2,2,5,2,4,3,3,3,5,0,1,5,5,52.06
Psychology,Music Teacher,4.117287825044476,7,0,4,0,4,0,1,0,0,3,1,4,1,0,Arts,Bachelors,18-24,14,0,0,Office,Tier2_City,2,3,4,3,4,0,3,40.41,Other,3,3,5,2,5,4,1,4,2,3,1,1,5,2,51.74
Business,Data Scientist,4.254835181997791,4,2,4,0,8,0,0,3,3,0,4,0,1,1,Commerce,Masters,18-24,4,0,0,Remote,Tier1_City,3,4,5,3,5,1,5,32.43,Finance,3,2,5,5,1,4,3,5,1,5,0,0,2,1,53.28
Education,Education Administrator,2.903823916358989,8,2,0,1,3,1,0,1,1,1,1,4,1,0,Arts,Masters,40+,3,0,0,Hybrid,Tier3_City,3,3,0,5,2,5,5,46.36,Healthcare,1,5,2,1,2,4,3,5,3,4,1,1,2,4,42.65
Chemistry,Urban Planner,3.602682276921276,3,2,2,0,7,1,1,4,4,2,3,0,1,0,Science,Bachelors,31-35,9,0,0,Flexible,Tier2_City,1,4,5,5,2,4,5,28.72,Healthcare,5,4,4,4,1,2,4,5,2,4,0,1,5,3,58.2
Education,Ecologist,2.8663692560528977,4,2,1,1,4,1,3,3,2,2,4,0,2,1,Arts,Bachelors,31-35,8,0,0,Remote,Tier1_City,5,4,0,1,1,3,4,5.93,Tech,4,5,1,5,4,0,5,1,2,5,0,1,5,2,61.56
Computer Science,Aerospace Engineer,4.853554662801809,6,1,2,1,3,1,3,3,3,0,2,3,1,0,Science,Masters,31-35,10,0,0,Flexible,Tier3_City,4,2,3,1,0,3,4,21.97,Other,1,4,3,5,3,1,4,5,5,4,0,1,5,3,70.02
Music,Physicist,3.4340459627331548,6,1,3,0,9,0,3,0,3,3,3,2,4,0,Arts,Bachelors,25-30,13,0,0,Office,Tier2_City,5,3,5,1,1,1,5,33.93,Education,5,3,3,2,2,1,1,5,2,2,1,1,5,5,52.65
Medicine,Accountant,3.647864375771656,4,1,2,0,1,1,0,2,2,3,3,4,3,0,Science,Bachelors,31-35,7,1,53,Office,Tier2_City,4,3,3,5,3,2,4,21.09,Education,5,2,1,1,0,3,4,2,3,1,0,1,1,4,52.42
Biology,Credit Analyst,3.853168621850768,9,1,0,1,6,0,0,2,1,3,1,1,0,1,Science,Bachelors,25-30,11,0,0,Office,Tier1_City,3,5,3,5,4,3,5,49.98,Manufacturing,2,2,5,4,5,5,1,2,3,5,1,0,4,4,59.71
Computer Science,Dentist,4.012672687953822,6,1,3,0,9,0,0,1,1,0,3,4,0,1,Science,Masters,25-30,6,0,0,Office,Tier2_City,5,3,5,5,1,3,3,22.05,Healthcare,2,5,2,1,4,4,5,2,4,3,0,1,1,2,50.86
Marketing,Fluid Mechanics Engineer,3.130155085077699,1,2,2,1,6,0,2,3,3,3,0,1,4,1,Commerce,Bachelors,25-30,10,0,0,Flexible,Tier1_City,1,4,1,3,0,3,4,28.67,Finance,3,1,2,4,4,1,5,4,3,2,0,1,3,3,51.16
Education,Legal Secretary,3.8822356243443146,0,0,2,1,5,0,2,1,0,3,2,3,1,1,Arts,Bachelors,25-30,14,0,0,Office,Tier1_City,5,3,1,5,3,3,1,13.59,Tech,1,3,5,3,5,3,5,5,3,3,1,1,3,2,55.54
Business,Curriculum Developer,4.859128403946581,6,0,1,0,1,0,3,0,3,2,3,2,0,1,Commerce,Masters,36-40,0,1,58,Hybrid,Tier1_City,5,1,3,3,2,1,4,10.15,Education,1,4,2,1,2,2,1,1,3,3,0,1,4,5,46.36
Engineering,Illustrator,4.675596736895191,8,2,3,1,7,0,3,0,4,1,3,0,0,0,Science,Bachelors,40+,8,1,16,Hybrid,Tier1_City,1,5,4,1,3,5,3,33.33,Manufacturing,1,3,5,3,2,3,5,5,2,1,0,0,4,1,52.08
Art,Art Director,4.110166012404374,1,2,2,0,1,1,3,1,2,3,4,1,3,1,Arts,Bachelors,25-30,8,1,57,Hybrid,Tier2_City,1,1,2,1,5,0,3,30.66,Manufacturing,3,5,4,4,0,5,3,5,4,4,0,1,5,5,64.92
Psychology,Landscape Architect,2.569071090535606,3,2,2,1,7,0,0,2,2,0,3,4,3,1,Arts,Bachelors,31-35,5,1,41,Flexible,Tier2_City,2,4,5,1,1,0,4,3.2,Healthcare,4,2,1,5,5,4,4,4,4,3,1,0,4,3,51.85
Music,Inorganic Chemist,2.7645428212132748,6,0,0,1,6,0,2,4,1,4,3,2,1,0,Arts,High School,18-24,6,0,0,Flexible,Tier2_City,4,1,1,2,0,2,2,16.38,Finance,4,4,5,3,2,3,4,2,1,5,0,0,5,1,50.57
Law,Principal,2.916644928968672,0,0,4,0,5,1,2,3,4,0,1,1,1,1,Arts,Masters,31-35,12,0,0,Hybrid,Tier2_City,3,4,2,2,1,5,5,33.25,Finance,4,4,4,4,5,4,1,5,1,5,0,0,1,1,61.78
Computer Science,Organic Chemist,2.991831447333208,9,1,1,0,2,1,2,1,0,0,0,1,4,1,Science,Bachelors,25-30,2,1,29,Office,Any,5,5,1,4,2,4,5,41.18,Education,1,4,5,4,0,2,2,3,4,2,0,1,3,1,32.0
Law,Conductor,3.224903648442531,7,1,0,0,8,1,2,1,0,0,4,0,3,0,Arts,Bachelors,18-24,4,0,0,Flexible,Tier1_City,5,2,0,4,2,0,3,17.68,Manufacturing,5,4,4,3,2,2,2,3,4,2,0,0,2,5,43.7
Medicine,Physicist,2.746581640104628,9,0,3,0,2,1,4,1,2,1,4,3,4,0,Science,Masters,25-30,6,1,26,Remote,Tier2_City,3,1,4,4,0,4,4,33.43,Healthcare,1,3,4,1,0,2,4,2,2,3,0,1,1,3,55.08
Education,Conductor,3.5083911800412766,2,0,1,1,6,0,1,0,3,1,3,1,1,1,Arts,Masters,31-35,0,0,0,Hybrid,Any,1,5,1,2,5,0,2,15.47,Finance,5,3,4,5,1,5,2,2,3,1,0,0,3,1,41.08
Physics,Physicist,4.308977411668773,4,1,0,1,9,1,4,0,1,3,1,4,2,0,Science,Masters,18-24,11,0,0,Hybrid,Tier1_City,1,2,0,2,4,0,1,35.45,Manufacturing,2,5,1,4,3,3,2,5,4,4,1,0,2,2,70.47
Architecture,Clinical Psychologist,4.999574369802996,8,0,0,1,9,0,2,4,2,0,2,0,2,0,Interdisciplinary,Bachelors,36-40,0,1,35,Office,Tier2_City,5,4,4,4,3,2,5,35.8,Finance,3,2,5,1,3,4,2,3,5,1,1,1,2,1,37.5
Finance,Clinical Psychologist,3.3881663060256115,7,1,1,1,7,1,0,3,2,3,4,1,0,1,Commerce,High School,18-24,4,0,0,Hybrid,Tier2_City,5,4,5,4,3,3,2,9.12,Tech,4,2,5,4,2,1,1,1,2,1,1,1,4,5,38.98
Education,Landscape Architect,3.437682899790912,4,1,1,0,1,0,0,3,3,1,2,4,4,0,Arts,Masters,36-40,8,1,38,Office,Tier1_City,3,2,1,5,2,2,5,34.26,Finance,1,3,5,4,2,4,3,1,1,2,1,1,1,2,53.22
Finance,Architect,4.008057421108518,6,0,3,1,3,1,3,0,4,1,2,3,1,1,Commerce,Bachelors,31-35,6,0,0,Hybrid,Tier1_City,3,5,4,4,1,0,4,18.68,Finance,1,5,4,4,3,3,5,3,2,4,1,0,4,3,51.56
Computer Science,Accountant,2.9835169146241065,0,0,2,1,9,0,3,0,1,0,1,2,0,0,Science,Masters,25-30,0,0,0,Remote,Tier3_City,4,2,1,5,1,5,5,11.11,Manufacturing,2,1,2,1,3,2,1,2,4,3,0,1,2,3,36.72
Biology,Entrepreneur,4.780621712515938,3,2,1,1,2,0,1,1,0,1,0,3,4,0,Science,Masters,25-30,12,1,58,Remote,Tier2_City,1,1,3,3,5,3,1,26.52,Finance,5,4,2,2,0,0,3,4,5,1,1,0,1,5,56.15
Medicine,Data Scientist,3.2983462624969926,9,1,4,0,2,1,2,2,4,3,2,3,2,0,Science,Masters,31-35,12,0,0,Remote,Tier1_City,2,2,1,2,4,5,4,24.26,Finance,4,2,5,5,0,1,5,4,4,3,1,0,2,1,70.49
Medicine,Entrepreneur,3.305145265018649,7,1,3,0,9,0,1,3,3,4,4,2,0,1,Science,Bachelors,31-35,14,0,0,Remote,Tier3_City,2,3,1,4,1,5,3,39.37,Tech,3,4,2,5,1,4,5,1,1,2,1,1,3,3,58.37
Education,Financial Controller,2.7572000288227847,0,0,1,0,8,1,3,3,1,2,1,4,4,0,Arts,Bachelors,31-35,11,0,0,Hybrid,Tier3_City,3,1,0,2,3,5,2,6.97,Finance,5,2,2,2,1,5,1,2,2,3,0,1,2,4,58.06
Business,Graphic Designer,4.511571676760953,3,2,2,0,0,1,2,2,3,1,2,1,1,1,Commerce,Masters,25-30,4,1,47,Office,Tier1_City,4,5,3,2,1,3,5,40.12,Finance,5,1,2,4,0,4,4,5,1,5,1,0,2,1,53.77
Biology,Illustrator,4.587873433308494,5,2,3,0,8,0,4,4,1,1,1,2,3,1,Science,Bachelors,25-30,14,1,18,Remote,Tier2_City,5,1,2,2,4,5,4,7.99,Manufacturing,4,2,4,2,1,0,1,3,4,4,1,1,5,2,62.5
Finance,Biochemist,3.869317937818952,9,1,3,0,9,0,0,2,3,0,2,4,1,0,Commerce,Bachelors,40+,7,0,0,Hybrid,Tier2_City,3,4,4,3,3,3,4,12.75,Healthcare,3,1,5,3,4,5,5,1,4,1,0,1,3,5,48.11
Medicine,Musician,3.0958523531453057,2,0,1,0,8,1,2,1,4,0,3,4,3,0,Science,Masters,18-24,7,0,0,Hybrid,Tier1_City,3,4,2,1,1,4,5,27.25,Tech,4,2,5,3,5,2,2,4,2,2,1,1,3,5,54.44
Art,Zoologist,3.8063420388304072,5,0,0,0,6,0,0,2,0,4,3,3,1,0,Arts,Masters,25-30,11,1,17,Remote,Tier2_City,3,4,2,4,3,0,3,24.77,Finance,4,3,3,1,0,0,2,4,4,3,1,0,3,2,58.46
Psychology,Mechanical Engineer,3.202798014785893,5,1,0,1,2,1,3,1,0,0,1,3,1,0,Arts,Bachelors,25-30,1,1,34,Hybrid,Tier1_City,2,1,3,1,2,1,5,49.48,Healthcare,1,4,3,1,1,2,4,5,3,2,1,0,4,1,36.59
Architecture,School Psychologist,4.404691969397892,5,1,3,0,7,1,4,2,1,3,3,1,1,0,Interdisciplinary,Bachelors,31-35,6,0,0,Office,Tier1_City,3,4,3,1,2,5,3,30.71,Manufacturing,3,5,2,3,1,5,1,5,2,5,1,1,4,2,56.18
Business,Human Resources Specialist,3.2598703899371624,5,1,1,1,1,1,0,0,3,4,0,1,2,0,Commerce,Bachelors,31-35,9,0,0,Remote,Tier1_City,4,5,3,1,5,2,5,18.39,Tech,5,5,5,2,2,4,5,4,1,2,1,1,2,2,46.22
Physics,Marketing Manager,4.88011655567038,2,2,3,1,2,1,4,0,3,1,1,4,0,0,Science,Masters,25-30,4,1,41,Remote,Any,2,5,0,2,2,4,4,45.31,Other,4,2,2,1,2,5,2,2,5,4,0,1,3,4,56.98
Art,Software Developer,3.604310765057437,8,2,0,0,5,0,2,0,2,0,3,2,0,1,Arts,PhD,18-24,8,0,0,Flexible,Tier3_City,4,1,0,5,1,2,1,17.67,Manufacturing,2,5,4,2,2,2,3,4,4,4,0,1,5,2,58.72
Psychology,Web Developer,3.8666627082011287,9,2,2,1,6,0,4,2,2,3,2,0,3,0,Arts,Bachelors,18-24,2,1,50,Office,Tier2_City,2,2,4,2,4,1,1,15.87,Healthcare,3,4,5,1,3,1,2,3,5,4,0,1,2,5,50.64
Art,Artist,4.934906082991546,0,0,1,0,8,1,4,4,2,0,4,0,1,1,Arts,Bachelors,25-30,0,0,0,Hybrid,Tier2_City,4,2,3,2,3,3,4,26.24,Tech,2,3,4,5,5,3,4,2,1,5,1,1,3,3,50.85
Education,Music Teacher,4.983146366846951,7,0,3,0,4,1,0,0,2,1,1,3,0,0,Arts,Masters,25-30,12,0,0,Hybrid,Tier1_City,1,5,2,1,0,1,1,45.92,Finance,5,3,4,2,3,3,1,5,5,4,0,0,3,1,56.63
Medicine,Biomedical Engineer,3.275201648853769,0,0,2,0,0,1,1,3,0,4,2,1,3,0,Science,Bachelors,40+,3,0,0,Office,Tier2_City,1,1,4,2,2,2,3,36.3,Healthcare,3,1,5,3,3,2,1,5,2,5,0,1,4,3,44.25
Law,Human Resources Specialist,4.068848171121408,7,2,4,1,1,0,0,2,3,4,3,4,0,0,Arts,Bachelors,25-30,6,1,34,Office,Tier1_City,2,5,0,1,2,1,4,34.84,Manufacturing,1,5,2,3,0,4,2,5,1,1,0,1,3,2,49.01
Biology,Judge,4.541494356454762,1,2,3,0,0,1,3,4,2,1,2,0,4,0,Science,PhD,25-30,0,0,0,Hybrid,Tier2_City,1,4,1,5,0,0,3,37.13,Tech,3,4,3,1,2,4,3,3,2,5,0,1,5,2,46.39
Psychology,Legal Consultant,2.964913347465931,2,2,1,0,6,0,3,0,3,0,1,0,2,0,Arts,Bachelors,36-40,1,0,0,Hybrid,Tier3_City,5,4,1,4,0,1,4,34.0,Healthcare,5,5,2,2,2,5,1,5,2,3,0,0,3,4,30.94
Music,Construction Manager,3.13013641295621,0,2,1,0,7,0,3,3,1,2,0,1,2,0,Arts,Masters,25-30,13,0,0,Hybrid,Tier1_City,4,5,4,1,1,5,3,38.71,Other,1,4,3,4,0,5,1,2,5,4,1,0,5,5,65.65
Architecture,Acoustics Specialist,2.9688169054408324,2,2,1,1,2,0,1,2,4,2,3,2,4,1,Interdisciplinary,Bachelors,25-30,4,1,41,Remote,Tier2_City,2,4,0,5,3,0,3,12.06,Healthcare,5,1,1,3,3,2,5,5,3,2,1,1,2,1,50.3
Law,Acoustics Specialist,4.593887503820083,3,0,0,0,1,0,2,0,4,2,2,0,3,1,Arts,Bachelors,18-24,8,0,0,Flexible,Tier2_City,1,3,4,4,2,5,1,11.33,Manufacturing,3,5,3,3,5,0,4,5,2,5,1,1,4,2,54.53
Engineering,School Counselor,2.973980418285864,5,2,1,1,4,1,4,2,3,1,4,0,0,0,Science,Masters,25-30,13,0,0,Hybrid,Tier1_City,2,3,0,3,4,1,4,20.02,Manufacturing,5,3,5,2,1,0,5,4,2,1,1,0,3,5,61.95
Music,Lawyer,3.069090572975768,6,0,2,1,4,0,2,4,2,1,3,4,2,0,Arts,Bachelors,36-40,0,0,0,Hybrid,Tier2_City,5,3,3,1,1,0,5,43.0,Finance,3,1,3,2,4,0,4,4,1,3,0,1,2,3,41.29
Chemistry,Advertising Manager,3.3371475525804137,0,1,4,1,7,1,4,0,3,2,3,2,4,1,Science,PhD,25-30,11,0,0,Flexible,Tier2_City,2,2,1,1,1,0,1,36.58,Finance,1,5,1,1,2,4,1,3,3,1,0,0,3,1,60.1
Law,Animator,2.6413377937276654,9,1,2,1,2,0,0,0,3,2,0,4,4,1,Arts,Masters,25-30,3,0,0,Remote,Tier3_City,2,2,2,3,4,1,3,29.62,Healthcare,3,3,3,4,3,2,3,2,4,1,0,0,3,1,47.64
Physics,Electrical Engineer,3.117705917539228,1,2,4,1,3,0,0,3,1,1,1,4,4,1,Science,Bachelors,31-35,11,0,0,Remote,Tier1_City,3,1,3,3,4,4,3,3.91,Manufacturing,5,3,2,3,1,2,3,2,2,3,0,1,1,4,54.93
Medicine,Composer,4.405141368509431,9,2,4,1,7,0,1,2,3,0,1,1,1,0,Science,Bachelors,36-40,13,0,0,Office,Tier2_City,3,2,2,1,5,3,5,14.08,Healthcare,5,4,3,2,2,4,1,4,1,4,0,0,1,5,52.39
Marketing,Social Media Manager,4.877027566528467,0,2,2,0,5,0,2,4,1,4,4,1,3,0,Commerce,Bachelors,25-30,2,1,7,Hybrid,Any,3,5,4,3,4,3,5,40.77,Education,5,3,5,3,2,2,4,2,5,2,0,1,4,1,56.23
Engineering,Ecologist,4.787900976860398,2,0,4,1,3,0,3,2,3,4,0,4,3,0,Science,Bachelors,25-30,13,1,35,Office,Tier2_City,3,1,1,2,0,3,3,14.4,Other,2,2,5,4,4,1,5,5,1,3,0,1,4,3,54.17
Education,Graphic Designer,2.994028729856568,3,2,4,1,6,1,0,2,1,2,3,1,0,0,Arts,Bachelors,40+,4,1,27,Remote,Tier2_City,4,1,2,4,2,0,5,37.32,Manufacturing,2,5,4,5,3,0,5,3,3,4,1,0,2,3,47.34
Finance,School Psychologist,3.451993006060729,0,2,3,0,4,1,3,4,2,2,0,0,2,1,Commerce,Bachelors,18-24,4,0,0,Hybrid,Tier1_City,5,5,5,4,5,3,2,11.68,Education,2,5,2,5,5,2,5,4,1,4,1,1,2,2,48.83
Marketing,Software Developer,2.7513097265118063,4,2,4,0,9,0,0,2,3,1,4,4,1,0,Commerce,Bachelors,31-35,9,1,6,Remote,Tier1_City,2,3,4,4,0,0,1,31.5,Education,4,4,2,4,0,4,4,5,4,5,1,0,1,2,60.77
Engineering,Biotechnologist,3.551166969032717,9,2,0,0,7,1,4,4,1,3,1,1,2,1,Science,Masters,31-35,1,0,0,Office,Any,5,2,0,2,5,4,4,32.53,Manufacturing,3,3,3,2,1,2,1,4,5,4,0,0,5,3,56.01
Biology,Organic Chemist,4.232329130452546,4,1,1,0,0,0,1,1,4,3,4,3,0,1,Science,Masters,31-35,4,0,0,Remote,Tier1_City,2,1,3,3,2,1,5,38.34,Finance,2,4,3,5,1,5,3,4,5,3,1,1,5,5,63.59
Biology,Education Administrator,4.239697237899188,8,1,3,0,6,1,3,4,3,1,3,1,0,0,Science,Masters,25-30,8,0,0,Hybrid,Any,3,3,0,5,5,1,5,23.6,Healthcare,5,2,5,2,3,5,5,3,2,4,0,0,5,5,65.84
Marketing,Fluid Mechanics Engineer,4.994054967747603,3,2,1,1,7,1,4,3,4,1,1,2,4,0,Commerce,High School,25-30,4,0,0,Office,Tier1_City,4,4,3,3,0,0,2,32.74,Tech,5,4,4,1,1,4,4,3,3,5,1,1,1,3,48.57
Finance,Animator,3.325813175926106,0,2,2,0,5,1,4,1,1,1,2,2,3,1,Commerce,Bachelors,31-35,14,0,0,Flexible,Tier1_City,2,3,1,1,3,0,4,25.89,Tech,2,5,1,3,0,2,4,4,5,5,1,1,4,3,66.5
Music,Lawyer,4.907876751166558,6,0,4,0,2,1,0,4,3,2,1,3,0,0,Arts,Masters,18-24,10,0,0,Office,Tier1_City,2,3,2,4,2,4,2,47.52,Other,2,4,3,1,1,3,5,5,5,2,1,1,5,2,62.21
Music,Microbiologist,3.964864109438036,0,1,1,0,0,0,1,0,1,0,4,0,4,0,Arts,Bachelors,25-30,9,0,0,Hybrid,Tier2_City,1,2,0,3,1,3,4,27.53,Manufacturing,5,5,2,5,3,1,1,1,4,3,1,1,5,3,53.77
Marketing,Acoustics Specialist,4.225871785668144,8,2,1,1,9,1,4,4,2,2,4,4,3,1,Commerce,High School,18-24,1,0,0,Hybrid,Tier3_City,4,4,0,5,2,4,1,12.85,Finance,2,1,3,5,0,3,3,5,1,3,1,0,4,2,47.27
Music,Digital Marketing Specialist,3.7062513962973167,9,1,2,1,3,1,4,4,2,2,2,3,2,1,Arts,Masters,18-24,6,0,0,Office,Any,4,1,2,1,2,1,5,34.39,Finance,4,2,4,2,4,2,3,2,4,2,1,1,2,2,63.68
Marketing,Biotechnologist,4.78340975531594,3,1,3,0,2,1,4,4,0,1,0,1,4,0,Commerce,Masters,40+,14,0,0,Flexible,Tier1_City,4,5,2,2,2,1,1,28.78,Finance,4,2,2,5,5,5,4,4,3,3,0,0,3,2,56.9
Medicine,Physicist,4.615506103097254,7,1,1,1,1,0,4,2,0,4,3,0,0,0,Science,Bachelors,25-30,5,0,0,Flexible,Tier1_City,5,1,4,2,3,5,4,40.78,Tech,4,5,4,2,3,5,1,4,3,1,0,0,3,4,49.05
Art,Curriculum Developer,3.2677156838793424,2,2,0,0,2,1,1,2,2,1,0,4,3,0,Arts,Bachelors,40+,6,0,0,Flexible,Tier2_City,3,2,3,5,0,3,5,11.31,Education,1,1,2,4,5,5,2,3,5,5,1,1,4,5,53.13
Physics,Geneticist,4.223856168690317,9,1,4,1,7,0,0,1,1,2,1,3,4,1,Science,Masters,18-24,7,0,0,Office,Tier3_City,1,1,5,1,1,1,2,15.26,Other,4,3,3,5,4,4,3,2,2,1,0,0,2,3,44.12
Chemistry,Surgeon,4.069244626729175,0,0,3,0,4,1,2,4,4,1,0,4,4,1,Science,Masters,25-30,9,0,0,Remote,Tier1_City,5,2,5,4,0,5,3,46.32,Tech,5,4,4,4,1,2,2,1,1,4,1,0,4,4,58.65
Medicine,Dentist,4.23136120622695,5,1,3,1,8,1,0,1,3,4,4,0,3,0,Science,Masters,18-24,4,0,0,Office,Tier1_City,3,2,4,3,5,0,2,46.71,Finance,1,3,5,4,5,4,4,1,1,2,1,0,1,2,52.05
Finance,Psychologist,3.011342173289327,9,2,3,1,8,1,1,3,1,0,3,2,0,1,Commerce,Masters,31-35,1,1,31,Office,Tier1_City,2,1,0,1,5,1,3,23.79,Tech,5,1,2,3,0,5,3,3,3,1,1,0,5,4,43.18
Medicine,Human Resources Specialist,4.957504997975692,5,0,4,0,6,0,1,1,2,0,2,2,2,0,Science,Masters,31-35,6,0,0,Flexible,Tier2_City,1,5,2,2,5,2,2,5.24,Tech,5,2,4,2,5,0,1,1,4,4,0,1,3,4,56.37
Psychology,Cybersecurity Analyst,3.735643745264919,7,1,2,1,5,0,3,4,2,0,0,2,4,1,Arts,Bachelors,18-24,6,0,0,Flexible,Tier2_City,5,5,1,5,0,3,4,17.41,Other,2,3,4,4,1,0,2,4,5,3,0,0,2,5,55.04
Education,Art Director,4.615884676295197,4,2,4,0,8,0,0,3,0,3,4,3,4,1,Arts,Bachelors,36-40,7,1,24,Hybrid,Tier3_City,1,1,0,5,4,5,1,14.61,Healthcare,3,1,1,3,3,2,5,1,1,3,1,1,5,1,50.12
Computer Science,Biologist,3.1339020048592032,2,1,3,0,2,0,0,2,3,0,3,4,0,1,Science,Masters,18-24,6,0,0,Office,Tier1_City,3,4,0,3,3,3,3,22.49,Manufacturing,4,2,1,5,4,0,2,1,4,4,1,0,4,2,61.64
Business,School Counselor,3.818021391119799,9,1,4,1,0,1,1,2,0,4,2,0,0,0,Commerce,Masters,31-35,9,0,0,Remote,Tier3_City,5,3,5,5,4,3,4,17.94,Education,3,3,3,5,4,2,4,5,4,4,0,0,1,4,59.65
Biology,Biologist,2.643797107036135,5,0,3,1,3,1,2,1,1,0,2,1,0,1,Science,Masters,40+,6,0,0,Hybrid,Tier1_City,5,5,3,5,5,2,1,41.96,Healthcare,3,2,5,4,1,5,4,1,3,4,0,1,3,3,54.68
Computer Science,Entrepreneur,3.601971535905164,8,1,2,1,7,0,3,1,4,3,2,0,4,1,Science,Bachelors,36-40,13,0,0,Hybrid,Tier1_City,1,2,4,1,3,4,1,3.14,Manufacturing,2,5,5,5,3,0,4,5,5,4,0,1,4,1,67.4
Law,Social Media Manager,4.02677241642891,9,1,3,0,1,0,3,4,1,2,0,0,0,1,Arts,Bachelors,40+,12,0,0,Flexible,Tier2_City,2,5,5,4,0,0,5,33.3,Finance,3,2,4,2,1,5,1,2,5,4,1,1,2,1,57.33
Computer Science,Data Scientist,3.3933315020861383,9,1,2,1,0,0,2,2,1,0,3,4,4,0,Science,Masters,25-30,8,1,53,Flexible,Tier3_City,2,4,3,3,5,3,5,34.22,Other,4,2,4,5,5,1,1,5,2,2,0,0,4,4,57.57
Computer Science,Special Education Teacher,2.9742372752496125,2,1,3,0,5,0,2,4,2,2,4,0,1,1,Science,Masters,18-24,7,0,0,Office,Tier1_City,2,1,0,1,0,1,5,34.05,Other,1,1,4,1,2,3,4,2,5,4,0,1,1,1,59.24
Engineering,Cybersecurity Analyst,2.7211839782494067,5,0,3,1,5,0,0,1,2,4,3,4,2,0,Science,PhD,18-24,14,0,0,Remote,Any,3,4,2,4,3,0,3,27.47,Healthcare,5,1,2,5,3,0,3,3,3,3,0,1,1,1,68.42
Physics,Architectural Technologist,3.6757382950287902,8,1,4,1,0,1,4,2,0,4,2,3,2,1,Science,Masters,25-30,1,0,0,Hybrid,Tier3_City,1,3,1,1,0,1,3,31.72,Manufacturing,4,4,3,4,3,1,5,4,4,3,1,0,1,4,53.92
Business,Organic Chemist,3.435918628629513,5,2,4,0,7,1,3,3,1,2,0,0,2,0,Commerce,Masters,31-35,1,1,41,Office,Tier1_City,3,5,3,1,0,0,1,41.09,Other,2,1,3,3,0,3,1,3,1,2,1,0,1,5,32.76
Architecture,Clinical Psychologist,4.545594163811545,7,2,2,0,8,1,1,0,4,3,2,2,1,0,Interdisciplinary,Masters,18-24,6,1,44,Remote,Tier3_City,3,2,5,5,1,0,3,39.86,Healthcare,1,5,1,2,2,4,3,3,4,4,0,1,4,3,55.22
Computer Science,Doctor,3.5489683933127942,7,0,0,1,0,1,2,0,2,0,0,1,1,0,Science,Masters,31-35,9,0,0,Remote,Tier2_City,2,2,0,4,4,5,1,4.63,Other,2,5,4,2,4,3,2,3,1,5,0,0,5,2,52.61
Business,School Psychologist,3.7651083684164974,9,2,2,1,7,0,0,2,1,0,0,3,1,1,Commerce,Masters,25-30,14,0,0,Flexible,Tier3_City,2,4,5,3,4,1,4,4.43,Tech,4,2,4,3,1,3,2,2,2,3,1,1,3,5,49.72
Architecture,School Psychologist,2.756091925797424,9,2,2,1,6,1,1,3,3,0,4,4,1,1,Interdisciplinary,Masters,25-30,10,0,0,Remote,Any,2,1,5,3,4,1,2,42.43,Tech,5,1,2,2,4,1,3,1,2,4,0,1,3,2,65.33
Physics,Composer,2.959434836114618,2,0,2,0,3,1,4,2,2,4,2,1,1,0,Science,Bachelors,31-35,12,0,0,Remote,Tier3_City,1,3,4,4,2,0,1,30.01,Healthcare,3,4,4,4,3,2,5,5,2,5,1,0,5,4,64.83
Physics,Cybersecurity Analyst,4.64300547176927,4,1,1,1,2,1,0,0,3,3,3,2,2,0,Science,Bachelors,25-30,14,0,0,Hybrid,Tier1_City,1,1,3,5,1,3,1,48.0,Healthcare,3,1,4,4,5,5,2,3,4,5,1,1,2,2,61.29
Psychology,Game Developer,4.8359961709461405,0,0,4,1,5,1,1,4,1,1,1,2,4,0,Arts,Masters,36-40,9,0,0,Flexible,Tier3_City,2,5,0,2,5,1,4,23.28,Education,2,4,3,3,1,1,3,3,3,1,0,0,2,5,56.43
Psychology,Cybersecurity Analyst,4.418790603374904,8,1,1,1,5,0,0,1,2,1,1,4,2,0,Arts,Bachelors,18-24,2,1,32,Office,Tier2_City,3,4,4,1,5,2,5,11.31,Finance,1,2,4,4,4,3,3,1,5,5,1,0,2,3,52.47
Business,Civil Engineer,2.8402504160958566,7,1,0,0,5,0,4,1,3,0,1,0,0,0,Commerce,Bachelors,31-35,0,0,0,Flexible,Tier2_City,1,4,4,5,5,2,5,25.24,Tech,5,5,2,1,1,3,4,3,1,5,1,0,5,5,41.37
Computer Science,Construction Manager,4.8929507851705525,0,0,3,1,9,1,2,3,4,2,1,4,1,0,Science,Bachelors,18-24,8,0,0,Office,Tier1_City,5,2,1,4,4,0,5,23.52,Other,2,1,2,4,4,1,3,2,3,3,1,0,4,1,63.67
Finance,Interior Designer,3.3656035079481974,8,0,0,0,3,0,1,0,1,2,1,1,4,0,Commerce,Bachelors,18-24,13,0,0,Hybrid,Any,3,5,2,1,4,4,1,27.31,Healthcare,5,1,5,2,1,0,5,2,5,5,1,1,3,1,54.71
Computer Science,Geneticist,4.582500382696386,9,1,2,0,4,0,0,1,0,0,3,4,3,1,Science,Bachelors,31-35,14,0,0,Flexible,Tier2_City,3,2,1,3,1,0,1,40.97,Manufacturing,2,5,5,3,4,3,4,1,1,5,1,1,4,5,52.6
Law,Paralegal,3.3261920544437107,6,1,2,0,5,1,1,0,1,0,4,4,2,0,Arts,Bachelors,36-40,13,0,0,Hybrid,Tier2_City,4,1,4,2,0,0,3,33.81,Other,1,5,1,1,4,5,5,2,4,3,1,0,3,1,49.93
Finance,School Psychologist,3.791607664583567,3,2,1,1,9,0,2,1,1,0,1,1,2,0,Commerce,PhD,25-30,13,1,47,Hybrid,Tier2_City,1,4,3,3,4,3,3,11.71,Finance,4,3,2,4,1,3,5,3,1,1,1,0,3,5,53.86
Psychology,Actuary,3.2853207202988344,2,0,0,1,3,1,0,2,4,0,0,3,3,0,Arts,Bachelors,25-30,2,0,0,Hybrid,Tier3_City,5,4,5,4,5,3,2,37.52,Manufacturing,3,3,2,1,0,5,4,3,4,1,0,0,2,5,42.34
Business,Entrepreneur,3.953568069049765,6,0,1,1,8,1,1,0,1,0,4,3,1,0,Commerce,Bachelors,25-30,0,1,16,Office,Tier1_City,1,3,2,1,0,5,2,30.82,Other,5,3,3,5,1,4,4,4,5,4,0,0,1,3,42.82
Medicine,Conductor,4.944139682046677,5,1,4,0,4,0,4,1,0,1,1,2,3,1,Science,Bachelors,18-24,5,0,0,Flexible,Tier3_City,3,1,4,4,4,4,3,30.18,Finance,5,5,5,5,5,2,2,4,3,4,1,1,2,3,52.2
Music,Organic Chemist,2.6517755150041715,4,1,3,0,6,0,0,2,1,4,2,1,2,1,Arts,Masters,36-40,3,0,0,Hybrid,Tier1_City,1,5,2,1,3,4,1,34.88,Manufacturing,1,3,1,1,4,5,2,1,1,5,0,1,1,3,42.82
Music,Forensic Psychologist,2.77579578292451,9,2,1,1,3,0,3,2,3,0,3,1,0,1,Arts,Bachelors,31-35,13,0,0,Hybrid,Tier3_City,3,3,3,5,2,4,4,29.51,Tech,5,1,3,5,2,1,4,3,5,5,0,1,3,1,69.33
Engineering,Data Scientist,3.881602952793253,8,0,2,0,8,0,3,4,2,3,2,4,4,1,Science,Masters,18-24,0,0,0,Flexible,Tier2_City,5,4,0,2,4,4,3,24.5,Healthcare,4,5,3,5,3,3,5,3,2,4,0,1,4,1,55.79
Engineering,Conductor,3.795520256499489,9,2,1,0,5,0,4,1,0,2,4,0,1,1,Science,Masters,25-30,3,0,0,Remote,Tier2_City,3,5,0,5,3,4,1,33.1,Other,4,1,5,5,0,0,1,5,3,4,1,0,1,2,57.48
Biology,Ecologist,4.565405395280739,1,0,3,1,4,1,1,1,3,2,2,2,2,0,Science,Masters,31-35,7,0,0,Office,Tier2_City,2,2,4,5,1,0,3,37.02,Healthcare,1,5,3,3,5,0,3,2,2,5,0,1,4,5,56.93
Law,Aerospace Engineer,2.8452109336891778,5,2,1,1,8,1,3,2,3,1,1,2,4,0,Arts,Bachelors,25-30,10,0,0,Hybrid,Tier1_City,3,1,4,4,3,0,5,13.61,Education,2,2,5,3,1,4,4,1,2,3,0,0,4,5,58.01
Marketing,Legal Analyst,4.964147400489575,1,1,1,0,5,1,2,2,3,2,0,3,1,0,Commerce,Masters,31-35,6,1,16,Hybrid,Tier2_City,2,2,1,2,1,5,3,26.36,Other,2,1,2,5,3,0,3,1,3,3,0,1,4,3,58.01
Medicine,Financial Controller,4.819700482084534,4,0,4,0,7,0,2,4,1,0,0,4,1,0,Science,Bachelors,18-24,14,0,0,Hybrid,Any,5,4,4,1,4,2,5,24.53,Healthcare,5,5,2,2,5,1,2,2,1,3,1,1,3,1,53.65
Medicine,Graphic Designer,4.960934853788027,4,2,1,0,5,1,4,0,0,0,2,4,2,0,Science,PhD,31-35,11,0,0,Hybrid,Tier3_City,5,3,0,1,1,2,1,4.88,Other,5,4,5,5,0,0,3,5,5,4,1,1,4,3,68.8
Law,Music Teacher,3.416719667030195,2,1,2,0,1,1,3,1,2,2,2,1,1,1,Arts,Masters,18-24,0,0,0,Office,Tier1_City,3,2,0,3,3,5,5,42.22,Tech,1,5,4,5,2,4,2,4,3,1,0,1,4,1,41.94
Education,Market Research Analyst,3.5039770839930924,0,0,2,1,6,0,4,2,4,1,1,2,4,0,Arts,Bachelors,36-40,9,0,0,Flexible,Any,2,4,1,1,2,5,3,20.74,Finance,4,2,4,5,3,5,4,5,1,4,0,0,4,1,58.19
Engineering,Art Therapist,4.924274540175411,7,0,3,0,2,1,4,3,2,0,4,1,3,1,Science,Bachelors,25-30,11,0,0,Hybrid,Tier3_City,3,2,5,4,0,1,5,6.42,Finance,1,5,1,2,5,4,2,4,3,3,0,0,3,5,58.7
Business,Geneticist,3.480003027261402,9,1,3,1,1,1,4,1,1,2,1,3,3,1,Commerce,Bachelors,25-30,8,0,0,Office,Tier1_City,5,1,3,5,0,0,4,24.52,Healthcare,2,2,4,2,1,0,5,4,3,2,0,1,3,1,50.48
Art,Musician,4.275445000037751,7,1,2,0,2,1,0,2,3,2,0,3,1,0,Arts,Masters,36-40,5,0,0,Office,Tier2_City,2,2,2,5,2,4,5,10.59,Manufacturing,4,3,1,5,2,5,5,5,1,3,0,1,4,1,46.03
Biology,Actuary,3.1376062121022184,6,0,4,0,2,1,1,1,1,1,1,4,3,0,Science,Bachelors,18-24,1,0,0,Hybrid,Tier2_City,4,1,0,5,5,1,5,36.11,Healthcare,5,1,5,4,1,3,5,1,2,2,0,0,1,5,38.19
Business,Art Therapist,4.637307196473371,0,0,1,0,3,0,2,1,2,0,2,4,2,1,Commerce,Masters,25-30,2,1,8,Hybrid,Tier1_City,4,1,2,2,0,3,2,29.87,Other,2,2,5,1,5,0,3,3,4,3,1,0,1,2,44.64
Biology,Investment Banker,4.5549280146124485,9,0,2,1,1,1,2,4,4,2,1,2,2,1,Science,Bachelors,25-30,6,1,48,Office,Tier3_City,5,5,4,1,4,0,4,15.7,Finance,3,4,5,3,3,4,3,1,1,3,0,1,3,5,53.0
Architecture,Art Director,4.194658358622332,4,2,1,1,1,0,2,0,0,4,3,1,2,1,Interdisciplinary,Masters,25-30,2,0,0,Remote,Tier1_City,2,3,4,4,5,5,1,47.67,Other,2,1,1,1,1,3,1,3,4,2,0,1,1,1,45.82
Art,Geneticist,3.1762406920710275,4,2,0,0,0,1,1,0,1,3,0,3,3,0,Arts,Masters,36-40,12,0,0,Hybrid,Tier2_City,3,2,5,2,4,2,5,16.71,Education,4,5,3,3,5,4,3,1,4,3,0,1,4,1,56.03
Engineering,AI Researcher,2.8625944133858146,9,0,4,1,9,0,2,4,4,4,0,1,2,0,Science,Masters,31-35,2,1,19,Flexible,Tier3_City,5,4,3,3,3,0,4,29.08,Finance,4,5,1,1,2,5,1,5,3,2,1,1,2,1,49.42
Art,Credit Analyst,4.900308195924644,5,2,1,1,4,0,1,1,1,1,3,3,2,0,Arts,Masters,18-24,4,0,0,Hybrid,Any,5,5,5,4,3,5,1,40.67,Manufacturing,1,2,3,2,2,3,4,5,1,2,1,0,5,1,45.53
Chemistry,Financial Controller,2.944028778772922,5,1,0,0,1,1,2,4,3,1,1,2,3,0,Science,Bachelors,31-35,2,0,0,Hybrid,Tier1_City,1,3,2,4,5,0,4,27.15,Manufacturing,4,4,2,5,3,0,4,5,1,4,0,1,4,1,46.89
Medicine,Paralegal,4.800440833258223,0,2,3,1,9,0,1,3,0,0,0,4,3,0,Science,Bachelors,25-30,2,1,28,Remote,Tier1_City,3,5,0,4,5,0,2,48.16,Education,3,2,2,3,3,5,4,3,2,1,0,0,5,5,36.93
Medicine,Manager,2.928617991177311,4,2,1,1,3,1,1,4,2,2,1,2,3,0,Science,Masters,36-40,10,0,0,Remote,Tier2_City,3,2,1,5,5,0,1,42.66,Other,3,4,3,5,4,2,4,1,4,4,0,1,2,2,70.33
Music,Human Resources Specialist,4.186587509570937,3,2,4,1,4,0,3,1,0,3,1,1,1,0,Arts,Bachelors,25-30,4,1,54,Hybrid,Tier3_City,4,2,0,4,5,3,1,46.29,Other,4,2,3,5,2,1,3,4,2,1,1,1,4,5,41.39
Business,Brand Manager,4.437783308624174,5,0,0,1,0,1,4,1,1,3,4,3,4,1,Commerce,Bachelors,25-30,13,0,0,Remote,Any,1,2,2,1,1,2,5,20.52,Other,5,3,4,2,5,3,5,1,5,1,0,0,5,5,59.08
Computer Science,Inorganic Chemist,2.8366412041302924,4,1,4,1,6,0,4,4,2,4,4,2,1,0,Science,High School,25-30,4,0,0,Remote,Tier1_City,3,3,2,4,5,0,3,28.77,Manufacturing,4,3,3,3,4,5,5,1,4,3,1,0,4,3,63.51
Biology,Data Scientist,3.982451258398145,4,1,2,0,9,1,0,4,2,0,4,0,4,0,Science,Bachelors,25-30,11,0,0,Hybrid,Tier2_City,3,5,0,5,5,5,1,42.49,Healthcare,5,3,3,4,1,4,2,2,2,2,1,0,5,1,53.78
Art,Industrial-Organizational Psychologist,2.694522058437242,0,0,2,0,6,1,3,3,3,3,4,1,4,0,Arts,High School,25-30,8,1,12,Hybrid,Tier1_City,4,4,0,4,3,3,1,45.46,Healthcare,4,2,5,2,3,4,4,1,2,1,1,0,2,1,51.77
Art,Nuclear Physicist,3.740088544461758,4,1,1,0,0,1,0,4,0,2,2,2,3,0,Arts,Masters,18-24,0,0,0,Remote,Tier3_City,1,5,3,3,4,1,2,47.39,Finance,2,1,1,5,5,2,5,4,4,1,1,1,1,4,42.5
Medicine,Pharmacist,4.788288560929797,9,0,1,0,0,0,0,0,0,0,4,4,0,0,Science,Bachelors,31-35,13,0,0,Remote,Tier1_City,1,3,4,3,3,0,2,44.32,Tech,4,5,3,3,0,4,1,1,2,1,1,0,5,1,48.25
Engineering,Music Teacher,2.9151782304432703,3,0,0,1,4,1,4,1,4,4,4,0,0,1,Science,Masters,25-30,0,1,13,Remote,Any,2,1,5,5,0,3,2,37.35,Healthcare,2,1,5,2,5,4,4,2,5,2,1,1,3,2,51.86
Business,Lawyer,2.742394695437352,3,2,2,0,3,1,0,1,3,2,3,0,0,1,Commerce,High School,40+,10,1,46,Remote,Tier1_City,5,1,3,1,1,4,5,4.14,Healthcare,5,5,3,2,1,4,1,2,1,5,1,1,5,5,49.06
Education,Illustrator,3.248164508839655,6,1,3,0,7,1,0,1,4,2,4,4,2,0,Arts,Masters,25-30,13,1,34,Remote,Tier3_City,2,1,0,1,1,1,1,17.8,Other,4,4,4,4,4,3,3,4,5,1,1,1,1,2,63.81
Education,Game Developer,3.3023073045285702,8,0,2,0,8,0,0,2,0,2,4,2,4,1,Arts,Bachelors,31-35,8,0,0,Hybrid,Tier1_City,1,4,0,2,4,2,2,9.06,Other,5,3,3,1,2,3,4,1,4,2,0,0,1,4,49.71
Finance,Social Media Manager,3.774472713695792,0,0,0,0,8,1,1,4,2,1,2,0,3,1,Commerce,Masters,36-40,4,1,12,Hybrid,Tier2_City,4,3,1,5,5,0,2,10.27,Education,3,3,3,3,3,5,4,5,3,2,0,1,5,1,52.38
Biology,Composer,4.388854005339606,8,2,4,0,1,0,4,3,0,3,0,3,0,0,Science,Masters,31-35,3,0,0,Hybrid,Tier2_City,2,3,4,4,3,0,4,16.67,Healthcare,1,5,5,3,3,1,5,5,4,5,0,1,2,4,58.37
Art,Art Director,4.760313762782069,5,1,3,1,9,1,4,0,4,0,2,0,4,1,Arts,Bachelors,36-40,1,0,0,Office,Tier1_City,4,1,5,5,0,3,4,6.51,Finance,5,3,3,3,5,2,3,2,1,4,0,1,3,3,39.82
Engineering,Architectural Technologist,3.6255753825850574,0,2,3,0,7,0,0,4,2,3,1,0,3,1,Science,PhD,36-40,11,1,16,Hybrid,Tier1_City,1,3,5,2,3,2,2,14.42,Other,2,1,5,3,1,0,2,4,5,1,0,0,2,3,62.51
Medicine,Landscape Architect,4.476284045163046,3,0,0,0,6,0,1,0,4,3,0,4,3,0,Science,PhD,25-30,8,0,0,Remote,Tier1_City,4,3,1,5,5,4,5,47.98,Education,1,2,1,1,5,5,1,5,2,5,1,1,1,4,62.15
Education,Advertising Manager,4.3214287056321945,8,2,2,1,1,1,0,0,1,1,4,4,3,0,Arts,Masters,31-35,5,0,0,Remote,Tier1_City,2,2,4,5,5,1,3,17.66,Healthcare,4,3,5,2,1,2,4,2,2,5,1,1,2,4,55.33
Psychology,Mechanical Engineer,4.113288527025015,9,2,3,1,4,0,3,4,3,2,2,2,0,1,Arts,Masters,18-24,14,0,0,Flexible,Tier1_City,1,4,4,2,2,5,4,10.51,Finance,2,3,1,2,3,1,1,2,3,4,1,0,4,1,67.82
Engineering,Lawyer,4.278460801020241,8,1,1,1,5,1,0,3,2,3,3,4,3,0,Science,Bachelors,25-30,8,1,27,Flexible,Tier2_City,1,3,2,1,3,2,4,36.76,Education,1,4,3,1,4,3,4,1,5,1,0,0,2,2,58.3
Medicine,Zoologist,4.2437314651661655,0,2,3,1,2,1,4,4,1,2,2,4,0,0,Science,Masters,18-24,4,0,0,Remote,Tier3_City,2,1,4,4,4,0,1,41.94,Tech,1,2,1,2,2,3,4,4,2,5,1,1,5,1,64.35
Medicine,Graphic Designer,4.928321889353378,8,1,0,1,6,1,1,4,2,4,4,3,2,0,Science,Bachelors,31-35,3,0,0,Remote,Tier3_City,5,5,5,2,3,3,1,17.76,Other,5,5,2,1,3,2,2,5,4,5,0,1,4,4,60.16
Business,Actuary,4.545423325375428,9,0,2,0,9,0,2,1,0,3,4,1,3,1,Commerce,Bachelors,25-30,6,0,0,Hybrid,Tier1_City,2,5,0,3,1,4,2,16.09,Finance,4,2,2,1,3,0,5,1,2,4,1,0,5,5,45.76
Law,Brand Manager,3.0602832556126778,6,0,4,0,3,0,3,2,4,4,4,0,2,1,Arts,PhD,25-30,4,0,0,Hybrid,Tier1_City,2,4,4,1,0,3,1,14.36,Healthcare,4,2,5,2,1,3,1,3,1,5,0,0,1,4,62.98
Psychology,Interior Designer,4.662687549815487,7,1,1,0,7,1,2,1,0,1,3,0,0,1,Arts,Bachelors,25-30,7,1,13,Hybrid,Tier3_City,3,3,3,3,4,1,1,21.48,Education,4,5,4,2,2,5,1,4,5,3,1,1,2,3,52.9
Art,Risk Analyst,2.9591148297173304,6,2,4,1,2,0,3,3,0,2,2,1,2,0,Arts,Masters,40+,7,0,0,Hybrid,Tier2_City,1,2,2,1,2,2,3,7.1,Tech,5,2,3,1,3,5,3,2,2,1,1,0,2,3,48.72
Medicine,Teacher,3.9002038480550594,6,1,2,0,5,0,0,2,3,0,2,1,1,0,Science,Masters,18-24,12,0,0,Remote,Tier1_City,3,3,1,4,0,3,5,34.45,Finance,5,4,2,4,1,3,3,1,2,1,1,1,4,5,47.48
Computer Science,Zoologist,4.919110474725067,7,2,1,1,3,1,4,0,0,4,1,1,2,1,Science,Masters,18-24,1,1,7,Remote,Tier1_City,3,1,5,4,0,5,2,41.64,Tech,4,1,4,5,0,2,5,5,1,4,0,1,4,1,41.81
Computer Science,Architect,4.212281897772944,0,1,2,0,3,0,2,3,1,4,0,3,2,0,Science,PhD,18-24,12,0,0,Hybrid,Tier1_City,3,3,4,5,1,5,3,34.19,Finance,1,2,5,3,3,2,5,2,2,5,1,1,3,3,67.12
Architecture,Pharmacist,2.6009720251182187,0,0,2,1,8,0,3,0,3,1,1,4,3,1,Interdisciplinary,Bachelors,40+,14,0,0,Flexible,Tier1_City,4,5,1,3,1,3,2,22.8,Healthcare,4,1,1,1,0,0,3,2,3,3,1,0,2,3,53.95
Art,Inorganic Chemist,2.7339045152557206,7,2,1,0,5,1,3,2,1,0,3,2,0,0,Arts,High School,40+,4,0,0,Remote,Tier3_City,2,5,0,1,1,0,5,16.58,Finance,5,4,3,2,2,0,3,5,5,3,1,1,3,2,45.36
Biology,Entrepreneur,2.5503276575536726,3,2,3,0,1,1,2,2,3,4,2,0,4,0,Science,Bachelors,31-35,9,1,56,Office,Tier1_City,3,4,1,4,4,3,2,22.24,Healthcare,4,4,1,1,2,2,3,3,2,3,0,0,2,5,52.22
Marketing,Pharmacist,3.4726660843820385,7,2,0,0,7,1,3,2,1,2,2,0,3,0,Commerce,Bachelors,36-40,7,0,0,Hybrid,Any,4,1,4,2,3,4,1,22.92,Finance,5,2,3,2,3,0,5,4,4,5,0,1,5,3,58.34
Chemistry,Clinical Psychologist,2.746354923048408,1,0,1,0,1,0,2,0,3,2,0,0,4,1,Science,High School,18-24,2,0,0,Remote,Any,4,4,1,4,0,2,5,34.3,Education,4,3,2,1,5,1,3,4,2,2,0,1,1,3,26.44
Psychology,Chemist,3.105208002216493,3,2,3,0,8,1,2,0,3,2,0,4,4,1,Arts,Bachelors,40+,6,0,0,Flexible,Tier3_City,1,3,0,2,3,1,3,46.62,Finance,1,2,4,2,4,5,2,2,3,4,0,0,4,3,53.75
Business,Legal Analyst,2.896404949712277,5,1,1,1,8,1,2,3,2,3,3,1,2,1,Commerce,Masters,18-24,2,0,0,Hybrid,Tier1_City,2,2,4,1,3,5,3,6.32,Finance,1,1,5,4,1,2,5,1,4,2,1,0,4,1,56.49
Art,Biomedical Engineer,4.130037766146927,8,0,3,0,9,0,3,2,4,1,0,0,4,1,Arts,Masters,18-24,14,1,59,Hybrid,Tier1_City,5,4,1,4,1,3,4,47.81,Manufacturing,5,4,3,5,1,4,3,3,3,4,0,0,1,5,59.62
Psychology,Dentist,3.691790921130237,0,1,0,1,8,1,0,2,0,4,4,0,3,1,Arts,Bachelors,18-24,5,1,48,Hybrid,Tier2_City,2,5,1,4,3,4,3,45.78,Manufacturing,5,1,2,2,4,0,5,3,1,1,1,0,3,2,35.68
Psychology,Chemical Engineer,4.338918908886584,8,0,3,1,9,1,3,3,1,1,3,1,2,1,Arts,Masters,25-30,1,0,0,Remote,Tier1_City,4,1,0,1,0,5,4,8.53,Finance,2,1,5,4,0,2,2,2,4,1,1,0,2,3,45.68
Architecture,Psychologist,4.560838065612171,1,2,2,1,3,1,2,4,4,4,0,4,1,1,Interdisciplinary,Bachelors,31-35,5,0,0,Hybrid,Any,2,3,3,4,0,5,1,11.63,Manufacturing,3,5,3,5,5,4,1,1,4,5,1,0,4,2,61.53
Chemistry,School Psychologist,3.8680506191208153,4,2,4,1,6,0,2,2,0,0,4,2,1,0,Science,High School,25-30,5,1,36,Hybrid,Tier1_City,1,1,3,2,5,1,3,17.64,Healthcare,2,4,2,2,5,1,3,5,3,4,0,1,2,2,46.89
Business,Electrical Engineer,4.234144098790835,8,0,2,0,0,1,0,1,1,4,3,0,2,1,Commerce,Masters,40+,7,0,0,Remote,Tier3_City,2,1,2,4,2,5,5,29.3,Manufacturing,5,4,5,3,2,1,2,5,3,2,0,0,2,2,46.71
Medicine,Inorganic Chemist,4.167739532564342,8,0,3,0,8,0,3,2,3,4,0,2,4,0,Science,Masters,25-30,4,0,0,Hybrid,Tier2_City,4,1,0,3,4,4,4,9.32,Finance,5,1,1,1,3,3,4,2,1,1,1,1,3,5,45.82
Education,Artist,4.625602674085367,4,1,0,0,3,1,4,0,2,4,0,4,4,1,Arts,Masters,18-24,13,1,33,Remote,Tier3_City,4,5,3,5,3,5,3,12.42,Other,4,4,4,1,1,5,5,1,4,5,1,1,3,5,71.08
Architecture,Animator,4.015217759407335,5,0,0,1,8,1,3,0,4,4,3,0,1,1,Interdisciplinary,High School,25-30,0,0,0,Remote,Tier2_City,3,2,1,2,4,5,1,45.43,Tech,2,2,4,1,1,5,1,3,4,1,0,1,2,5,38.0
Art,Music Teacher,3.940716807641554,5,0,2,0,0,1,4,4,1,3,0,1,0,0,Arts,Masters,31-35,14,0,0,Office,Tier2_City,4,4,0,3,4,3,5,8.14,Other,3,5,1,2,3,4,4,3,4,2,1,1,2,4,63.71
Music,Biochemist,3.2032605294153043,0,2,2,1,0,0,1,3,1,0,3,2,0,0,Arts,Masters,36-40,7,0,0,Remote,Any,1,5,1,1,4,3,5,21.75,Other,2,2,4,3,3,4,3,3,4,4,1,0,1,2,59.53
Chemistry,Biomedical Engineer,3.754444409277538,4,1,4,0,7,0,1,2,2,1,1,4,1,0,Science,Masters,25-30,11,1,28,Hybrid,Tier1_City,4,2,1,2,5,2,1,38.86,Other,1,3,4,3,1,5,4,4,1,3,1,0,5,4,59.76
Computer Science,Biochemist,2.9412836043480315,8,0,4,1,5,1,3,1,4,4,0,4,4,0,Science,Masters,25-30,8,0,0,Flexible,Tier1_City,2,3,2,5,4,0,3,44.76,Other,1,3,3,3,1,4,3,3,2,1,1,0,3,1,60.08
Business,Fluid Mechanics Engineer,3.8201021148547007,7,0,3,1,0,1,0,0,0,2,4,2,3,0,Commerce,Masters,25-30,0,1,58,Remote,Tier1_City,5,4,5,5,5,4,2,18.79,Tech,2,1,2,5,1,1,2,5,4,4,0,1,2,2,45.92
Finance,Zoologist,2.947950908789857,3,2,0,0,3,1,4,3,4,2,3,1,4,1,Commerce,Masters,31-35,4,1,50,Hybrid,Tier2_City,4,2,2,1,0,0,3,10.73,Finance,2,3,1,2,3,3,2,1,5,1,1,0,4,3,58.12
Finance,Accountant,3.923356277782548,8,1,3,1,1,1,1,1,2,0,1,0,2,0,Commerce,Masters,40+,11,1,49,Hybrid,Tier1_City,1,3,4,1,3,0,4,37.64,Finance,5,2,2,4,5,1,1,3,1,4,1,0,2,2,53.07
Chemistry,Physicist,3.84173206664275,2,2,3,1,0,1,0,3,1,2,2,0,2,1,Science,PhD,18-24,5,1,13,Hybrid,Tier1_City,1,4,5,2,5,5,4,39.31,Tech,4,3,4,5,0,5,4,2,2,2,0,0,4,5,53.14
Medicine,Architectural Technologist,4.536594196079992,7,1,2,0,1,0,4,0,2,3,3,0,2,0,Science,Masters,36-40,3,0,0,Hybrid,Tier1_City,1,3,0,4,2,1,3,49.06,Education,1,1,2,2,1,2,5,2,3,3,1,1,3,2,51.89
Architecture,Architectural Technologist,3.669387149443444,8,1,2,1,9,0,0,3,1,0,2,0,1,0,Interdisciplinary,Bachelors,25-30,13,1,12,Hybrid,Tier3_City,1,5,3,1,4,1,4,9.56,Manufacturing,3,4,5,3,0,4,2,5,2,1,1,1,4,1,46.54
Medicine,Biochemist,3.1702109786152075,8,2,0,0,7,1,3,1,3,2,1,1,0,0,Science,Masters,25-30,10,0,0,Remote,Tier2_City,2,3,2,4,2,5,2,36.34,Education,4,5,1,2,1,4,2,3,3,5,0,1,5,5,63.56
Chemistry,Market Research Analyst,3.1052858585175462,3,2,4,0,4,1,1,0,3,0,3,1,2,1,Science,Bachelors,40+,1,1,12,Remote,Tier3_City,3,1,0,3,0,4,2,22.61,Healthcare,2,1,1,3,3,3,3,5,5,5,0,0,5,5,45.93
Art,Marketing Manager,4.747431822226337,5,2,1,1,6,0,4,4,4,2,3,4,3,1,Arts,Bachelors,25-30,4,0,0,Office,Tier1_City,5,5,2,5,0,0,5,45.99,Other,1,1,1,4,4,3,1,5,1,1,0,1,1,5,52.55
Chemistry,Risk Analyst,4.037707190796702,9,2,4,1,6,0,0,1,4,0,2,0,3,0,Science,Masters,25-30,13,0,0,Remote,Tier3_City,3,3,3,4,1,2,4,22.17,Other,2,1,3,3,0,4,1,5,2,4,0,1,2,3,56.17
Computer Science,AI Researcher,4.01722538469053,6,2,1,1,4,0,4,4,1,3,4,0,1,0,Science,PhD,18-24,13,0,0,Office,Tier2_City,3,5,2,5,4,0,3,23.96,Tech,1,2,2,5,4,1,3,4,3,4,1,1,5,1,77.79
Medicine,Education Administrator,3.3827125408958034,4,1,2,0,3,1,4,4,3,3,1,3,4,0,Science,PhD,18-24,3,1,9,Office,Tier2_City,3,4,4,4,1,1,5,8.96,Tech,3,4,2,2,1,5,5,3,4,1,1,1,4,4,57.03
Chemistry,Legal Secretary,3.238497836451452,8,1,1,1,4,1,3,4,4,0,0,1,4,1,Science,Bachelors,36-40,12,0,0,Remote,Tier1_City,2,1,0,3,2,0,2,18.08,Education,4,1,3,1,1,5,2,2,5,4,1,1,4,3,63.48
Biology,Clinical Psychologist,2.9557245466309783,1,1,1,0,9,1,1,4,3,0,2,0,4,0,Science,Bachelors,31-35,6,0,0,Remote,Tier1_City,5,1,5,1,3,3,5,21.84,Healthcare,3,4,1,3,5,3,1,4,5,1,0,1,3,4,48.52
Physics,Urban Planner,3.3315273076570544,7,1,0,0,8,1,2,2,2,1,4,3,3,0,Science,Bachelors,36-40,5,1,26,Remote,Any,4,3,5,3,1,3,1,3.82,Education,3,1,3,3,3,4,3,5,1,2,0,1,2,5,48.0
Medicine,Industrial-Organizational Psychologist,3.747885621067608,5,1,2,0,7,1,2,1,0,3,2,0,1,0,Science,PhD,18-24,2,0,0,Hybrid,Tier3_City,4,4,0,1,0,2,4,23.57,Healthcare,4,2,3,1,4,2,4,2,1,3,1,1,1,5,36.69
Computer Science,Accountant,2.874012449000902,3,1,0,0,2,1,2,2,4,0,4,1,0,1,Science,PhD,18-24,8,0,0,Office,Tier1_City,5,5,1,1,4,4,3,18.81,Finance,4,1,4,5,4,3,1,5,1,4,1,1,2,4,64.56
Medicine,Civil Engineer,4.549289871059253,1,1,0,0,9,0,0,2,1,1,0,4,4,0,Science,Masters,18-24,13,0,0,Remote,Any,5,3,5,5,2,0,2,40.78,Other,3,3,1,4,1,0,2,4,1,3,0,0,1,2,50.82
Music,Industrial-Organizational Psychologist,4.328351044134594,9,1,2,0,3,0,0,2,3,0,2,2,1,0,Arts,Masters,25-30,3,0,0,Remote,Tier1_City,1,2,5,3,5,3,5,8.03,Finance,2,2,5,4,2,2,2,1,4,2,0,0,3,1,49.29
Business,AI Researcher,3.03482874673944,0,0,2,0,0,0,4,3,4,2,3,3,2,1,Commerce,Masters,40+,14,0,0,Hybrid,Tier2_City,3,3,4,4,0,4,3,38.73,Tech,4,1,4,5,5,5,2,5,5,5,1,1,2,2,82.29
Chemistry,Cybersecurity Analyst,2.545788821466588,6,0,0,0,9,0,0,4,1,0,4,1,4,0,Science,Masters,31-35,10,1,21,Remote,Tier3_City,1,2,2,3,5,3,4,36.56,Finance,3,1,1,2,2,4,4,5,4,2,0,0,4,5,61.12
Psychology,Psychologist,4.6043143468133785,3,2,3,1,5,0,2,3,0,0,2,4,0,1,Arts,Bachelors,25-30,4,0,0,Hybrid,Tier1_City,2,1,1,5,3,4,3,14.36,Education,3,1,1,4,4,3,4,2,1,2,0,1,5,4,41.85
Medicine,Chemical Engineer,3.28315454924288,9,2,0,1,2,0,3,0,2,3,1,2,3,1,Science,Bachelors,36-40,13,0,0,Hybrid,Tier1_City,2,3,2,1,4,4,4,6.91,Healthcare,3,3,1,5,4,3,2,2,2,4,0,0,4,3,62.56
Education,Financial Analyst,3.2809105925397097,6,0,3,1,8,0,1,1,0,2,0,1,4,1,Arts,Masters,31-35,2,0,0,Hybrid,Tier2_City,5,3,4,5,3,3,4,42.57,Tech,2,3,2,3,0,1,3,5,3,5,1,0,1,5,45.56
Biology,Biotechnologist,3.330322128954696,6,1,2,1,0,1,3,2,1,3,0,0,1,1,Science,Masters,18-24,7,1,35,Hybrid,Tier2_City,2,1,1,2,3,5,4,14.72,Finance,5,1,1,1,1,5,3,3,2,3,1,1,5,5,46.98
Psychology,Mechanical Engineer,3.703263347162759,2,2,1,0,1,1,2,2,2,2,1,1,0,1,Arts,Bachelors,36-40,10,0,0,Hybrid,Tier1_City,5,5,3,2,4,1,5,9.84,Tech,5,3,1,2,2,4,2,2,5,5,1,1,4,3,61.52
Business,Illustrator,3.233237001952415,4,1,2,1,9,0,2,1,0,0,0,2,1,1,Commerce,PhD,25-30,6,0,0,Hybrid,Tier1_City,4,3,0,4,4,4,4,19.87,Tech,4,1,5,2,3,5,3,1,5,2,1,0,5,2,52.92
Finance,Paralegal,4.77392394552882,4,1,2,1,7,1,1,0,2,3,4,4,2,1,Commerce,Bachelors,18-24,10,0,0,Remote,Any,3,4,4,5,5,5,3,21.84,Healthcare,5,3,1,3,0,0,5,1,4,5,1,0,1,2,68.51
Psychology,Curriculum Developer,4.671731839616639,8,0,3,0,4,1,1,2,2,0,2,4,3,1,Arts,Bachelors,18-24,10,1,41,Hybrid,Tier1_City,2,1,4,4,3,0,1,18.33,Education,1,4,3,4,2,5,2,5,3,4,1,1,5,2,57.24
Law,Marketing Specialist,4.926534248288258,1,2,4,1,6,0,3,4,4,1,2,0,3,0,Arts,Masters,25-30,14,1,17,Hybrid,Tier1_City,1,5,2,4,2,5,3,48.89,Other,4,1,1,2,1,4,1,2,1,4,0,1,4,5,64.02
Chemistry,Interior Designer,4.720742950608579,2,2,2,0,9,1,1,3,1,0,4,1,0,1,Science,Masters,25-30,6,0,0,Remote,Tier3_City,2,1,3,2,5,3,5,44.4,Education,4,1,1,1,1,5,5,1,1,2,0,1,1,1,48.69
Finance,Aerospace Engineer,3.8002667665805534,8,1,2,1,7,1,3,0,1,0,4,4,0,0,Commerce,Masters,25-30,7,0,0,Remote,Tier1_City,3,1,3,4,4,5,4,44.03,Manufacturing,3,5,1,3,5,3,5,4,2,1,0,0,1,4,52.36
Music,Doctor,4.655248845501765,3,2,4,0,6,1,1,0,4,2,0,4,0,1,Arts,Bachelors,18-24,6,0,0,Remote,Tier1_City,2,5,5,2,0,1,1,21.74,Education,1,5,2,2,1,3,3,1,3,5,0,1,3,4,53.26
Architecture,Geneticist,2.9869496363586507,9,0,0,0,4,0,0,3,2,1,1,4,1,0,Interdisciplinary,Bachelors,31-35,2,0,0,Remote,Any,5,5,4,1,5,3,5,48.25,Finance,5,2,4,3,2,0,5,2,4,3,1,1,2,1,48.21
Music,Legal Analyst,3.350976958647116,7,1,4,1,1,0,1,2,4,2,1,3,2,1,Arts,Masters,40+,2,0,0,Hybrid,Any,2,5,4,5,1,2,2,35.15,Manufacturing,4,4,2,4,1,2,4,5,1,2,0,0,1,2,44.09
Business,Web Developer,4.2135845578156745,4,1,4,1,6,0,2,0,2,1,1,1,4,1,Commerce,Masters,31-35,1,0,0,Remote,Tier1_City,4,4,0,4,2,0,2,42.1,Manufacturing,1,4,5,5,5,4,3,1,5,1,1,1,5,4,42.72
Law,Legal Analyst,3.8238779590737018,3,0,3,0,0,1,3,4,3,1,0,3,1,0,Arts,Bachelors,25-30,12,0,0,Hybrid,Any,4,2,3,2,5,2,2,26.54,Manufacturing,2,2,5,3,3,4,3,5,1,5,0,1,4,2,61.56
Psychology,Curriculum Developer,2.912195520923702,0,1,0,0,3,1,3,4,3,3,4,2,4,0,Arts,Masters,18-24,0,1,34,Hybrid,Any,2,1,4,3,4,5,1,10.55,Manufacturing,2,5,3,4,5,4,4,4,3,1,1,0,2,5,54.09
Architecture,Accountant,4.238008769317456,5,1,0,1,8,0,0,3,1,2,2,1,0,0,Interdisciplinary,Bachelors,18-24,4,0,0,Hybrid,Tier2_City,1,3,0,4,4,4,3,44.68,Education,3,2,3,2,1,1,5,1,5,2,0,0,4,1,48.83
Engineering,Interior Designer,3.46981664762107,7,0,3,0,8,1,4,3,0,2,2,4,2,1,Science,Masters,18-24,11,0,0,Office,Tier2_City,2,2,2,1,2,5,1,25.86,Manufacturing,1,5,5,2,0,5,3,5,4,5,0,1,2,4,71.73
Chemistry,Teacher,4.231600190643786,6,2,3,0,8,0,2,3,4,0,2,3,2,1,Science,Masters,25-30,3,0,0,Hybrid,Tier1_City,5,3,3,1,1,4,1,48.52,Finance,4,1,4,4,5,0,3,1,1,1,1,1,2,5,44.28
Physics,Education Administrator,3.9385860142766607,4,0,1,1,5,0,1,0,1,3,2,4,4,0,Science,Bachelors,31-35,14,0,0,Remote,Tier1_City,5,3,1,3,5,2,1,14.98,Finance,2,2,4,2,3,2,1,1,5,1,1,0,3,1,59.48
Physics,Risk Analyst,4.333180038482094,5,0,1,1,1,1,4,3,4,1,3,4,1,0,Science,High School,31-35,12,0,0,Remote,Tier2_City,5,3,1,2,5,2,2,49.64,Tech,2,3,5,2,0,4,3,2,4,4,1,0,2,5,67.57
Law,Clinical Psychologist,3.33110598230481,0,1,4,0,0,0,4,2,3,3,4,1,4,0,Arts,Masters,31-35,10,0,0,Remote,Tier3_City,1,4,4,4,3,4,3,13.45,Finance,5,5,1,2,5,5,3,2,3,2,1,1,2,5,65.81
Business,Geneticist,3.944808369007342,1,0,3,1,4,0,2,2,2,2,1,2,3,0,Commerce,Masters,25-30,1,1,15,Hybrid,Tier2_City,4,4,4,2,0,1,1,20.3,Other,5,1,2,4,5,2,4,3,4,3,0,0,1,3,49.08
Medicine,Landscape Architect,3.435478231398781,7,1,2,0,6,0,3,4,1,3,4,4,1,1,Science,Masters,25-30,0,1,36,Remote,Tier1_City,5,2,5,1,4,0,3,30.92,Tech,1,3,2,4,0,2,3,2,4,2,0,0,2,2,55.7
Architecture,Counselor,3.071282324053768,1,0,4,0,7,1,2,2,4,0,0,1,2,1,Interdisciplinary,Masters,31-35,13,1,52,Hybrid,Tier1_City,5,5,0,2,5,3,4,35.59,Finance,5,3,1,3,4,2,3,2,5,2,1,0,2,4,64.56
Biology,Microbiologist,4.463865215008619,6,1,4,0,4,1,1,2,0,4,2,4,1,1,Science,Masters,25-30,13,0,0,Flexible,Tier2_City,2,4,4,1,5,2,1,36.85,Manufacturing,1,4,4,1,4,3,5,3,1,4,0,1,3,5,58.88
Education,Software Developer,3.849590484817713,0,0,2,0,5,1,3,0,0,2,3,3,3,1,Arts,PhD,18-24,2,1,46,Remote,Tier2_City,4,1,4,2,5,0,1,25.38,Healthcare,4,5,2,5,1,5,3,3,5,3,0,0,5,5,58.33
Music,Biologist,3.5475430913879658,0,0,2,0,0,0,3,0,4,0,1,3,3,0,Arts,Bachelors,25-30,12,0,0,Flexible,Tier1_City,5,2,0,3,1,3,1,6.61,Manufacturing,4,1,2,2,3,4,2,1,2,4,0,0,3,5,52.56
Finance,Marketing Manager,3.885430628118418,0,0,3,0,0,1,2,0,1,4,1,3,3,1,Commerce,Bachelors,25-30,5,0,0,Flexible,Tier2_City,5,1,1,5,0,5,4,26.31,Education,4,5,3,1,2,5,2,1,5,2,1,0,1,1,44.9
Architecture,Entrepreneur,4.831414042568211,7,2,0,0,3,1,0,0,3,0,0,3,0,0,Interdisciplinary,Bachelors,18-24,12,0,0,Office,Tier3_City,2,3,0,3,5,3,4,18.73,Tech,5,1,4,1,4,4,1,1,5,1,1,0,2,3,50.46
Medicine,Music Teacher,4.730999490057549,3,2,0,0,5,0,3,1,0,2,4,1,3,0,Science,Bachelors,36-40,1,0,0,Flexible,Tier1_City,2,1,5,3,2,2,2,33.91,Healthcare,5,5,5,4,3,4,2,2,1,1,0,1,4,4,36.54
Law,Human Resources Specialist,4.206554844329661,8,1,3,1,1,1,3,2,3,4,1,2,1,1,Arts,Masters,36-40,9,1,55,Remote,Tier1_City,3,4,5,5,4,1,5,11.57,Finance,3,3,5,4,4,0,2,5,3,2,0,1,5,2,63.33
Marketing,Physicist,3.157283277451977,1,0,1,1,8,0,1,3,0,2,3,3,2,1,Commerce,Bachelors,18-24,14,0,0,Remote,Tier1_City,2,1,3,5,3,1,3,21.51,Manufacturing,2,4,1,1,5,1,4,5,2,5,1,1,3,3,56.73
Law,Brand Manager,3.6608366177044926,2,2,1,1,6,0,1,2,2,4,3,1,4,0,Arts,PhD,18-24,12,0,0,Remote,Any,2,3,3,4,2,0,5,48.41,Tech,4,2,2,4,3,1,4,2,1,2,0,0,1,1,59.28
Chemistry,Conductor,2.9160054708447123,5,0,0,0,7,1,3,0,0,1,4,3,0,0,Science,Masters,31-35,6,0,0,Remote,Tier2_City,3,3,4,4,4,5,1,7.18,Tech,5,5,5,3,1,5,1,4,1,2,0,1,5,3,49.36
Business,Game Developer,4.070113486145296,0,0,2,1,4,0,2,2,3,0,4,3,3,0,Commerce,Masters,18-24,10,1,37,Hybrid,Tier2_City,5,4,4,3,1,0,1,31.31,Finance,2,3,1,3,0,1,4,1,4,5,0,1,1,1,67.66
Physics,Psychologist,2.83137673134444,1,1,0,0,5,1,3,1,2,3,1,2,1,1,Science,Bachelors,25-30,6,1,24,Office,Tier3_City,2,2,5,3,0,4,2,7.26,Tech,4,2,3,5,4,1,3,2,2,5,1,1,4,1,54.55
Biology,Music Teacher,3.139856552964965,5,1,2,1,4,0,3,0,0,0,1,3,2,1,Science,Bachelors,18-24,10,0,0,Remote,Tier1_City,1,5,1,1,0,1,5,10.38,Finance,4,2,4,5,0,3,1,4,4,4,1,0,5,3,53.25
Architecture,Music Therapist,2.9305331802783785,0,0,2,1,2,0,2,0,3,2,1,1,0,0,Interdisciplinary,High School,18-24,2,0,0,Remote,Tier1_City,3,2,1,1,4,0,1,31.43,Finance,2,2,2,5,5,0,3,1,4,1,0,0,1,4,38.63
Education,Brand Manager,3.2713588505135025,2,2,0,0,9,1,4,1,1,2,0,2,4,0,Arts,Bachelors,31-35,13,1,13,Office,Tier2_City,3,5,2,4,2,4,5,23.87,Manufacturing,2,3,2,2,0,0,5,3,1,5,0,0,3,1,53.83
Law,Judge,2.733373675882043,4,1,3,0,7,0,0,2,0,3,2,3,4,0,Arts,Bachelors,36-40,0,0,0,Remote,Tier2_City,5,4,3,4,3,5,2,28.78,Tech,5,1,1,3,2,3,4,2,3,2,0,0,5,2,35.41
Music,Biochemist,3.589083717676284,8,2,0,0,9,1,1,0,2,1,2,4,2,0,Arts,Masters,18-24,8,0,0,Hybrid,Tier1_City,2,4,3,1,1,3,5,44.35,Education,2,2,2,2,2,4,3,4,1,3,0,1,4,4,48.31
Medicine,Advertising Manager,4.066910099335127,4,2,1,0,1,0,2,0,0,4,2,2,3,1,Science,Masters,25-30,10,0,0,Remote,Tier1_City,1,4,5,1,4,0,3,41.41,Education,2,4,4,3,1,3,5,5,5,3,1,1,3,5,60.92
Finance,Zoologist,3.217560612828123,5,1,3,1,7,1,4,0,2,0,1,4,3,0,Commerce,Masters,18-24,4,0,0,Office,Tier2_City,5,3,2,2,1,4,2,44.74,Manufacturing,5,1,5,1,3,1,4,2,3,4,1,0,2,4,47.74
Marketing,Credit Analyst,3.4473781819118594,7,1,3,1,7,1,2,1,1,1,2,3,0,1,Commerce,Masters,18-24,1,0,0,Hybrid,Tier3_City,2,2,2,2,0,1,5,31.96,Manufacturing,4,3,1,2,1,5,4,5,2,3,0,0,2,5,39.47
Psychology,Aerospace Engineer,3.2967587407823755,3,0,2,0,7,0,0,3,1,3,4,2,2,1,Arts,Bachelors,40+,14,0,0,Hybrid,Tier1_City,5,5,3,1,5,3,1,26.01,Finance,2,2,4,5,3,0,1,4,3,1,0,0,5,4,61.82
Finance,Teacher,3.700192199230768,0,2,3,1,1,1,2,2,1,0,0,3,0,0,Commerce,Masters,31-35,7,0,0,Remote,Tier2_City,3,2,4,2,5,0,4,24.58,Education,3,3,2,3,5,5,2,2,2,2,0,1,1,4,49.35
Art,Chemical Engineer,3.632071167040824,0,1,4,1,4,1,1,3,2,1,1,2,4,0,Arts,Masters,25-30,11,1,47,Flexible,Any,3,5,3,5,3,1,4,37.77,Tech,1,3,5,5,2,3,2,2,4,3,0,0,2,3,62.16
Law,Chemical Engineer,3.23133873651111,2,1,3,0,5,1,3,4,1,1,0,1,3,0,Arts,Bachelors,31-35,9,0,0,Hybrid,Tier1_City,2,1,2,4,1,3,2,27.5,Education,2,2,4,4,1,1,3,2,1,1,0,0,2,4,42.56
Engineering,School Psychologist,3.384682800054799,3,1,1,1,0,1,1,3,3,3,2,3,0,0,Science,Masters,36-40,9,0,0,Office,Tier2_City,5,2,1,4,4,2,4,7.97,Manufacturing,2,3,5,3,3,1,1,2,1,3,1,1,3,4,60.2
Music,School Psychologist,3.039332602366477,5,1,1,1,4,0,2,0,2,4,2,1,0,1,Arts,Bachelors,36-40,3,0,0,Flexible,Tier2_City,2,1,0,1,3,1,3,9.67,Manufacturing,1,4,5,3,5,2,2,3,5,2,0,0,2,3,50.01
Physics,Manager,3.828119388305895,5,1,1,0,5,0,1,3,3,4,1,0,4,1,Science,Masters,18-24,10,0,0,Hybrid,Tier1_City,4,4,1,3,2,2,2,19.78,Finance,3,4,1,5,2,4,3,2,1,4,0,1,1,5,60.11
Finance,Financial Analyst,4.886099732348153,7,0,2,1,1,0,4,1,2,3,1,3,1,1,Commerce,PhD,18-24,9,0,0,Hybrid,Tier3_City,2,3,5,1,5,5,1,6.19,Tech,4,5,2,5,3,4,3,4,3,1,0,0,3,2,68.05
Chemistry,Game Developer,2.78290647457418,3,0,0,1,4,1,4,3,1,3,3,4,2,1,Science,High School,31-35,11,1,8,Remote,Any,4,3,1,2,4,0,1,14.24,Manufacturing,3,2,3,5,1,4,2,4,5,5,1,1,4,4,72.57
Chemistry,Organic Chemist,4.399442624842493,2,1,0,1,8,0,3,3,2,3,3,4,4,1,Science,Masters,25-30,6,0,0,Hybrid,Tier3_City,3,2,2,3,1,4,2,33.85,Other,1,2,3,3,4,5,5,3,1,5,1,0,2,5,60.27
Architecture,Special Education Teacher,2.546940745119336,2,0,4,0,1,0,2,2,1,3,2,2,1,1,Interdisciplinary,Masters,40+,13,0,0,Flexible,Tier1_City,1,1,3,2,3,0,4,3.58,Tech,2,2,3,1,4,0,3,2,5,3,0,1,1,5,63.52
Biology,Brand Manager,4.5065571229052495,5,0,3,1,0,0,4,1,3,1,1,2,0,0,Science,PhD,31-35,12,0,0,Remote,Tier3_City,3,1,5,5,4,1,4,31.39,Education,4,5,4,4,5,5,2,2,1,5,0,0,1,5,67.46
Education,Musician,2.950501097494526,1,0,1,1,8,1,1,0,1,3,2,1,3,1,Arts,Bachelors,40+,4,0,0,Flexible,Tier2_City,1,5,2,2,3,2,1,39.3,Finance,3,4,3,5,1,0,5,1,1,1,1,1,5,3,34.84
Physics,Doctor,3.9059118446234535,5,2,1,0,5,0,3,1,2,1,0,2,1,0,Science,Masters,18-24,12,1,17,Office,Tier1_City,5,2,2,5,3,2,3,11.0,Education,3,4,2,1,5,0,2,1,4,5,1,1,4,2,60.65
Law,Organic Chemist,3.214884804017492,1,1,3,1,5,1,1,2,3,4,0,2,1,1,Arts,Bachelors,36-40,2,0,0,Hybrid,Tier1_City,1,2,5,5,3,3,4,11.51,Other,4,2,3,5,0,0,3,5,1,1,0,1,4,2,38.65
Computer Science,Artist,3.808609023924454,0,2,2,0,8,1,4,1,4,1,0,1,2,1,Science,Bachelors,25-30,9,1,50,Hybrid,Any,5,1,5,2,1,0,3,4.36,Manufacturing,3,3,5,3,5,1,5,3,1,5,1,0,1,5,55.49
Finance,Acoustics Specialist,3.8407064744180417,9,1,2,1,6,1,2,3,4,0,3,0,0,0,Commerce,Bachelors,40+,7,1,48,Remote,Tier2_City,4,1,5,2,4,0,4,27.09,Manufacturing,1,1,5,1,4,4,3,1,3,4,0,0,4,2,55.28
Chemistry,Data Scientist,4.697052448793785,9,1,0,1,0,1,4,0,1,3,2,1,1,0,Science,PhD,18-24,1,0,0,Remote,Any,5,3,4,5,0,1,2,33.77,Tech,4,1,5,3,5,5,2,4,2,3,0,1,5,2,48.68
Music,Physician Assistant,2.815934684369972,4,0,0,0,1,0,4,2,3,4,3,2,3,1,Arts,Masters,25-30,0,0,0,Remote,Tier1_City,2,2,5,3,0,2,5,24.47,Manufacturing,1,2,3,2,4,5,1,4,3,1,0,1,5,4,48.73
Marketing,Mechanical Engineer,2.84208585675326,3,1,4,0,4,1,4,4,4,2,2,4,0,0,Commerce,Masters,31-35,4,0,0,Hybrid,Tier3_City,2,3,4,5,1,1,1,21.3,Other,4,2,2,5,4,0,1,4,5,4,1,0,4,3,72.69
Engineering,Astronomer,4.860089281705923,7,0,1,1,9,0,3,4,3,1,1,4,3,1,Science,PhD,25-30,10,1,26,Flexible,Tier1_City,2,4,0,4,1,1,2,24.36,Tech,1,4,2,4,0,4,2,3,5,3,0,1,5,4,72.11
Physics,Marketing Specialist,3.4895937906904395,7,0,2,0,0,1,4,1,0,2,1,0,0,0,Science,Bachelors,25-30,3,0,0,Hybrid,Tier1_City,3,4,4,5,5,5,4,39.73,Other,2,4,3,1,2,1,4,4,1,4,1,0,4,3,42.01
Education,Cybersecurity Analyst,3.0337917498457894,6,2,2,0,3,0,2,3,1,1,1,0,4,0,Arts,Bachelors,40+,10,0,0,Hybrid,Any,2,1,0,3,3,2,1,4.58,Healthcare,2,3,2,2,2,0,5,1,1,5,1,1,4,5,48.67
Medicine,Software Developer,2.875073734539546,7,0,0,1,6,1,3,0,2,3,4,2,2,0,Science,Bachelors,25-30,9,0,0,Remote,Tier1_City,5,5,1,4,4,1,5,39.84,Manufacturing,3,4,3,5,0,2,1,1,4,1,1,1,3,1,62.63
Law,Marketing Specialist,4.262655572201678,3,0,3,0,5,1,3,2,4,3,2,0,3,1,Arts,Bachelors,31-35,14,0,0,Office,Tier2_City,5,1,1,1,4,2,5,34.32,Education,4,1,2,2,5,3,2,5,1,2,0,1,1,4,54.75
Finance,Accountant,3.9299231219015898,1,2,1,1,9,0,4,2,0,0,1,1,1,1,Commerce,Bachelors,18-24,6,1,6,Hybrid,Any,5,2,2,1,2,1,4,14.35,Education,4,1,1,1,0,0,4,5,3,4,0,0,2,2,44.38
Computer Science,Education Administrator,3.02856776801668,0,0,4,0,0,1,1,4,1,1,3,4,1,1,Science,Bachelors,36-40,14,0,0,Hybrid,Tier3_City,2,1,1,3,2,4,1,27.66,Tech,1,4,1,4,1,0,3,3,3,2,1,0,5,4,59.05
Chemistry,Biochemist,4.421102602988155,7,1,2,0,9,1,4,3,2,0,2,4,0,1,Science,Bachelors,31-35,12,0,0,Flexible,Tier2_City,4,3,4,5,0,1,4,5.32,Other,3,1,2,1,1,2,3,5,3,1,1,0,1,1,50.99
Computer Science,Construction Manager,4.630489520844587,7,2,4,1,7,1,2,1,2,1,1,3,1,0,Science,Bachelors,25-30,8,0,0,Flexible,Tier2_City,4,1,4,2,2,1,5,20.84,Other,3,1,5,4,5,5,3,3,3,5,0,1,5,1,58.8
Music,Paralegal,4.911627632776084,7,2,0,1,2,1,3,1,2,3,0,4,3,1,Arts,Bachelors,18-24,5,0,0,Office,Tier2_City,3,3,4,3,2,4,2,11.18,Other,4,1,1,3,1,1,2,2,2,5,1,0,2,3,50.73
Architecture,Construction Manager,4.035796934825882,0,2,1,1,1,0,3,2,4,2,4,4,1,0,Interdisciplinary,Bachelors,25-30,10,0,0,Flexible,Tier1_City,5,4,3,4,0,0,2,4.05,Other,2,1,4,5,2,3,5,5,3,2,1,0,4,2,67.72
Business,Biomedical Engineer,4.768461957486705,0,2,3,1,3,1,0,0,2,3,3,3,1,1,Commerce,PhD,18-24,0,0,0,Hybrid,Tier1_City,5,3,4,4,5,2,3,19.78,Healthcare,4,5,3,2,5,5,2,3,3,3,0,1,1,2,50.91
Art,Construction Manager,4.956118295602186,1,1,0,0,8,0,2,3,1,0,2,4,2,1,Arts,Masters,18-24,14,0,0,Office,Tier1_City,3,2,5,1,0,3,5,37.13,Manufacturing,4,2,4,3,3,1,4,1,5,2,0,1,2,2,59.78
Chemistry,Financial Analyst,2.695262181857172,2,2,1,0,5,0,1,2,2,2,0,0,0,1,Science,PhD,31-35,7,0,0,Hybrid,Tier1_City,5,1,2,4,2,4,5,46.29,Other,5,3,2,5,4,5,5,5,5,2,0,0,5,1,57.82
Physics,Brand Manager,4.490925714910235,5,2,3,1,8,1,4,2,2,1,1,2,3,0,Science,Bachelors,18-24,1,0,0,Remote,Tier1_City,1,2,2,3,4,0,4,34.13,Finance,1,5,2,2,1,2,3,5,5,2,0,1,2,3,46.07
Education,Biotechnologist,2.502543827193737,5,0,2,0,7,0,1,2,0,3,4,2,4,0,Arts,Bachelors,18-24,3,0,0,Flexible,Tier1_City,3,3,1,4,2,1,3,21.89,Finance,1,3,5,3,4,0,1,3,1,2,0,1,5,5,41.09
Medicine,Cybersecurity Analyst,4.133697283997305,7,0,3,0,3,1,2,2,4,2,3,2,0,0,Science,Masters,31-35,2,1,15,Remote,Tier1_City,5,3,0,3,3,5,3,49.98,Education,5,5,1,5,0,5,1,2,5,1,0,1,5,3,53.77
Art,Counselor,4.61650482424842,5,2,2,0,0,0,0,2,0,4,4,4,4,1,Arts,Bachelors,18-24,5,1,27,Remote,Tier1_City,3,3,5,2,3,0,1,16.3,Manufacturing,3,5,1,5,2,3,1,5,1,1,0,1,1,5,48.91
Architecture,Art Director,4.939898526365608,9,2,2,0,9,1,1,4,3,3,1,1,4,1,Interdisciplinary,Bachelors,25-30,1,0,0,Remote,Tier2_City,1,3,5,1,3,4,4,11.8,Finance,1,3,4,3,1,1,4,3,5,2,1,0,2,1,45.23
Biology,Art Director,3.071055314391855,4,1,2,1,9,1,4,4,4,2,0,3,4,0,Science,Bachelors,18-24,4,0,0,Hybrid,Tier1_City,1,3,5,4,5,5,2,24.79,Tech,3,2,1,1,5,0,3,2,3,2,1,1,1,4,54.18
Engineering,Mechanical Engineer,3.630048047093229,3,0,0,0,1,0,4,1,1,3,4,1,1,1,Science,Bachelors,25-30,10,1,44,Remote,Tier3_City,2,1,3,3,1,1,1,26.73,Manufacturing,2,4,2,4,5,4,1,3,5,5,0,1,2,5,67.33
Finance,Physician Assistant,3.588929357693964,3,0,0,0,0,0,2,0,2,3,2,0,3,1,Commerce,Bachelors,31-35,8,0,0,Hybrid,Any,5,5,0,5,3,0,3,19.68,Education,3,5,5,4,3,5,5,2,4,4,1,1,5,4,55.54
Education,Legal Secretary,4.455514871052353,4,2,3,0,1,1,3,2,1,3,3,3,4,0,Arts,Bachelors,31-35,14,1,24,Flexible,Tier1_City,1,2,3,1,4,3,2,35.69,Healthcare,1,2,3,1,5,2,1,4,1,1,0,0,4,4,52.17
Education,Zoologist,3.559303308750807,5,2,4,0,3,1,2,4,1,3,0,2,3,1,Arts,Masters,25-30,2,1,44,Remote,Tier1_City,1,4,5,2,5,2,5,11.64,Tech,3,4,4,5,2,1,4,5,3,3,1,0,3,3,55.39
Computer Science,Marketing Manager,4.582675208617764,8,1,2,1,5,1,3,2,2,2,0,1,4,1,Science,Bachelors,18-24,1,0,0,Office,Tier3_City,1,4,2,3,1,2,4,26.99,Tech,2,3,4,2,0,4,1,4,3,3,1,0,4,3,36.37
Medicine,AI Researcher,4.248772810559615,0,2,3,1,3,1,3,4,2,0,2,1,0,0,Science,Bachelors,18-24,1,0,0,Remote,Any,2,2,2,2,1,4,3,26.51,Other,5,5,3,1,5,5,4,3,3,3,1,0,1,5,38.81
Business,Composer,3.614173076078724,0,1,0,1,8,1,4,3,3,0,3,2,3,1,Commerce,Masters,25-30,14,0,0,Remote,Tier1_City,5,1,3,2,3,1,5,41.72,Manufacturing,1,4,2,5,5,1,4,4,5,4,0,1,2,4,78.0
Medicine,Interior Designer,2.941207077742779,6,0,4,1,2,1,2,1,1,2,1,2,3,0,Science,Bachelors,36-40,8,0,0,Hybrid,Tier1_City,3,2,1,4,2,1,3,46.57,Healthcare,2,2,4,3,5,1,5,2,1,5,1,1,1,1,47.21
Chemistry,Legal Secretary,4.041132046501885,5,2,2,0,6,0,3,3,3,4,1,4,2,1,Science,Bachelors,18-24,5,1,47,Flexible,Tier1_City,2,3,4,4,0,2,2,34.17,Tech,4,4,1,3,4,4,4,1,3,4,0,1,4,3,54.93
Architecture,Legal Analyst,3.01942918208334,4,2,1,0,5,1,3,0,3,3,1,2,2,0,Interdisciplinary,Masters,25-30,1,1,8,Remote,Tier2_City,5,5,4,3,2,0,1,17.35,Healthcare,5,3,1,5,2,2,2,4,3,2,0,0,3,2,47.71
Computer Science,Entrepreneur,3.144193262533496,1,1,3,0,2,1,4,3,2,0,4,3,0,0,Science,Bachelors,18-24,2,0,0,Hybrid,Any,1,2,0,5,2,1,2,35.41,Education,5,4,1,3,4,2,3,3,5,5,0,0,3,1,57.89
Music,Composer,3.101076084006519,3,2,3,1,2,0,1,3,4,3,4,2,3,0,Arts,Bachelors,31-35,14,0,0,Remote,Tier3_City,2,1,2,3,1,3,4,14.81,Tech,1,1,5,4,5,4,4,5,3,5,0,1,4,1,66.78
Marketing,Microbiologist,4.086812644520426,5,1,4,0,0,0,1,3,0,4,0,3,4,0,Commerce,Bachelors,31-35,13,0,0,Flexible,Tier2_City,4,3,4,5,1,3,4,48.43,Finance,2,5,3,1,1,2,2,4,3,2,0,0,4,5,50.58
Business,Civil Engineer,3.440566177471628,2,2,3,0,7,1,4,2,4,0,1,0,3,0,Commerce,Bachelors,31-35,0,0,0,Remote,Tier3_City,4,2,2,2,5,1,3,41.65,Education,4,2,2,4,5,3,2,4,2,3,1,1,2,2,42.42
Medicine,Legal Analyst,3.351465735057504,2,1,4,1,5,0,4,1,1,4,1,2,4,0,Science,Masters,36-40,1,0,0,Hybrid,Tier1_City,1,2,5,1,5,1,2,23.27,Education,2,2,1,5,5,3,1,1,5,3,1,0,2,2,56.45
Education,Mechanical Engineer,3.9568908038479575,0,2,3,1,4,1,0,4,1,2,0,1,2,1,Arts,Masters,25-30,14,1,58,Flexible,Tier2_City,5,3,2,3,1,2,1,39.86,Other,3,5,1,1,0,0,5,3,2,1,0,1,2,2,45.67
Psychology,Animator,3.5814488765019896,8,0,1,1,2,0,2,2,1,0,2,0,0,1,Arts,Bachelors,18-24,1,0,0,Hybrid,Tier1_City,5,1,2,3,4,4,4,22.21,Tech,1,5,5,3,3,4,1,4,2,3,1,0,1,3,39.77
Finance,Industrial-Organizational Psychologist,4.499431858460471,8,2,0,1,1,1,0,0,2,1,4,1,1,1,Commerce,Masters,25-30,10,0,0,Flexible,Tier1_City,2,5,4,5,4,2,1,6.51,Finance,3,1,1,1,2,3,5,5,5,4,0,1,1,2,61.7
Physics,Legal Analyst,4.238709342544069,7,1,2,0,4,0,0,2,1,2,3,0,0,0,Science,Bachelors,31-35,1,0,0,Flexible,Tier1_City,4,5,4,2,0,4,5,36.22,Healthcare,3,1,5,1,5,1,1,2,3,5,1,1,4,1,38.64
Finance,Musician,3.0519275268307595,7,0,2,1,3,0,4,0,2,4,3,1,3,0,Commerce,Bachelors,31-35,6,0,0,Hybrid,Tier2_City,5,3,5,2,1,3,3,22.02,Finance,5,2,3,3,4,5,1,5,3,1,1,0,1,5,49.76
Psychology,Interior Designer,4.19569996439221,7,1,4,0,8,0,4,0,2,2,2,3,4,0,Arts,Masters,25-30,2,0,0,Hybrid,Tier3_City,2,4,4,5,3,4,1,46.73,Education,5,4,4,2,0,2,2,4,1,1,0,0,4,3,40.91
Computer Science,Software Developer,3.03013618682208,5,1,4,1,5,1,0,2,1,4,1,0,0,0,Science,Bachelors,31-35,12,0,0,Remote,Tier2_City,2,1,3,2,5,2,3,17.41,Tech,3,5,1,3,0,5,3,4,1,3,0,0,5,4,49.0
Physics,Zoologist,3.919606330715293,6,2,4,1,3,0,3,2,0,4,0,3,3,0,Science,Bachelors,31-35,14,0,0,Flexible,Tier1_City,4,4,4,4,1,1,5,42.64,Finance,2,1,1,4,1,3,2,1,5,1,0,0,3,2,56.52
Education,Curriculum Developer,4.68597206852687,9,2,1,0,5,1,0,4,3,2,1,3,4,1,Arts,Bachelors,36-40,13,1,11,Remote,Tier1_City,1,4,2,1,4,4,1,34.98,Finance,1,1,3,2,2,3,1,3,4,1,0,1,1,3,53.8
Law,School Counselor,2.722103109082264,7,2,2,1,7,1,0,3,1,0,0,2,3,0,Arts,Bachelors,25-30,10,0,0,Office,Tier1_City,2,4,5,3,1,2,1,43.11,Education,1,1,4,4,1,5,3,1,2,2,0,0,1,5,41.43
Chemistry,Cybersecurity Analyst,3.847172240834613,1,0,0,0,8,1,3,3,0,1,4,1,1,0,Science,Bachelors,31-35,3,0,0,Hybrid,Tier1_City,1,1,2,1,4,3,5,16.72,Healthcare,2,4,5,5,1,4,1,5,5,3,1,1,4,4,56.81
Architecture,Conductor,3.041253714786545,2,2,0,0,2,1,2,0,0,2,4,2,1,1,Interdisciplinary,Masters,18-24,1,1,47,Hybrid,Tier2_City,4,4,5,3,1,5,2,24.68,Finance,3,2,4,4,1,5,1,3,3,3,1,1,5,1,42.24
Music,Physicist,4.244533044739638,6,2,3,0,7,0,3,3,1,3,1,0,2,0,Arts,Bachelors,31-35,4,1,54,Remote,Tier1_City,2,3,0,4,3,4,1,41.69,Other,1,2,1,1,0,1,3,1,2,5,1,1,5,2,45.33
Computer Science,Clinical Psychologist,2.7235376153518898,7,0,2,1,6,0,3,1,2,1,3,2,2,0,Science,Bachelors,36-40,13,0,0,Hybrid,Tier3_City,3,2,1,2,0,3,1,33.26,Finance,5,1,3,5,4,5,2,4,1,4,1,0,4,2,54.36
Music,Physician Assistant,4.322764849463045,8,1,0,1,9,0,1,2,1,1,4,2,0,1,Arts,Bachelors,25-30,8,0,0,Remote,Tier3_City,4,3,3,5,3,3,4,19.92,Manufacturing,4,4,2,2,4,3,4,3,2,1,1,0,5,5,44.08
Biology,Music Teacher,2.9254065206067192,3,0,3,1,6,1,2,4,4,3,2,3,3,1,Science,Masters,31-35,11,1,27,Remote,Tier1_City,4,2,5,4,4,0,2,27.06,Education,5,4,3,4,3,1,1,2,1,1,1,0,5,3,65.83
Computer Science,Teacher,3.5246458001780496,0,2,3,1,1,0,2,0,1,4,4,3,2,0,Science,Masters,31-35,8,0,0,Remote,Tier2_City,3,5,0,1,5,5,1,49.82,Manufacturing,2,2,5,5,5,2,4,2,5,4,1,1,1,3,71.86
Chemistry,Psychologist,3.225084123377644,5,2,4,1,2,0,0,3,1,0,4,1,2,0,Science,Masters,18-24,6,0,0,Remote,Tier1_City,4,4,5,5,5,4,5,37.87,Education,4,5,5,4,3,2,2,5,1,4,0,0,5,4,50.81
Computer Science,Graphic Designer,3.0575436520573818,8,0,4,0,7,1,0,3,4,4,1,4,0,0,Science,Masters,25-30,11,0,0,Hybrid,Tier2_City,3,5,3,2,2,2,3,31.88,Education,1,1,1,1,4,2,4,1,5,1,0,0,1,2,60.9
Medicine,Physical Chemist,4.180421436640502,2,1,1,0,0,0,1,0,1,1,2,3,2,1,Science,Masters,18-24,7,0,0,Hybrid,Any,3,5,3,4,3,4,5,41.91,Manufacturing,1,4,3,1,1,5,2,5,5,4,1,1,1,5,55.86
Computer Science,Aerospace Engineer,2.54212834137452,1,2,3,0,1,0,1,4,2,1,3,1,4,1,Science,Bachelors,40+,12,0,0,Remote,Tier2_City,4,1,2,5,1,4,2,23.78,Healthcare,4,5,2,2,0,5,4,2,3,2,0,1,2,3,53.64
Engineering,Zoologist,4.177713523014569,0,2,4,1,7,0,0,4,3,4,0,2,2,1,Science,Bachelors,36-40,13,0,0,Hybrid,Tier1_City,3,4,2,4,0,5,4,47.65,Healthcare,1,3,3,3,1,0,4,4,4,4,0,0,3,2,60.11
Business,Architectural Technologist,3.953070432138852,4,1,4,1,6,0,0,1,4,1,1,3,0,0,Commerce,Masters,18-24,4,1,51,Office,Tier3_City,3,5,2,4,1,3,4,28.94,Education,4,1,5,3,1,4,1,4,4,3,0,0,1,3,51.47
Music,Conductor,2.9144565889094247,4,1,4,0,0,1,1,4,0,0,2,3,4,0,Arts,PhD,18-24,4,1,24,Hybrid,Tier2_City,4,2,2,2,1,3,4,18.36,Manufacturing,3,3,3,1,1,2,3,4,4,1,0,0,1,1,49.58
Biology,Artist,3.773432841219493,1,1,0,1,2,1,4,0,3,2,3,3,1,1,Science,Masters,25-30,11,1,54,Flexible,Tier2_City,3,2,0,3,3,3,5,7.04,Finance,2,2,1,5,2,0,3,4,5,1,0,1,4,1,71.19
Chemistry,Special Education Teacher,3.574635040819257,3,1,0,1,9,1,2,1,1,0,0,1,0,0,Science,Bachelors,25-30,2,0,0,Remote,Tier2_City,1,1,1,5,0,3,3,20.66,Education,5,2,5,2,2,0,2,4,5,4,0,1,3,2,36.43
Engineering,Acoustics Specialist,3.172316279547319,8,1,4,1,5,1,0,2,0,1,0,0,3,1,Science,Bachelors,18-24,5,0,0,Office,Tier1_City,4,5,1,2,2,5,3,29.73,Other,4,2,3,4,1,4,1,2,3,5,0,1,2,2,38.23
Marketing,Digital Marketing Specialist,3.053152061184745,4,0,4,1,5,0,2,1,0,1,3,4,2,1,Commerce,Bachelors,25-30,0,1,42,Hybrid,Tier2_City,4,5,5,4,1,2,1,36.05,Education,4,4,3,4,3,2,4,3,3,2,1,1,5,2,35.9
Art,Quantum Physicist,3.7651617384694336,6,1,3,1,1,0,0,1,1,2,0,0,1,0,Arts,Masters,25-30,2,0,0,Hybrid,Tier2_City,1,5,0,2,0,1,3,44.13,Tech,3,4,1,5,3,4,2,4,1,3,1,1,1,4,34.69
Finance,Construction Manager,4.264849314210825,0,2,4,1,7,0,1,1,0,1,3,1,1,1,Commerce,Bachelors,18-24,10,0,0,Hybrid,Any,5,1,1,3,2,0,3,47.37,Healthcare,5,5,1,3,4,5,3,3,1,4,0,0,3,5,49.47
Art,Art Director,4.34308909474538,3,1,1,1,7,0,3,3,2,3,4,1,4,1,Arts,Bachelors,36-40,1,0,0,Hybrid,Tier1_City,2,4,5,5,1,3,1,7.82,Manufacturing,3,3,3,1,0,4,4,4,5,5,0,0,3,4,52.01
Marketing,Entrepreneur,4.047066880674288,7,0,3,0,8,1,0,1,3,1,3,4,4,1,Commerce,Masters,36-40,6,0,0,Hybrid,Tier1_City,3,5,4,3,0,3,5,31.24,Finance,3,2,2,1,2,3,1,5,4,4,0,0,3,1,56.14
Psychology,Interior Designer,3.765663576030154,5,0,3,0,8,0,4,4,1,0,2,0,4,1,Arts,Bachelors,31-35,8,0,0,Hybrid,Any,3,5,4,1,3,0,5,34.33,Other,2,2,5,2,5,5,2,1,2,1,0,1,1,1,48.59
Finance,Landscape Architect,2.723293268010808,8,1,4,1,3,1,2,1,3,0,1,3,2,1,Commerce,Masters,36-40,3,0,0,Remote,Tier1_City,2,3,4,5,5,3,2,11.09,Finance,1,4,3,1,1,4,5,3,3,3,0,0,5,1,50.66
Architecture,Curriculum Developer,3.927307384487728,3,0,4,1,4,1,1,3,0,1,4,3,2,1,Interdisciplinary,Bachelors,18-24,6,1,29,Hybrid,Tier3_City,3,2,2,3,5,1,5,28.64,Other,5,4,1,3,5,0,1,1,2,4,1,1,3,3,54.51
Education,Quantum Physicist,2.7739068138330363,1,0,4,1,5,1,4,4,0,2,3,0,3,0,Arts,Bachelors,25-30,7,0,0,Office,Tier1_City,3,4,4,4,1,4,4,18.74,Education,3,4,5,3,2,2,2,2,2,1,1,0,3,1,47.4
Architecture,Digital Marketing Specialist,4.576910170258712,9,1,2,0,3,0,1,4,3,0,0,0,1,0,Interdisciplinary,Bachelors,18-24,9,1,55,Hybrid,Tier1_City,1,4,5,5,1,0,4,6.64,Finance,1,1,1,5,5,4,4,5,5,2,0,1,3,1,51.45
Art,Accountant,4.422088481465859,2,2,1,1,8,1,4,1,3,2,0,2,3,1,Arts,Masters,31-35,1,1,33,Remote,Tier1_City,1,4,3,5,0,2,2,6.1,Finance,1,3,5,2,4,0,2,4,1,1,1,1,4,3,34.03
Biology,Curriculum Developer,3.497246195531048,3,0,0,1,2,1,1,2,4,3,2,0,3,0,Science,Bachelors,36-40,6,0,0,Remote,Tier3_City,1,5,3,2,5,0,3,38.68,Education,1,3,3,2,3,2,1,4,4,4,1,0,2,2,55.01
Physics,Pharmacist,4.627087113015738,6,0,3,0,0,0,1,2,0,2,0,1,0,0,Science,Bachelors,31-35,12,1,26,Remote,Tier1_City,1,3,5,4,1,1,2,31.93,Healthcare,1,1,4,1,3,1,3,2,2,4,1,0,5,5,44.03
Chemistry,Electrical Engineer,2.670446316124166,4,0,3,0,9,0,2,3,0,2,2,3,4,0,Science,PhD,36-40,11,0,0,Remote,Tier1_City,4,4,0,1,2,5,1,36.61,Tech,2,2,4,4,0,5,3,3,3,2,0,0,4,3,60.74
Marketing,Astronomer,4.389899295248919,7,1,3,0,2,0,1,0,4,0,4,0,3,1,Commerce,Bachelors,31-35,2,0,0,Remote,Tier1_City,3,1,3,3,1,2,2,35.21,Healthcare,2,5,5,2,0,0,1,4,3,4,1,1,5,4,39.6
Education,Inorganic Chemist,4.332874427764935,8,2,3,1,7,0,0,4,2,0,3,2,0,0,Arts,Masters,25-30,7,0,0,Remote,Tier1_City,2,1,5,2,5,4,2,9.31,Healthcare,3,5,1,1,4,5,4,3,3,5,1,0,4,1,59.33
Medicine,Organic Chemist,3.2293637119807883,7,0,4,0,7,0,3,2,3,1,3,3,2,1,Science,Masters,25-30,5,0,0,Remote,Tier2_City,3,2,5,3,4,3,4,10.12,Tech,1,2,1,4,0,1,3,4,2,2,1,1,3,5,60.22
Physics,Electrical Engineer,3.4147800250742177,9,2,0,0,2,0,1,2,0,0,0,1,2,0,Science,Bachelors,18-24,2,0,0,Hybrid,Tier1_City,4,3,0,1,5,0,1,14.87,Education,3,5,1,1,4,5,5,3,1,3,0,0,2,3,32.76
Psychology,Acoustics Specialist,3.408654329736347,9,1,2,0,3,1,4,0,0,0,4,3,0,0,Arts,Masters,18-24,7,0,0,Flexible,Tier1_City,4,4,1,1,2,2,1,21.76,Healthcare,4,4,3,5,5,5,5,1,4,1,1,0,1,3,57.38
Marketing,Investment Banker,4.1285034776196845,2,1,4,0,0,0,3,3,3,4,1,3,2,1,Commerce,Bachelors,31-35,10,0,0,Flexible,Tier1_City,3,3,3,5,0,0,2,47.14,Manufacturing,2,3,5,2,5,5,5,3,2,3,0,1,5,5,57.19
Biology,Chemist,4.328377767412332,8,0,2,0,1,1,1,1,2,3,3,3,0,0,Science,Masters,25-30,12,0,0,Remote,Tier3_City,3,1,5,1,2,4,1,34.67,Manufacturing,2,4,3,1,2,1,2,2,1,2,1,0,5,5,55.72
Finance,Ecologist,4.143385162648931,0,0,4,0,9,1,0,2,4,3,3,0,2,0,Commerce,Bachelors,25-30,2,0,0,Remote,Tier1_City,1,4,5,3,4,0,1,14.99,Tech,5,5,4,5,1,3,4,4,4,5,1,0,2,5,56.21
Music,Electrical Engineer,3.781484761027322,5,0,0,0,6,1,0,2,4,2,4,0,0,0,Arts,Masters,25-30,8,0,0,Hybrid,Tier2_City,4,5,3,4,4,2,5,5.63,Manufacturing,4,5,4,1,3,1,4,5,4,2,0,0,4,4,57.55
Architecture,Biomedical Engineer,4.925803853192477,9,2,4,0,1,0,4,1,2,1,1,0,3,0,Interdisciplinary,Bachelors,25-30,10,0,0,Remote,Tier1_City,3,1,0,4,1,1,1,35.16,Education,2,3,1,3,1,0,3,3,4,5,1,1,5,1,55.94
Computer Science,Mechanical Engineer,4.044903651396004,2,1,3,0,3,1,1,4,2,4,0,0,1,1,Science,Masters,25-30,2,1,43,Hybrid,Tier1_City,2,2,3,5,1,5,3,32.39,Finance,1,4,1,1,5,5,1,5,4,4,0,1,2,3,47.18
Engineering,Counselor,2.7556080425524354,2,1,3,1,7,1,1,3,2,0,1,3,4,0,Science,Bachelors,25-30,0,0,0,Hybrid,Tier3_City,2,4,0,3,5,2,1,34.76,Education,1,3,5,3,2,4,5,3,4,2,0,0,3,3,42.19
Music,Accountant,3.2168096628231067,9,1,2,0,8,1,2,3,0,1,1,0,0,0,Arts,Bachelors,25-30,12,1,8,Hybrid,Any,1,2,3,3,3,0,4,15.28,Tech,1,5,4,2,5,5,5,1,1,3,1,0,1,5,46.16
Business,Fluid Mechanics Engineer,4.8734532516849605,9,0,1,0,0,1,3,3,0,1,2,1,2,0,Commerce,Bachelors,36-40,1,0,0,Office,Tier1_City,1,3,5,1,2,4,5,27.3,Finance,3,3,5,1,0,2,1,5,4,1,1,1,2,5,35.39
Education,Manager,3.63357705274551,8,2,0,0,6,1,1,1,3,0,2,1,1,0,Arts,Bachelors,25-30,3,0,0,Office,Tier2_City,3,2,2,3,5,3,4,20.0,Manufacturing,2,3,4,5,3,3,1,2,2,2,0,1,1,5,43.81
Computer Science,Industrial-Organizational Psychologist,3.5551670909357425,1,0,3,0,5,0,3,4,1,0,1,0,0,1,Science,Masters,31-35,12,0,0,Flexible,Tier2_City,2,2,1,2,3,3,4,41.43,Healthcare,3,5,2,2,0,2,5,5,1,1,1,1,2,1,49.68
Engineering,Market Research Analyst,3.038312905558505,0,0,3,1,4,1,4,2,2,2,4,0,1,1,Science,Bachelors,36-40,10,0,0,Remote,Tier3_City,4,5,3,1,5,4,3,6.26,Manufacturing,2,3,5,2,1,0,1,3,4,2,1,0,5,2,61.99
Engineering,Animator,4.0955425846804365,0,2,1,1,7,1,4,2,0,1,4,4,4,0,Science,PhD,36-40,1,1,50,Flexible,Any,5,2,5,2,4,0,5,15.95,Education,5,4,2,3,5,4,2,2,1,2,1,1,2,4,52.99
Architecture,Credit Analyst,2.9182714484263004,5,1,0,0,0,0,4,2,2,1,0,3,1,1,Interdisciplinary,PhD,36-40,3,0,0,Hybrid,Tier2_City,2,5,1,5,1,5,2,31.34,Education,3,5,3,2,0,1,3,1,1,2,1,0,1,4,47.48
Architecture,Brand Manager,3.763832841305814,8,1,2,0,0,1,3,3,4,0,2,4,1,0,Interdisciplinary,Masters,25-30,3,0,0,Hybrid,Any,4,2,3,4,1,4,1,12.65,Tech,2,3,4,1,4,1,2,5,3,4,1,1,2,3,57.52
Marketing,Doctor,4.268636605930203,8,1,1,1,3,0,3,3,0,4,4,0,2,0,Commerce,Bachelors,18-24,3,0,0,Flexible,Any,2,5,3,5,5,0,3,34.62,Healthcare,5,2,2,1,1,5,5,2,1,3,0,0,3,2,45.97
Biology,Actuary,4.505052111132865,2,1,2,0,2,0,3,4,0,2,3,4,0,0,Science,Bachelors,25-30,0,0,0,Flexible,Tier2_City,3,1,2,4,1,2,3,9.43,Healthcare,2,4,3,3,0,5,3,5,3,4,1,1,4,1,50.61
Music,Nurse,3.676261546232745,3,0,2,0,8,1,2,0,0,2,1,0,1,0,Arts,Masters,25-30,8,1,26,Office,Tier2_City,5,5,4,5,0,5,2,4.07,Finance,4,4,5,1,1,0,3,1,5,3,1,1,4,4,50.52
Architecture,Entrepreneur,3.5058215420295804,7,0,1,1,9,0,3,2,3,0,2,4,3,0,Interdisciplinary,Bachelors,36-40,9,0,0,Hybrid,Tier2_City,5,1,4,3,5,1,3,43.58,Finance,3,4,2,3,0,0,3,1,3,1,1,0,5,5,59.14
Engineering,Game Developer,3.054382751921232,4,0,2,0,9,1,1,4,4,4,0,3,3,0,Science,Bachelors,31-35,10,1,6,Hybrid,Tier1_City,3,1,1,2,4,0,2,18.67,Education,1,1,2,4,0,2,4,1,5,4,0,0,3,5,71.52
Architecture,Brand Manager,4.133038980767117,5,2,0,1,7,0,1,3,3,1,0,4,4,0,Interdisciplinary,Masters,18-24,6,0,0,Hybrid,Tier2_City,3,4,1,4,5,3,2,10.37,Tech,5,5,3,3,5,2,4,1,5,1,1,1,3,3,58.84
Music,Geneticist,2.702368077434236,1,0,4,1,5,0,4,2,1,2,3,1,1,0,Arts,Masters,18-24,1,0,0,Office,Tier2_City,1,1,2,1,5,3,2,11.12,Education,5,1,2,5,5,5,3,2,5,2,0,0,4,4,54.15
Business,Marketing Specialist,2.813400511104729,3,2,0,0,0,1,0,3,4,2,2,0,2,1,Commerce,Masters,18-24,2,0,0,Office,Tier1_City,4,4,0,2,1,5,3,44.64,Other,1,3,3,5,5,5,4,2,3,4,1,0,2,4,52.16
Engineering,Legal Analyst,2.7021269240343395,7,2,2,0,3,0,0,1,4,1,0,3,1,1,Science,Bachelors,31-35,12,0,0,Hybrid,Any,4,5,1,1,4,1,2,33.76,Healthcare,5,5,4,1,1,2,2,1,1,4,0,1,5,4,50.03
Medicine,Judge,4.755936895043698,0,0,4,0,2,0,0,0,4,4,4,3,3,0,Science,Masters,31-35,7,1,31,Hybrid,Any,1,3,4,2,5,0,3,47.95,Healthcare,1,4,4,4,2,5,5,3,4,2,0,1,2,3,67.32
Engineering,Fluid Mechanics Engineer,4.428079345431617,8,1,2,1,8,0,3,3,1,4,4,1,3,1,Science,Bachelors,36-40,6,0,0,Remote,Tier1_City,4,4,2,2,1,1,5,40.6,Education,1,4,4,5,1,1,5,2,5,5,1,0,4,3,63.4
Education,Lawyer,3.091405501701709,1,0,1,1,5,1,4,4,1,3,0,2,0,1,Arts,Bachelors,36-40,3,0,0,Flexible,Tier3_City,5,3,0,5,2,2,2,39.07,Healthcare,2,4,2,5,3,0,5,1,4,1,0,1,2,3,46.69
Medicine,Inorganic Chemist,4.682723755273284,8,0,4,0,1,0,2,2,4,3,2,4,4,0,Science,Masters,18-24,3,1,56,Remote,Tier1_City,2,5,5,4,4,1,3,26.49,Finance,3,4,2,5,3,3,1,2,1,3,1,0,3,1,56.5
Finance,Architect,4.171555809205612,5,0,4,0,7,0,1,0,3,3,3,4,3,1,Commerce,Bachelors,25-30,8,0,0,Hybrid,Tier2_City,5,4,2,4,3,2,3,41.58,Healthcare,4,3,1,1,2,1,2,5,5,3,0,1,5,3,62.74
Computer Science,Clinical Psychologist,4.869476558394838,8,2,2,0,4,0,2,2,3,2,1,0,1,0,Science,Bachelors,18-24,14,0,0,Flexible,Tier2_City,1,5,4,2,0,3,3,22.39,Finance,5,2,1,2,0,3,5,3,5,3,0,1,4,4,56.04
Business,Biotechnologist,4.214491177406357,2,2,3,0,8,1,2,0,0,0,0,1,1,0,Commerce,High School,25-30,4,0,0,Hybrid,Tier2_City,4,3,5,3,3,2,1,41.87,Manufacturing,2,5,3,2,1,2,5,1,5,4,1,1,4,4,39.85
Medicine,Music Teacher,4.154780209243439,4,0,3,0,5,1,1,1,2,1,0,3,0,0,Science,Masters,36-40,13,0,0,Office,Tier2_City,4,5,2,3,4,0,1,38.61,Tech,4,2,2,2,5,2,5,3,5,3,1,0,1,1,62.13
Business,Biotechnologist,4.503567521443491,8,0,0,1,4,0,1,2,0,1,3,4,3,0,Commerce,Masters,25-30,12,0,0,Office,Any,2,3,3,1,5,5,2,34.89,Tech,4,5,3,1,0,0,5,2,3,3,0,1,1,5,56.87
Psychology,Nuclear Physicist,4.496096390390903,9,2,0,0,8,1,4,1,1,3,3,4,0,1,Arts,Masters,31-35,10,0,0,Remote,Tier2_City,2,1,4,1,1,5,5,18.5,Healthcare,5,4,5,2,0,4,4,2,3,2,0,1,4,4,63.96
Music,AI Researcher,3.2400653145341285,4,2,1,1,3,1,4,3,4,1,4,1,4,0,Arts,Masters,25-30,4,1,21,Hybrid,Tier2_City,2,3,0,5,4,0,2,32.64,Tech,5,1,2,3,3,4,4,5,2,1,0,0,2,5,55.17
Music,Software Developer,4.071499246040736,7,0,2,1,2,0,2,3,1,0,0,2,4,0,Arts,Bachelors,18-24,14,0,0,Office,Tier2_City,5,3,2,2,0,0,4,26.82,Other,2,3,5,1,5,5,2,1,4,4,1,1,1,3,50.12
Computer Science,Data Scientist,4.178394414065052,7,0,4,1,1,1,0,2,1,3,4,4,4,1,Science,Bachelors,18-24,6,1,37,Hybrid,Any,1,1,4,1,4,0,4,24.69,Manufacturing,5,5,2,1,5,5,2,1,4,2,1,1,4,5,50.12
Business,Urban Planner,3.6691614805176775,1,0,1,1,9,0,4,3,2,2,2,0,2,0,Commerce,Bachelors,25-30,0,0,0,Hybrid,Tier1_City,1,4,4,1,1,4,5,49.54,Healthcare,4,4,4,4,1,2,5,4,2,2,1,0,3,4,41.24
Chemistry,Paralegal,4.838813831302501,1,0,4,1,5,0,2,2,0,0,1,0,1,1,Science,Bachelors,31-35,2,0,0,Hybrid,Tier1_City,1,2,0,2,3,2,5,26.71,Finance,5,1,3,5,4,4,5,5,3,4,0,0,1,1,42.09
Psychology,Analytical Chemist,3.0593519150445507,5,0,1,0,6,0,0,3,2,2,0,4,2,0,Arts,Bachelors,18-24,1,1,36,Remote,Any,5,4,4,5,2,0,5,4.5,Manufacturing,2,4,1,4,5,4,5,3,2,2,1,0,1,2,35.18
Music,Nuclear Physicist,3.729609615848476,1,2,3,1,5,1,2,0,0,3,0,0,3,1,Arts,PhD,31-35,10,1,50,Hybrid,Tier3_City,3,2,0,1,3,5,1,32.44,Other,2,3,4,2,5,5,1,1,5,5,0,1,5,5,62.82
Finance,Physician Assistant,3.737795641460973,4,0,0,0,3,0,3,4,1,1,0,4,4,0,Commerce,High School,36-40,9,0,0,Remote,Any,4,1,4,5,1,1,1,37.22,Manufacturing,2,1,1,1,3,2,3,4,3,4,1,1,1,5,49.7
Marketing,Judge,4.428818296285447,9,2,0,0,0,0,2,2,3,1,1,0,4,1,Commerce,Bachelors,25-30,5,0,0,Remote,Tier1_City,5,4,2,4,1,1,4,44.6,Tech,5,5,2,1,5,0,4,3,5,1,1,0,3,2,45.65
Physics,Geneticist,3.6521099328176727,0,0,4,0,3,1,4,4,4,4,2,3,0,0,Science,Bachelors,31-35,10,1,30,Hybrid,Any,1,5,0,5,0,4,5,32.74,Other,3,5,5,2,0,1,5,2,2,4,0,0,2,5,64.24
Art,Game Developer,4.6272717943015,8,1,3,1,1,1,0,1,2,3,0,2,0,1,Arts,Bachelors,25-30,11,1,50,Hybrid,Tier3_City,5,5,0,3,4,2,3,3.91,Finance,2,5,5,5,0,5,1,2,4,2,1,1,1,5,54.5
Chemistry,Landscape Architect,3.991866899619088,8,0,1,1,1,0,3,0,4,2,2,0,4,1,Science,PhD,31-35,5,1,21,Remote,Tier3_City,5,4,4,3,4,2,4,8.63,Education,3,5,4,4,4,4,1,5,1,2,1,0,3,5,56.03
Medicine,Astronomer,2.605955134554366,5,1,0,1,1,1,3,4,3,3,0,4,3,1,Science,Bachelors,31-35,9,0,0,Office,Tier2_City,3,5,5,5,3,2,5,10.58,Manufacturing,1,1,1,5,0,3,1,2,1,1,1,0,5,3,58.19
Finance,Physician Assistant,3.996613371611802,5,1,3,0,9,0,2,0,4,3,3,0,1,0,Commerce,Bachelors,40+,0,0,0,Hybrid,Tier1_City,2,1,3,3,2,5,3,12.93,Tech,2,3,3,2,2,4,4,2,5,1,0,0,1,3,42.54
Education,Quantum Physicist,3.390217847989611,5,2,2,0,6,1,0,3,4,4,2,2,0,1,Arts,Masters,25-30,13,0,0,Flexible,Tier2_City,1,5,5,4,2,5,5,40.59,Manufacturing,3,1,3,4,4,1,3,4,1,5,1,1,1,5,67.66
Architecture,Quantum Physicist,3.594547310746086,4,1,2,0,9,1,4,4,0,4,4,0,4,1,Interdisciplinary,Bachelors,25-30,13,1,57,Hybrid,Tier2_City,5,5,5,2,0,4,2,17.56,Finance,3,5,3,4,5,1,5,3,5,4,0,1,2,2,70.72
Business,Aerospace Engineer,3.333118464608876,3,1,1,1,8,0,2,4,0,3,0,2,0,0,Commerce,Bachelors,18-24,5,0,0,Remote,Tier2_City,2,2,0,3,1,2,3,17.68,Finance,4,3,1,5,0,1,5,3,2,3,1,0,1,5,43.2
Music,Software Developer,4.119194637109015,4,1,4,1,2,0,4,4,3,3,3,2,0,1,Arts,Bachelors,18-24,9,0,0,Office,Tier3_City,4,2,3,3,0,2,2,38.51,Healthcare,3,2,5,5,3,1,3,4,3,2,0,0,2,5,61.36
Education,Biomedical Engineer,2.9815272950219267,9,0,4,1,6,0,1,0,3,4,1,2,2,1,Arts,Masters,31-35,1,1,57,Hybrid,Tier2_City,4,3,5,5,4,0,1,22.38,Education,4,2,5,1,3,3,4,3,4,3,1,0,3,2,49.58
Physics,Art Director,2.6759211046746194,7,0,4,1,9,0,3,3,3,3,4,3,0,1,Science,PhD,36-40,10,0,0,Hybrid,Tier1_City,4,1,1,4,5,2,4,6.04,Education,3,1,4,1,2,0,1,3,5,2,0,1,5,4,76.38
Engineering,Illustrator,4.166335636789817,0,2,0,0,7,1,3,2,4,4,2,4,1,0,Science,Masters,25-30,3,1,48,Hybrid,Tier2_City,5,5,2,2,5,5,5,30.5,Tech,3,5,1,5,4,1,5,5,3,1,0,1,2,3,63.51
Music,Microbiologist,2.815350282911127,2,2,4,1,0,0,2,4,2,3,0,2,1,0,Arts,Bachelors,18-24,5,0,0,Remote,Tier1_City,5,1,3,5,5,0,4,9.11,Education,1,2,2,2,4,1,1,1,3,3,1,1,1,2,50.99
Marketing,Cybersecurity Analyst,2.685973048155508,7,1,4,0,4,0,0,3,4,1,4,1,2,1,Commerce,Masters,25-30,2,0,0,Hybrid,Tier1_City,3,1,5,5,1,0,5,29.87,Finance,3,2,2,5,0,5,3,3,5,2,0,0,2,1,52.11
Finance,Doctor,3.310684617500559,9,1,2,0,8,1,4,2,1,0,2,2,4,1,Commerce,Bachelors,25-30,2,0,0,Remote,Tier2_City,1,2,5,4,0,2,2,39.64,Education,5,4,3,1,0,3,5,3,4,4,1,0,2,5,43.1
Biology,Web Developer,2.825390833254396,9,0,0,0,0,0,4,2,0,2,3,3,1,0,Science,High School,25-30,11,0,0,Hybrid,Tier3_City,2,5,2,2,3,1,3,46.69,Tech,5,4,5,4,1,4,5,3,4,4,1,1,1,5,64.62
Engineering,Chemical Engineer,3.586535422188946,5,2,0,1,4,0,2,3,0,4,3,4,0,0,Science,Bachelors,18-24,2,0,0,Flexible,Tier3_City,4,3,0,4,4,3,3,6.15,Manufacturing,5,3,5,2,5,4,5,2,3,4,0,0,4,1,54.03
Education,School Psychologist,4.619406667730157,5,0,0,1,5,0,3,0,1,0,2,2,2,1,Arts,Bachelors,31-35,3,0,0,Office,Tier2_City,2,4,5,2,5,5,5,17.29,Education,1,3,1,1,2,3,2,4,1,2,0,1,4,4,33.75
Business,Investment Banker,4.941712288330194,7,1,0,1,3,0,4,1,4,2,4,4,4,1,Commerce,Bachelors,18-24,8,0,0,Remote,Any,3,3,2,4,2,1,2,33.67,Education,3,5,1,2,4,4,3,5,3,4,1,1,5,2,69.19
Medicine,Manager,2.736206646698095,5,2,4,1,5,1,1,1,1,2,2,0,0,0,Science,Masters,25-30,3,1,20,Flexible,Tier1_City,4,2,3,5,0,2,5,17.83,Finance,1,2,4,2,0,2,3,2,2,5,0,1,4,4,40.44
Education,Civil Engineer,3.751970583909806,7,2,2,0,4,1,2,1,4,0,2,3,0,1,Arts,PhD,31-35,12,0,0,Hybrid,Any,2,3,5,5,4,2,5,24.2,Finance,3,1,1,4,5,0,1,4,5,5,0,0,2,1,76.26
Engineering,Physician Assistant,3.12842831423558,8,2,0,0,8,0,1,2,4,4,1,2,0,1,Science,Bachelors,25-30,3,0,0,Remote,Any,1,2,5,1,4,1,5,3.94,Manufacturing,4,1,4,1,4,5,4,5,3,1,1,1,3,5,43.37
Architecture,Brand Manager,3.653877239631197,4,2,2,1,9,0,4,3,2,3,2,0,2,1,Interdisciplinary,Bachelors,31-35,3,0,0,Office,Tier2_City,1,2,0,3,2,2,3,35.59,Other,1,4,3,5,5,4,5,2,4,3,0,1,5,5,52.49
Finance,Landscape Architect,4.069057855719402,6,1,0,0,8,0,4,4,4,1,0,0,4,1,Commerce,Bachelors,31-35,6,0,0,Hybrid,Tier1_City,3,1,5,4,2,5,5,44.51,Other,5,3,3,2,2,3,5,5,2,2,1,1,4,1,45.51
Law,Industrial-Organizational Psychologist,2.7457792978496545,6,1,1,0,3,1,2,2,4,0,0,1,0,0,Arts,High School,31-35,4,1,33,Remote,Tier2_City,2,5,3,1,2,0,3,48.91,Healthcare,5,5,5,2,3,2,5,3,3,4,1,1,1,1,42.46
Education,Education Administrator,4.197877396108193,9,1,1,0,7,0,0,3,1,3,2,2,4,0,Arts,Masters,25-30,11,0,0,Remote,Tier1_City,3,4,0,3,5,4,1,42.04,Education,5,4,5,4,2,0,3,2,5,4,1,1,4,1,68.45
Art,Art Therapist,4.17179253594479,5,1,1,0,3,1,2,0,1,1,3,1,1,1,Arts,Bachelors,25-30,1,0,0,Hybrid,Tier2_City,3,2,3,4,5,2,2,4.49,Finance,3,4,5,1,4,1,5,2,5,1,1,1,2,4,40.5
Physics,Brand Manager,2.590221391148331,7,1,1,0,3,1,0,3,4,3,3,0,4,1,Science,Masters,36-40,6,1,25,Remote,Tier1_City,3,2,0,2,0,2,1,33.64,Healthcare,3,5,2,2,0,4,3,1,5,2,0,0,3,5,54.66
Marketing,Paralegal,3.669387515496554,7,0,4,0,5,0,3,2,4,1,2,2,1,1,Commerce,Bachelors,31-35,2,0,0,Office,Tier2_City,5,1,5,3,2,1,5,26.3,Education,1,5,4,2,4,5,4,3,4,2,1,1,4,3,49.93
Medicine,Microbiologist,2.6873864250073,2,1,1,1,5,1,0,3,4,1,2,3,3,0,Science,High School,25-30,10,0,0,Hybrid,Tier1_City,1,4,3,5,3,0,3,47.08,Education,2,2,3,3,1,0,4,3,5,4,1,0,3,2,61.69
Computer Science,Sound Engineer,2.6399839141283485,1,2,2,1,3,1,3,0,1,4,1,1,2,1,Science,Bachelors,18-24,0,1,37,Hybrid,Tier1_City,5,2,1,1,4,1,2,45.4,Healthcare,3,5,4,3,5,0,3,2,2,2,0,1,1,5,39.85
Music,Market Research Analyst,4.291608361494184,9,1,0,0,3,0,2,0,0,3,1,3,2,1,Arts,Bachelors,18-24,8,1,13,Remote,Tier1_City,5,5,3,3,2,5,4,49.44,Finance,2,5,2,2,2,5,5,2,1,4,1,1,2,3,48.0
Biology,Web Developer,2.614087904911668,4,2,0,1,9,0,2,2,2,1,0,2,4,1,Science,High School,18-24,4,0,0,Office,Tier1_City,1,5,3,3,4,1,2,43.51,Manufacturing,2,4,2,4,1,1,3,4,2,5,0,0,2,1,44.95
Architecture,Financial Advisor,4.378737559907144,4,2,1,0,1,0,3,2,3,3,1,4,0,0,Interdisciplinary,Masters,25-30,9,0,0,Hybrid,Tier3_City,3,1,1,5,1,2,2,28.7,Other,3,4,3,5,4,0,5,1,4,4,1,0,1,2,72.53
Finance,Construction Manager,4.635693306415925,8,2,4,1,2,1,0,1,0,1,3,3,4,1,Commerce,Bachelors,18-24,0,1,54,Hybrid,Tier1_City,2,2,2,4,1,0,5,36.6,Education,1,1,3,3,4,5,5,2,4,1,0,0,4,5,31.13
Art,Chemical Engineer,3.541571173556942,0,1,4,0,2,0,4,2,4,0,0,4,2,0,Arts,Masters,25-30,10,0,0,Office,Tier2_City,3,4,0,2,2,5,1,48.34,Tech,2,1,5,3,5,4,2,5,2,1,1,0,2,2,58.57
Business,Lawyer,4.110430275657419,5,2,4,0,9,1,2,3,4,0,0,0,4,1,Commerce,Bachelors,31-35,0,1,45,Remote,Tier2_City,3,1,5,5,4,2,1,30.17,Tech,1,1,2,1,1,2,3,4,2,4,0,1,3,4,39.44
Marketing,Microbiologist,4.55536170143276,3,1,2,1,9,0,3,0,2,2,0,3,4,0,Commerce,Bachelors,25-30,0,1,51,Hybrid,Tier1_City,5,1,3,2,1,5,4,42.48,Tech,1,5,5,5,0,4,1,2,2,2,0,1,1,2,33.57
Marketing,Marketing Specialist,3.592021794108172,3,1,0,1,7,1,4,0,0,4,2,0,4,1,Commerce,Bachelors,31-35,11,0,0,Hybrid,Tier1_City,2,3,2,4,2,2,5,47.28,Manufacturing,3,2,3,3,0,3,1,3,4,3,1,0,5,5,56.59
Music,Conductor,3.80712641162746,8,1,0,0,7,0,4,3,2,4,2,2,1,0,Arts,Masters,31-35,8,0,0,Hybrid,Tier2_City,1,1,4,3,4,2,2,29.82,Other,2,4,2,5,2,0,4,1,5,5,0,0,5,1,74.9
Education,Advertising Manager,4.425550122224666,1,2,3,0,7,0,0,1,2,1,0,4,1,1,Arts,Bachelors,18-24,12,0,0,Remote,Any,4,3,2,2,2,2,1,10.48,Education,1,3,2,5,5,1,5,4,4,3,0,1,4,1,55.41
Architecture,Forensic Psychologist,3.7588448096484406,1,0,3,0,6,0,3,1,3,2,1,0,1,1,Interdisciplinary,Masters,31-35,7,0,0,Remote,Tier2_City,1,3,4,1,5,4,1,10.31,Finance,2,2,1,1,1,5,5,5,5,5,1,0,3,2,61.07
Chemistry,Fluid Mechanics Engineer,2.518617846604539,7,0,0,0,4,0,2,4,4,2,3,3,0,1,Science,Bachelors,31-35,10,0,0,Hybrid,Tier2_City,2,2,0,1,4,3,3,8.42,Finance,1,3,2,2,2,3,2,4,2,5,1,0,1,5,70.47
Marketing,Entrepreneur,4.600017070222142,0,1,2,0,0,0,3,1,1,2,4,4,2,0,Commerce,Masters,25-30,12,1,38,Flexible,Tier3_City,1,5,4,5,1,0,2,25.39,Other,3,5,5,2,2,0,5,1,5,2,0,1,4,1,65.95
Law,Clinical Psychologist,3.440893928232972,2,2,2,1,2,0,0,4,3,3,1,4,4,1,Arts,Bachelors,18-24,14,0,0,Hybrid,Tier3_City,5,4,1,4,2,4,5,25.57,Manufacturing,1,3,1,3,3,0,4,1,3,5,1,0,4,2,61.88
Chemistry,Microbiologist,4.907273278632123,9,2,2,1,2,1,4,4,4,2,3,1,4,1,Science,Masters,25-30,12,0,0,Remote,Any,2,1,1,5,1,3,1,32.02,Other,3,1,2,1,5,2,3,4,1,1,1,0,1,5,60.03
Medicine,Psychologist,4.74021689282505,8,2,2,1,0,1,4,0,2,4,3,3,1,0,Science,Masters,36-40,5,1,30,Office,Tier2_City,4,2,2,5,2,5,5,25.7,Education,3,4,1,3,2,1,3,5,5,1,1,1,4,1,56.55
Business,Art Director,3.0926274060294143,3,0,1,0,1,1,4,2,2,2,2,1,4,1,Commerce,PhD,31-35,9,0,0,Hybrid,Tier1_City,4,4,1,5,0,3,2,48.73,Healthcare,2,2,2,3,5,4,4,4,1,5,1,1,4,4,60.3
Law,Software Developer,2.8669975316941585,7,2,1,0,4,1,2,4,3,1,2,4,0,1,Arts,Bachelors,18-24,14,0,0,Hybrid,Tier3_City,2,1,1,1,1,3,2,16.69,Healthcare,2,1,4,2,5,0,2,3,2,4,1,1,2,3,58.73
Music,Geneticist,3.696061600052385,5,0,4,0,2,0,0,0,1,1,1,0,3,0,Arts,Bachelors,31-35,14,0,0,Hybrid,Tier1_City,1,5,2,1,1,4,1,44.07,Education,2,4,5,1,2,3,3,4,1,3,1,1,5,2,36.35
Marketing,Risk Analyst,2.964343629724178,2,0,1,1,6,1,3,4,2,0,0,2,0,1,Commerce,High School,25-30,5,0,0,Hybrid,Tier2_City,4,5,3,5,3,0,4,7.72,Education,4,1,5,5,3,5,4,2,3,2,0,0,3,5,42.96
Engineering,Data Scientist,4.509470203584161,3,0,3,1,4,1,0,2,0,1,1,2,2,0,Science,Masters,25-30,5,1,56,Hybrid,Tier2_City,2,3,0,1,5,1,5,31.29,Finance,2,2,1,2,2,1,5,2,4,5,1,0,5,5,53.39
Music,Teacher,3.093584664437704,3,2,4,1,3,0,2,4,0,2,0,3,2,0,Arts,Bachelors,31-35,3,0,0,Remote,Tier2_City,2,3,4,4,1,3,5,33.47,Manufacturing,2,5,4,3,2,4,3,5,1,5,0,1,1,1,40.25
Architecture,Physician Assistant,4.759954314061635,4,1,4,1,2,0,0,4,0,0,4,0,2,1,Interdisciplinary,Masters,25-30,4,0,0,Office,Tier3_City,2,4,2,5,4,1,3,39.29,Manufacturing,1,3,1,3,5,5,4,2,4,5,0,0,5,4,51.19
Architecture,Forensic Psychologist,4.28785335060816,6,2,3,1,0,1,1,4,3,2,1,1,2,0,Interdisciplinary,Bachelors,36-40,9,0,0,Remote,Tier1_City,3,1,1,1,2,1,2,26.64,Other,4,5,1,4,2,3,2,2,4,1,0,1,5,2,51.13
Music,Music Therapist,3.7528911103222047,5,1,4,0,2,0,0,3,1,1,4,0,0,0,Arts,Bachelors,31-35,2,1,28,Remote,Any,1,3,4,2,0,2,2,12.27,Finance,4,3,3,1,1,1,3,4,5,1,0,1,5,3,37.22
Biology,Game Developer,3.92857090551911,1,0,2,0,5,0,3,0,3,1,3,3,0,0,Science,High School,31-35,2,1,13,Remote,Tier1_City,2,2,3,5,4,1,1,20.34,Tech,1,3,1,5,3,2,2,4,1,3,1,1,2,1,44.2
Architecture,Accountant,4.324138987403311,7,2,2,0,9,0,4,3,2,2,4,1,4,0,Interdisciplinary,PhD,18-24,9,0,0,Office,Tier1_City,2,3,5,5,4,5,1,15.79,Healthcare,2,2,2,5,0,3,1,1,5,2,0,0,5,2,73.78
Biology,Musician,4.162921393061951,7,0,0,0,0,1,1,4,2,2,1,1,3,1,Science,Masters,36-40,6,1,58,Hybrid,Tier2_City,3,4,0,4,4,5,1,22.7,Education,5,2,3,3,2,1,2,2,1,5,0,1,5,2,53.25
Psychology,Game Developer,3.764479515483599,2,1,0,1,7,1,2,1,4,2,3,3,0,1,Arts,PhD,36-40,4,0,0,Office,Any,5,2,0,3,4,2,3,27.91,Other,3,5,3,4,1,4,4,2,3,1,1,0,5,2,61.18
Architecture,Biochemist,4.325838793848014,5,1,3,0,8,0,0,2,4,3,2,2,2,0,Interdisciplinary,Bachelors,18-24,7,0,0,Office,Tier2_City,3,5,1,3,0,0,4,32.38,Healthcare,4,4,1,4,1,0,5,1,3,1,0,0,1,5,51.11
Art,Art Director,4.381509089520489,9,2,1,0,8,1,2,0,2,1,2,4,4,1,Arts,Masters,25-30,4,1,8,Remote,Tier2_City,2,2,3,4,3,0,1,42.72,Healthcare,1,4,3,1,1,5,3,1,5,4,1,0,3,4,54.46
Computer Science,Biochemist,2.9694192110148747,9,2,1,0,5,1,2,4,2,2,3,0,0,0,Science,Masters,25-30,11,0,0,Hybrid,Tier2_City,1,4,0,4,5,5,1,45.77,Other,5,5,5,3,3,1,2,5,2,5,0,0,5,5,67.04
Business,Fluid Mechanics Engineer,4.966754439257407,5,1,4,1,1,1,1,0,1,0,1,0,2,0,Commerce,Bachelors,31-35,3,0,0,Hybrid,Tier1_City,3,5,4,4,1,2,1,24.74,Manufacturing,3,3,3,3,3,3,3,1,4,5,1,1,2,1,36.41
Physics,Musician,3.671791334918834,7,0,4,1,5,0,1,2,4,4,0,0,0,1,Science,Masters,31-35,13,0,0,Hybrid,Tier2_City,2,1,4,3,4,0,3,7.17,Finance,5,2,3,3,4,4,3,1,4,2,1,0,1,3,63.16
Biology,Entrepreneur,4.595711564453599,5,1,0,0,9,1,3,2,3,3,0,3,0,0,Science,PhD,18-24,2,0,0,Remote,Tier1_City,1,4,5,4,1,3,5,40.46,Tech,2,5,2,1,2,5,4,2,1,4,1,1,4,2,50.94
Marketing,Cybersecurity Analyst,3.3759460494378635,8,0,4,0,8,0,2,4,1,2,1,4,4,0,Commerce,Masters,36-40,11,0,0,Flexible,Any,3,3,1,1,1,0,4,25.43,Tech,1,4,5,5,0,0,4,3,3,5,1,1,4,1,64.89
Architecture,Brand Manager,3.8892834369673976,8,2,0,1,6,0,2,3,1,1,2,4,0,0,Interdisciplinary,Masters,18-24,1,0,0,Office,Tier1_City,4,4,3,5,4,2,5,28.68,Other,3,3,3,2,0,4,1,5,5,1,0,1,2,4,49.62
Music,Architect,4.788064268332745,5,0,2,0,0,0,1,1,4,3,3,1,1,1,Arts,Bachelors,31-35,2,0,0,Hybrid,Tier1_City,1,4,4,5,3,5,2,31.0,Other,3,4,2,4,4,0,5,5,2,3,0,1,1,5,44.7
Art,Biologist,4.71495318585688,7,0,1,1,1,1,4,1,1,0,1,3,4,0,Arts,Bachelors,25-30,6,0,0,Office,Tier2_City,2,4,0,2,1,3,2,34.39,Finance,2,3,5,5,0,2,1,4,1,2,1,0,4,4,44.96
Computer Science,Geneticist,3.861322824375538,0,2,3,0,6,1,1,1,3,1,0,0,3,0,Science,PhD,25-30,7,0,0,Hybrid,Tier2_City,1,5,4,2,2,1,1,44.83,Healthcare,2,4,3,2,2,2,4,5,3,5,1,0,3,4,52.46
Marketing,Marketing Manager,3.738365963512596,2,1,4,0,8,1,3,4,3,4,0,0,1,1,Commerce,High School,18-24,14,0,0,Remote,Tier2_City,1,4,5,5,1,1,5,47.75,Finance,2,1,1,5,0,4,1,1,2,5,0,1,1,1,58.55
Physics,Surgeon,3.6720598612399256,1,2,2,0,7,1,2,4,3,3,2,0,0,1,Science,Masters,18-24,4,1,24,Hybrid,Tier1_City,2,1,0,1,5,1,3,47.19,Finance,1,3,3,5,2,0,2,5,2,1,0,1,5,1,54.92
Art,Urban Planner,4.0393900347956535,4,0,1,0,5,0,1,2,3,1,0,4,1,1,Arts,Masters,31-35,10,0,0,Remote,Tier1_City,4,4,3,3,4,5,4,41.04,Education,4,3,5,5,3,5,2,5,5,3,1,0,3,1,64.76
Medicine,Biologist,3.653718157493936,8,0,3,0,7,1,4,0,1,2,4,3,0,1,Science,Masters,25-30,0,1,58,Remote,Tier3_City,1,3,1,3,0,2,5,44.79,Education,5,3,3,5,3,0,3,4,5,1,1,0,3,4,47.09
Business,Human Resources Specialist,2.802949148236325,2,0,4,0,3,0,4,0,0,3,4,0,2,1,Commerce,PhD,18-24,2,1,26,Remote,Tier2_City,2,2,5,1,1,1,5,5.33,Healthcare,1,1,5,3,2,1,1,4,3,1,1,0,3,2,48.62
Education,Illustrator,4.752809181797751,4,2,4,1,8,0,0,0,2,3,3,2,4,0,Arts,Bachelors,18-24,3,0,0,Flexible,Tier2_City,1,5,5,3,3,0,4,42.91,Manufacturing,1,1,1,5,5,1,1,5,5,3,0,1,2,1,52.0
Medicine,Illustrator,3.910144152171781,9,1,4,0,9,1,1,0,3,0,3,2,1,0,Science,Bachelors,18-24,9,0,0,Hybrid,Tier2_City,5,3,1,4,2,1,5,6.4,Tech,5,4,3,2,2,2,4,2,1,1,1,1,2,5,42.19
Physics,Musician,3.347168085994784,0,2,2,0,9,0,4,1,4,3,1,4,3,0,Science,Bachelors,31-35,12,0,0,Office,Tier2_City,4,1,1,5,2,4,5,38.07,Education,3,2,5,2,3,2,1,1,4,1,1,1,4,1,59.78
Music,Nuclear Physicist,4.950024826670149,6,2,3,1,8,1,2,3,1,1,4,0,2,1,Arts,Bachelors,31-35,12,0,0,Remote,Tier3_City,5,4,2,5,0,5,4,10.96,Healthcare,5,4,2,4,2,0,3,1,1,1,1,0,4,5,49.69
Business,Graphic Designer,4.469363488324039,6,2,4,0,0,1,0,1,2,3,0,3,4,1,Commerce,Bachelors,18-24,11,0,0,Remote,Tier2_City,1,5,1,1,5,4,3,19.93,Other,2,3,3,1,4,0,4,1,1,3,1,1,4,1,49.46
Art,Inorganic Chemist,3.72704850872196,8,0,0,0,1,1,0,4,2,4,1,0,0,0,Arts,Bachelors,25-30,3,0,0,Flexible,Tier1_City,4,5,1,3,0,1,4,11.66,Finance,3,3,1,2,3,3,3,4,2,1,1,0,2,1,35.21
Marketing,Construction Manager,4.254613966036364,1,1,4,0,8,1,1,4,0,1,4,1,1,0,Commerce,Masters,18-24,11,0,0,Hybrid,Tier2_City,2,5,0,2,5,1,1,23.84,Education,1,4,2,2,0,1,2,1,3,3,1,1,1,3,59.72
Architecture,Zoologist,3.395043427763376,4,0,3,0,1,1,1,1,3,3,0,2,2,0,Interdisciplinary,PhD,36-40,0,1,39,Flexible,Tier1_City,5,3,5,2,1,4,1,22.35,Finance,5,5,3,2,3,0,4,2,3,5,1,0,5,2,47.36
Biology,Marketing Specialist,2.8385321326097697,0,0,3,0,0,0,0,0,2,4,3,2,2,1,Science,Bachelors,36-40,9,1,30,Remote,Tier2_City,4,2,3,3,4,5,1,5.26,Finance,1,2,5,2,0,0,5,1,2,5,0,1,5,4,55.86
Architecture,Art Director,4.277577993940646,0,2,2,1,3,1,1,4,2,1,3,0,4,1,Interdisciplinary,Bachelors,31-35,8,0,0,Flexible,Tier2_City,4,2,3,2,3,5,1,42.03,Education,1,1,4,1,0,2,3,4,1,1,1,1,1,5,46.47
Finance,Data Scientist,3.8311835884275753,6,2,3,1,8,0,0,3,4,2,1,2,0,0,Commerce,PhD,36-40,11,0,0,Hybrid,Tier1_City,1,1,4,1,2,1,2,43.15,Healthcare,5,2,2,1,4,4,5,2,1,4,0,1,2,2,57.91
Music,Geneticist,4.017696405640128,5,2,0,0,0,0,0,1,3,2,0,3,0,0,Arts,Bachelors,36-40,9,0,0,Remote,Tier3_City,5,3,1,1,0,5,3,40.01,Other,1,5,5,5,3,2,5,5,4,5,0,1,5,3,56.11
Architecture,Composer,3.838125544098877,4,2,2,1,4,1,3,0,0,1,4,3,4,1,Interdisciplinary,Bachelors,36-40,14,0,0,Office,Tier1_City,2,3,3,3,3,3,2,42.84,Tech,4,4,2,2,3,0,3,3,4,3,1,1,3,3,55.43
Education,Software Developer,4.051519521858089,6,1,2,1,4,1,0,1,2,1,1,0,4,1,Arts,Bachelors,25-30,14,1,33,Office,Any,3,3,3,2,5,5,5,38.29,Healthcare,4,4,3,2,4,1,4,2,3,5,1,0,3,1,53.12
Education,Game Developer,4.976041392746666,4,1,3,0,5,0,2,1,3,1,0,0,0,1,Arts,Masters,25-30,3,1,51,Remote,Tier1_City,1,4,5,1,4,4,5,47.06,Manufacturing,1,3,1,4,3,4,5,4,1,5,0,0,4,5,48.64
Law,Conductor,4.042899138645777,9,0,0,1,2,0,1,0,2,2,4,2,2,0,Arts,Bachelors,18-24,1,0,0,Flexible,Any,4,3,3,1,2,2,4,30.09,Manufacturing,3,4,1,4,0,3,4,2,4,1,0,0,4,2,44.47
Physics,Electrical Engineer,4.678725385692607,9,1,0,1,6,0,0,0,4,2,0,4,2,0,Science,PhD,25-30,12,0,0,Office,Tier2_City,5,3,3,4,2,4,1,30.38,Tech,3,5,2,4,5,5,5,2,2,3,1,1,3,5,59.03
Computer Science,Game Developer,3.980635804469748,3,2,3,0,5,0,3,2,3,4,2,0,2,0,Science,Bachelors,31-35,8,0,0,Hybrid,Tier1_City,3,5,0,4,5,0,4,43.42,Other,3,4,4,4,5,5,3,4,1,4,1,1,1,5,57.48
Music,Architectural Technologist,3.9623684406077153,2,1,1,1,4,1,2,4,4,1,4,2,0,0,Arts,Bachelors,18-24,13,1,14,Remote,Tier1_City,4,5,1,1,4,3,5,19.42,Manufacturing,3,4,3,5,2,2,1,3,5,3,1,0,3,4,73.64
Education,Marketing Specialist,4.306993076224634,4,0,4,0,0,0,2,3,1,1,1,4,2,1,Arts,Bachelors,25-30,3,0,0,Hybrid,Tier1_City,5,5,3,3,2,2,1,5.35,Finance,4,5,5,3,5,3,4,5,4,5,0,0,1,1,50.52
Music,Investment Banker,3.491717102165044,5,0,0,1,9,0,3,1,0,4,2,3,0,0,Arts,Bachelors,25-30,3,0,0,Remote,Tier1_City,5,3,0,5,4,1,3,38.24,Manufacturing,3,1,3,4,5,1,5,4,2,5,0,1,3,3,49.93
Medicine,Curriculum Developer,3.9159097158211376,5,2,0,1,7,0,4,2,2,4,4,4,3,0,Science,Masters,18-24,10,1,36,Hybrid,Tier1_City,3,3,2,5,2,0,5,14.97,Education,5,2,4,4,4,4,1,5,2,1,1,0,1,4,65.65
Biology,Physical Chemist,4.5571762968413765,9,2,4,1,0,1,1,0,3,4,0,0,1,0,Science,Masters,25-30,5,1,19,Office,Tier1_City,4,5,4,1,1,0,4,25.29,Finance,3,4,5,1,5,5,1,5,5,4,1,1,2,3,47.55
Biology,Judge,2.8341054669030985,3,0,4,1,1,1,4,1,3,0,4,2,3,1,Science,Masters,36-40,7,1,8,Office,Tier1_City,3,1,0,1,5,3,4,14.3,Healthcare,5,2,4,2,4,1,1,1,4,2,0,1,2,2,65.14
Psychology,Sound Engineer,2.700894325922905,7,2,2,0,1,1,1,4,3,0,0,3,4,1,Arts,Masters,31-35,4,0,0,Hybrid,Tier2_City,2,1,4,1,4,2,5,41.87,Other,4,2,3,5,2,5,3,2,3,4,1,0,2,4,54.92
Computer Science,Organic Chemist,4.557406517907529,0,0,3,0,2,0,1,4,0,2,0,0,1,0,Science,PhD,31-35,11,0,0,Remote,Tier1_City,1,2,4,3,3,0,2,48.04,Tech,5,3,3,2,0,4,3,3,2,3,1,1,2,3,55.84
Law,Musician,4.9684334504537695,7,0,2,1,3,0,1,0,2,0,0,4,0,1,Arts,Masters,25-30,7,0,0,Flexible,Tier2_City,1,4,2,4,1,2,3,5.59,Education,5,1,2,3,2,3,3,5,1,1,0,0,1,5,40.68
Medicine,Landscape Architect,3.6750311220486136,6,2,2,1,7,0,1,3,4,3,0,0,4,0,Science,Masters,25-30,0,1,56,Remote,Tier1_City,2,4,2,1,3,2,5,13.97,Education,1,2,4,5,3,3,3,5,3,2,1,0,3,5,43.24
Marketing,Physicist,4.97699456028233,7,2,0,0,2,0,0,1,1,2,4,0,3,0,Commerce,Bachelors,18-24,12,1,29,Remote,Any,4,2,2,1,5,5,5,11.91,Tech,5,3,1,3,2,1,4,2,2,2,1,0,1,1,49.96
Psychology,Art Therapist,3.124410719583725,0,0,2,0,3,0,1,0,4,2,4,1,3,1,Arts,High School,36-40,3,1,37,Hybrid,Tier2_City,3,5,0,2,2,0,4,34.64,Manufacturing,1,5,4,2,4,4,5,1,2,3,1,0,2,3,40.67
Marketing,Acoustics Specialist,3.3282082465482663,2,1,3,1,2,0,4,1,3,2,4,2,0,0,Commerce,Bachelors,18-24,0,0,0,Office,Tier2_City,1,5,2,3,3,2,1,23.15,Tech,3,5,4,1,1,5,4,1,5,1,0,1,5,4,48.99
Education,Interior Designer,3.1116155871595845,9,0,2,1,1,0,3,3,0,0,3,0,1,1,Arts,Masters,18-24,2,1,10,Flexible,Tier1_City,2,3,5,1,1,3,1,24.44,Tech,5,5,5,4,3,3,1,3,4,2,1,1,4,2,47.56
Law,Social Media Manager,4.6135600872534255,1,2,1,1,7,0,2,2,2,0,4,2,0,0,Arts,Bachelors,31-35,10,0,0,Flexible,Tier2_City,5,4,3,2,4,0,1,10.38,Manufacturing,5,5,5,2,5,4,5,1,4,1,0,1,1,5,54.98
Chemistry,Advertising Manager,4.024260834822417,0,2,4,1,0,1,2,0,3,0,4,3,1,0,Science,Bachelors,18-24,6,0,0,Flexible,Tier1_City,1,3,0,5,0,3,4,22.49,Healthcare,2,5,2,5,5,3,5,3,5,3,0,0,2,4,55.67
Marketing,Marketing Specialist,4.777745639635588,7,1,2,1,5,1,3,3,0,1,3,3,3,1,Commerce,Masters,25-30,0,0,0,Hybrid,Any,1,3,1,1,3,3,1,17.25,Other,3,3,1,4,5,0,1,3,5,3,0,1,5,1,51.21
Finance,Manager,2.7094985258093014,0,0,1,1,2,1,1,4,1,2,2,0,1,0,Commerce,Masters,18-24,4,0,0,Remote,Any,2,4,2,1,0,2,5,31.73,Tech,5,1,3,5,2,3,2,5,3,1,1,1,4,1,46.36
Finance,Accountant,2.630081832500058,3,0,4,1,2,1,1,2,0,2,2,2,1,0,Commerce,PhD,18-24,0,0,0,Hybrid,Tier2_City,3,5,0,2,5,2,2,13.21,Manufacturing,5,1,1,3,2,0,5,3,3,3,0,1,1,2,48.92
Computer Science,Art Therapist,3.6431632823418463,9,2,4,1,3,1,0,1,1,2,0,2,1,1,Science,Bachelors,18-24,5,1,8,Remote,Tier3_City,1,1,2,3,3,5,2,31.9,Education,2,3,1,5,0,1,4,4,5,3,1,1,4,5,48.87
Medicine,Astronomer,3.84594824790217,8,0,2,0,7,1,0,0,0,3,0,1,0,1,Science,Masters,18-24,8,1,44,Remote,Tier2_City,3,5,4,1,3,5,2,20.75,Tech,1,3,1,1,3,0,5,3,3,2,1,1,3,3,43.89
Art,Game Developer,3.562894227966148,0,0,1,1,8,1,3,3,3,3,4,0,3,1,Arts,Bachelors,31-35,2,0,0,Remote,Tier1_City,2,5,3,5,4,0,1,19.28,Other,3,4,2,3,0,1,1,3,1,1,0,1,4,3,42.83
Computer Science,Physician Assistant,4.47613828086014,2,0,2,1,7,1,2,1,3,1,1,3,0,0,Science,Bachelors,36-40,10,0,0,Remote,Tier3_City,5,3,4,1,2,5,2,17.36,Tech,2,2,2,2,4,0,1,4,5,3,1,1,1,5,57.34
Education,Marketing Manager,4.520510868815662,5,1,2,0,6,0,0,1,1,1,3,2,0,1,Arts,Bachelors,25-30,10,0,0,Hybrid,Tier1_City,1,3,2,5,1,1,1,34.67,Healthcare,3,5,1,4,4,1,4,2,4,4,0,1,5,2,54.29
Computer Science,Acoustics Specialist,4.941818394838462,7,0,1,1,3,0,4,3,4,3,4,2,2,1,Science,Bachelors,36-40,13,0,0,Hybrid,Tier2_City,3,3,0,4,1,0,5,29.43,Healthcare,3,2,3,4,0,3,1,1,4,4,1,0,4,2,75.31
Education,Music Therapist,2.606264187540804,4,1,4,1,8,0,1,2,0,0,1,2,4,0,Arts,Bachelors,18-24,11,0,0,Hybrid,Tier1_City,3,4,5,4,1,3,5,43.03,Education,1,4,3,1,3,5,5,1,5,3,0,0,4,1,50.95
Psychology,Market Research Analyst,2.577897684106891,4,0,3,0,5,1,1,4,0,2,2,0,0,1,Arts,Masters,25-30,14,1,51,Office,Tier1_City,4,4,3,5,5,5,4,14.36,Healthcare,1,1,3,5,0,2,3,1,4,5,1,0,1,3,66.57
Art,Psychologist,4.907087238202669,3,0,2,1,5,0,2,4,4,4,2,0,2,1,Arts,Bachelors,18-24,5,0,0,Office,Tier2_City,3,2,4,3,2,5,4,4.89,Other,4,5,2,2,5,5,4,2,2,4,1,0,3,1,57.25
Art,Dentist,4.462251660424863,2,0,2,0,6,1,1,1,0,3,1,4,3,1,Arts,Masters,31-35,3,1,44,Flexible,Tier1_City,3,3,3,1,0,5,3,11.56,Education,2,1,5,5,0,2,1,4,1,2,0,0,4,3,40.26
Psychology,Investment Banker,3.8430411894737926,3,0,2,0,0,0,1,2,2,2,0,1,2,1,Arts,Bachelors,25-30,5,1,32,Hybrid,Tier2_City,2,4,3,1,1,2,5,19.14,Tech,2,3,3,5,3,2,2,1,2,2,1,1,3,4,40.3
Music,Fluid Mechanics Engineer,2.574941215733919,5,0,0,0,4,0,2,3,3,3,4,2,0,1,Arts,Bachelors,31-35,1,0,0,Remote,Tier2_City,3,2,2,4,0,3,1,11.44,Manufacturing,3,2,5,1,4,0,2,1,5,2,1,1,5,4,49.22
Physics,Curriculum Developer,4.832583072655627,1,1,1,0,0,1,1,3,4,4,1,3,1,1,Science,Bachelors,31-35,3,0,0,Remote,Any,4,3,3,5,2,5,3,6.93,Healthcare,4,1,1,3,1,2,3,3,4,3,0,1,5,2,54.93
Psychology,Doctor,4.244466191695549,2,1,0,0,5,0,1,2,4,0,3,3,4,1,Arts,Bachelors,25-30,12,1,44,Office,Tier1_City,5,3,1,1,5,4,5,23.93,Education,4,4,3,3,0,1,5,2,3,3,1,0,2,3,61.34
Business,Forensic Psychologist,4.506981361818348,3,0,0,0,8,0,1,2,4,3,2,2,1,1,Commerce,Masters,31-35,12,0,0,Office,Tier3_City,4,1,1,1,2,4,1,34.82,Healthcare,3,1,1,1,5,0,3,1,2,4,0,1,3,2,64.11
Chemistry,Pharmacist,3.656600269176377,5,1,4,1,0,0,4,3,2,4,2,3,2,1,Science,Bachelors,36-40,6,1,38,Remote,Tier3_City,5,4,4,3,4,3,5,38.32,Healthcare,1,5,1,1,5,0,5,2,2,2,0,1,3,1,55.63
Finance,Actuary,4.566874149282038,6,2,4,1,4,0,0,4,4,4,1,1,0,1,Commerce,Bachelors,25-30,10,1,43,Flexible,Tier1_City,1,2,4,2,1,5,5,21.74,Finance,4,5,4,1,0,5,2,1,4,2,1,1,4,1,55.66
Marketing,Civil Engineer,3.142154747993996,4,1,2,0,4,0,1,1,4,3,4,3,0,0,Commerce,Bachelors,25-30,5,0,0,Hybrid,Tier3_City,5,3,5,4,5,1,1,25.47,Tech,2,2,1,5,2,3,1,1,3,5,0,1,1,1,63.23
Education,Architect,4.286492616127653,9,0,3,0,7,0,0,3,3,1,0,0,1,1,Arts,Bachelors,31-35,8,1,53,Remote,Tier1_City,5,4,0,4,4,1,5,38.51,Healthcare,1,3,1,5,3,1,3,1,5,3,0,0,1,1,53.7
Computer Science,Organic Chemist,2.704724099026184,9,2,3,1,5,0,2,2,0,1,3,3,0,0,Science,PhD,31-35,10,0,0,Hybrid,Tier1_City,4,2,2,2,1,0,5,19.58,Manufacturing,5,5,2,2,2,1,1,4,4,4,0,0,5,4,65.79
Medicine,Special Education Teacher,3.392144097978622,5,1,4,0,4,0,1,3,2,3,1,4,2,1,Science,Bachelors,18-24,6,1,37,Hybrid,Tier1_City,2,1,4,1,2,0,5,39.88,Other,4,4,1,1,4,3,2,3,1,4,1,1,3,2,51.51
Law,Advertising Manager,2.920486418453897,1,0,2,1,8,1,0,2,4,1,3,1,1,0,Arts,Masters,25-30,0,0,0,Remote,Tier3_City,2,2,0,3,2,5,4,48.47,Finance,3,2,3,5,2,4,5,4,1,3,0,1,5,3,43.41
Marketing,Biotechnologist,3.464548477445676,6,0,2,0,8,1,2,2,0,3,1,2,4,0,Commerce,Masters,25-30,5,1,26,Hybrid,Tier1_City,5,3,5,3,3,0,2,44.38,Education,2,5,2,3,3,3,1,2,5,2,0,1,3,3,52.72
Education,Teacher,4.844660674195632,4,0,1,0,5,0,4,0,2,1,2,4,3,1,Arts,PhD,25-30,10,0,0,Office,Tier1_City,4,5,4,4,3,2,5,24.32,Education,4,4,4,1,0,4,2,3,5,1,0,0,3,2,64.4
Marketing,Art Director,4.437079665667362,2,1,2,0,3,0,0,2,4,2,0,4,0,1,Commerce,Masters,18-24,2,1,22,Hybrid,Tier2_City,2,5,0,3,2,1,1,30.24,Manufacturing,3,1,4,3,0,2,4,5,1,4,0,1,5,2,48.44
Art,Digital Marketing Specialist,3.734718405107107,9,0,3,1,2,1,2,2,4,1,3,3,2,0,Arts,Masters,36-40,7,0,0,Remote,Tier1_City,2,1,2,2,2,3,5,36.67,Manufacturing,2,4,1,4,1,2,3,4,3,3,1,0,3,2,62.94
Law,Pharmacist,2.666623770267065,7,0,2,1,4,0,4,0,3,0,1,2,0,0,Arts,Masters,31-35,12,0,0,Flexible,Tier2_City,4,3,2,1,0,5,4,19.42,Other,4,2,5,2,4,5,5,3,5,2,0,0,4,2,60.18
Law,Sound Engineer,4.613960060666072,2,0,2,0,6,1,1,1,0,1,0,1,0,0,Arts,Masters,25-30,0,0,0,Remote,Tier1_City,5,3,4,2,0,5,4,40.56,Tech,2,5,4,4,0,2,5,1,1,2,1,0,3,1,24.06
Biology,Physical Chemist,4.612545768802153,7,1,2,0,9,0,2,1,2,4,0,0,3,0,Science,Bachelors,31-35,9,1,17,Remote,Tier1_City,1,4,1,5,4,4,5,23.54,Manufacturing,5,3,4,2,2,2,4,1,3,2,1,1,2,5,51.51
Biology,Analytical Chemist,3.994125887407132,7,0,0,0,2,0,1,1,2,4,4,0,4,1,Science,Bachelors,36-40,1,0,0,Hybrid,Tier2_City,4,5,3,4,3,1,3,42.8,Education,2,3,4,1,1,3,3,4,3,5,0,0,3,3,45.49
Education,Counselor,3.105580903140009,5,0,4,1,6,0,1,2,1,2,2,3,3,1,Arts,High School,18-24,2,0,0,Flexible,Tier2_City,4,4,4,3,3,1,2,14.97,Tech,3,4,3,2,1,2,1,3,5,2,0,0,1,3,43.91
Education,Risk Analyst,4.5009164428453925,1,1,3,0,0,0,3,4,3,1,2,4,2,0,Arts,Masters,25-30,13,1,41,Hybrid,Tier3_City,4,3,0,5,2,1,1,3.53,Manufacturing,4,4,5,5,4,3,2,4,2,5,1,0,2,3,69.71
Computer Science,Acoustics Specialist,4.328098288603821,4,0,0,1,3,0,1,3,4,2,0,2,4,0,Science,Masters,25-30,2,1,21,Office,Tier2_City,5,1,2,3,2,0,1,32.74,Manufacturing,3,4,1,3,1,5,2,5,3,3,1,1,4,3,45.98
Chemistry,Biotechnologist,2.839549694719742,6,2,4,0,6,1,4,4,4,1,3,1,1,1,Science,Bachelors,31-35,6,0,0,Flexible,Any,5,5,4,1,4,2,1,24.24,Education,5,5,1,5,5,1,1,2,5,2,0,0,3,4,64.4
Law,Musician,3.6779630702588113,2,1,1,1,3,0,2,1,4,1,1,1,0,0,Arts,Masters,18-24,12,1,12,Office,Tier1_City,4,4,2,1,5,3,1,5.81,Tech,1,3,2,1,3,1,1,4,3,3,0,0,5,4,58.47
Law,Pharmacist,3.111395618103219,4,2,2,1,7,1,3,2,2,2,4,3,2,1,Arts,Bachelors,40+,7,0,0,Remote,Tier2_City,2,1,4,1,5,0,4,25.92,Finance,2,3,3,4,2,0,3,2,4,4,1,0,5,2,69.67
Law,Clinical Psychologist,2.844213582967849,9,2,0,1,9,0,4,1,3,4,4,2,0,0,Arts,Bachelors,25-30,14,1,53,Office,Tier2_City,1,3,2,3,5,2,2,10.92,Finance,3,2,5,3,1,1,4,3,3,2,0,0,2,2,68.33
Education,Music Teacher,3.5135208000960274,7,0,0,1,1,0,1,3,1,3,0,4,0,0,Arts,PhD,25-30,8,1,7,Office,Tier3_City,3,2,1,5,3,1,5,32.6,Other,4,2,2,1,0,4,2,5,2,5,0,0,4,4,62.51
Finance,Marketing Manager,4.717892604271427,6,0,0,1,3,1,4,4,1,3,0,1,4,1,Commerce,Bachelors,25-30,6,0,0,Remote,Any,4,2,0,1,0,2,5,23.92,Tech,4,1,5,5,2,4,4,4,3,4,1,0,3,1,51.68
Medicine,Art Director,4.101188045712842,7,1,2,0,1,0,3,4,2,2,4,1,0,1,Science,Bachelors,18-24,7,0,0,Hybrid,Tier2_City,4,5,4,5,5,0,3,11.04,Manufacturing,1,5,4,5,4,2,3,3,2,3,0,1,4,2,64.72
Physics,Pharmacist,4.025871550859398,0,2,4,1,3,0,4,2,2,3,4,1,0,0,Science,Masters,31-35,10,0,0,Office,Tier1_City,5,1,2,3,1,1,5,22.36,Manufacturing,4,4,5,2,1,0,1,4,1,1,1,1,1,1,59.61
Finance,Quantum Physicist,4.517609890188334,7,0,4,0,1,1,4,2,2,2,0,0,1,1,Commerce,Masters,40+,14,0,0,Remote,Any,5,4,4,5,4,0,2,13.94,Tech,5,2,2,2,2,3,2,1,2,3,1,1,2,4,59.94
Education,Game Developer,3.679746431529338,9,0,1,1,7,0,3,0,1,0,0,2,1,0,Arts,High School,25-30,5,1,32,Remote,Tier1_City,3,1,0,3,5,3,5,33.7,Finance,1,1,3,4,0,3,4,3,3,4,0,1,1,1,41.72
Psychology,Legal Secretary,4.79301199941905,7,0,0,0,5,1,3,0,4,2,2,4,2,1,Arts,Masters,40+,1,0,0,Office,Tier1_City,5,5,4,3,1,1,4,16.87,Other,5,1,3,2,1,5,5,5,1,4,0,0,2,1,47.19
Education,Financial Advisor,3.771460080375114,1,0,4,0,8,1,4,4,1,2,3,0,1,1,Arts,Bachelors,36-40,0,1,47,Flexible,Tier2_City,5,3,3,4,5,2,5,41.63,Healthcare,2,3,4,2,4,3,2,3,1,4,0,1,5,1,47.56
Chemistry,Curriculum Developer,4.570058702584312,9,2,0,0,7,0,0,2,1,1,0,2,1,1,Science,Bachelors,25-30,2,0,0,Remote,Tier1_City,2,1,2,3,0,0,1,3.67,Education,5,5,1,2,4,2,5,5,1,2,0,0,4,2,25.65
Art,Interior Designer,3.8751176046819977,1,1,0,1,9,0,1,2,3,2,1,3,4,1,Arts,Bachelors,31-35,8,1,7,Hybrid,Tier1_City,1,5,0,3,0,4,1,21.96,Tech,2,5,2,4,4,0,5,1,1,3,0,1,4,1,45.66
Chemistry,Chemist,3.990948575749761,3,0,4,1,6,0,1,2,2,0,4,2,3,1,Science,Masters,25-30,12,1,48,Hybrid,Any,2,5,5,2,5,2,1,32.0,Other,5,4,1,1,5,5,5,1,3,3,1,0,4,2,63.55
Psychology,Construction Manager,3.3355874684513624,7,2,1,0,7,1,4,4,3,2,0,1,4,1,Arts,Bachelors,25-30,6,1,21,Office,Tier1_City,4,4,1,1,1,2,1,4.06,Healthcare,1,5,4,3,1,1,5,2,5,5,1,0,1,5,59.04
Psychology,Legal Secretary,3.110998716132854,8,1,3,0,4,1,0,1,4,2,4,2,4,1,Arts,PhD,18-24,1,0,0,Flexible,Tier3_City,2,3,3,4,4,1,4,13.14,Education,2,4,5,1,1,5,2,2,2,3,1,0,3,1,48.17
Business,Education Administrator,4.718771743537641,9,0,1,1,2,1,3,1,4,2,2,1,3,0,Commerce,Masters,31-35,13,0,0,Office,Tier1_City,3,1,4,4,1,5,4,18.39,Healthcare,5,5,5,1,1,1,5,1,5,5,0,0,3,5,67.07
Biology,Chemical Engineer,4.187410143926636,8,0,3,0,1,1,4,4,2,1,0,1,0,1,Science,PhD,18-24,0,0,0,Hybrid,Tier1_City,2,5,5,4,4,2,4,4.03,Healthcare,5,3,4,1,0,2,2,1,5,1,1,1,1,1,50.61
Computer Science,Dentist,4.442202284081427,2,0,2,1,5,1,3,4,4,1,3,2,4,0,Science,Bachelors,36-40,1,0,0,Flexible,Tier1_City,5,3,4,2,5,0,5,28.69,Education,4,1,3,5,5,5,1,2,2,2,0,0,5,5,53.22
Medicine,Game Developer,3.89280456720476,8,2,3,0,0,1,4,4,3,3,2,3,0,0,Science,PhD,36-40,14,0,0,Remote,Tier2_City,3,4,3,3,4,4,1,32.65,Healthcare,5,5,2,3,4,4,4,2,4,3,1,1,3,4,76.7
Physics,Art Therapist,3.968831677861585,3,0,4,1,7,1,2,0,2,3,2,4,3,0,Science,Bachelors,18-24,2,1,17,Remote,Tier1_City,3,5,1,1,2,3,3,13.69,Finance,4,5,4,3,2,3,4,2,2,1,1,1,5,5,40.05
Law,Interior Designer,2.611182334743626,1,1,1,1,0,0,2,4,0,0,1,2,1,1,Arts,Bachelors,25-30,13,0,0,Hybrid,Tier3_City,4,4,1,5,3,4,3,28.54,Other,5,3,4,5,5,5,4,3,4,3,0,1,4,5,58.08
Finance,Nurse,4.877708312659115,8,0,2,1,1,0,3,2,4,2,3,0,2,0,Commerce,Bachelors,25-30,5,0,0,Hybrid,Tier2_City,4,3,4,3,3,0,1,49.96,Tech,3,2,2,5,2,4,1,1,2,5,1,0,1,3,59.1
Psychology,Marketing Manager,2.708105850250568,2,0,1,0,4,0,4,1,2,1,2,0,3,0,Arts,Bachelors,25-30,11,0,0,Remote,Tier2_City,5,4,4,2,0,1,2,44.69,Other,4,4,3,2,1,1,4,4,5,1,0,0,4,5,53.7
Marketing,Landscape Architect,4.402704485001045,0,0,3,0,3,0,3,3,3,0,2,1,0,0,Commerce,Masters,25-30,8,0,0,Hybrid,Tier1_City,1,1,1,3,2,0,5,5.76,Finance,1,2,3,5,4,2,1,5,5,3,0,1,4,5,64.22
Law,Architect,2.625570037154632,9,0,4,1,0,0,2,0,1,0,1,3,3,0,Arts,Bachelors,25-30,7,0,0,Office,Tier1_City,3,4,1,3,3,5,3,9.01,Finance,1,1,2,4,4,5,3,5,2,1,1,1,5,2,40.76
Physics,Advertising Manager,4.806210794420489,4,2,0,1,5,0,0,1,0,2,3,2,2,1,Science,Bachelors,25-30,9,1,23,Flexible,Tier2_City,5,2,1,2,5,5,4,26.24,Education,2,2,1,5,1,4,2,5,1,1,1,0,3,1,43.6
Computer Science,Biotechnologist,4.2181917692400495,0,2,4,0,6,1,3,0,3,0,4,3,4,1,Science,Masters,18-24,8,0,0,Remote,Tier3_City,4,2,5,4,4,5,2,14.52,Education,1,1,5,2,0,1,3,5,4,2,0,1,1,3,64.02
Business,Psychologist,2.640469202680049,0,1,4,1,2,0,3,3,1,2,4,3,4,0,Commerce,Bachelors,18-24,10,1,24,Hybrid,Tier2_City,4,2,4,4,4,2,4,6.81,Education,2,4,2,5,2,2,1,2,1,2,1,0,1,2,63.11
Education,Conductor,3.3204265733643057,6,1,1,1,4,1,2,3,4,2,3,4,3,0,Arts,Masters,18-24,10,0,0,Remote,Tier2_City,1,2,2,1,1,1,2,14.96,Healthcare,1,3,3,4,2,5,5,2,4,1,1,0,2,3,67.09
Finance,Dentist,4.584640311107889,8,1,2,0,3,1,0,1,4,2,4,0,4,1,Commerce,Bachelors,31-35,7,1,30,Office,Any,3,1,3,1,1,5,2,5.88,Healthcare,4,1,1,5,3,3,1,1,5,3,1,0,3,1,59.04
Engineering,Biochemist,3.084732821912686,6,2,4,0,6,1,1,3,2,2,4,1,1,1,Science,Masters,40+,6,0,0,Hybrid,Tier1_City,3,5,1,4,4,3,5,27.91,Tech,3,4,4,1,1,5,2,2,4,1,1,0,4,5,55.17
Computer Science,Legal Analyst,4.256001269644295,0,0,1,1,0,0,2,1,0,3,3,4,4,1,Science,Masters,25-30,5,1,53,Flexible,Tier1_City,5,2,4,5,5,3,4,26.04,Healthcare,2,3,4,3,2,0,3,5,5,3,1,1,3,1,59.6
Education,Quantum Physicist,2.6599780197745497,1,1,1,0,8,0,2,0,3,0,2,2,0,0,Arts,Bachelors,25-30,7,0,0,Remote,Tier2_City,1,2,0,3,4,0,4,3.3,Tech,3,2,4,4,2,1,1,3,2,5,1,1,5,5,52.23
Biology,Credit Analyst,3.649078873544947,1,2,4,1,5,0,1,2,3,0,1,0,4,0,Science,Bachelors,18-24,5,0,0,Hybrid,Tier1_City,2,5,4,5,1,5,3,25.68,Finance,5,2,5,4,0,0,2,3,2,4,1,0,1,3,40.14
Music,Quantum Physicist,4.3259725501308575,3,2,0,0,2,0,0,0,1,1,4,4,2,0,Arts,Bachelors,25-30,1,0,0,Remote,Any,5,2,2,3,3,2,1,27.43,Tech,5,1,3,4,5,2,5,4,3,3,0,0,4,5,43.55
Education,Legal Analyst,3.353724790449742,6,2,4,0,7,0,4,2,3,4,1,3,0,1,Arts,Masters,18-24,12,1,36,Hybrid,Tier2_City,3,5,2,4,0,3,1,31.47,Tech,3,5,1,1,1,1,3,1,3,2,1,0,3,1,60.53
Architecture,Forensic Psychologist,2.9877198415478485,3,2,2,1,8,0,3,3,1,1,3,3,4,1,Interdisciplinary,Bachelors,31-35,8,1,49,Flexible,Tier1_City,5,2,5,1,1,4,3,48.59,Education,4,5,3,1,1,3,3,3,2,3,1,1,3,5,54.3
Engineering,Clinical Psychologist,2.912525665439232,0,0,3,0,9,0,4,4,4,1,2,4,1,0,Science,Bachelors,36-40,8,0,0,Flexible,Tier1_City,5,5,1,1,5,1,2,49.19,Healthcare,3,3,5,3,5,3,4,3,3,4,0,0,5,1,71.54
Engineering,School Counselor,3.654241370676216,4,2,1,0,5,0,4,4,0,2,4,1,2,1,Science,Bachelors,18-24,2,0,0,Hybrid,Tier2_City,5,5,3,5,3,4,3,27.77,Manufacturing,3,2,5,2,5,2,3,3,2,1,1,1,5,1,44.9
Chemistry,Psychologist,3.90046671474618,6,0,4,0,3,0,2,4,2,2,2,1,2,1,Science,Bachelors,31-35,8,0,0,Office,Tier2_City,5,3,4,1,3,3,3,42.72,Manufacturing,3,4,2,3,5,0,4,5,1,5,0,1,4,2,56.94
Business,Construction Manager,4.17611116345098,9,2,0,1,7,0,3,4,0,1,0,4,1,0,Commerce,Bachelors,18-24,1,0,0,Remote,Any,3,4,3,4,3,3,4,7.0,Education,2,3,3,4,2,5,3,5,5,5,1,1,4,1,54.81
Business,Graphic Designer,3.2840611376881506,9,1,2,0,5,0,0,0,0,2,0,3,0,1,Commerce,Masters,25-30,11,0,0,Remote,Tier2_City,1,5,0,5,2,0,3,27.96,Other,2,1,4,4,2,4,3,4,2,4,0,0,2,2,52.57
Engineering,Landscape Architect,4.493102502394817,4,1,3,1,9,0,4,0,3,0,3,2,4,1,Science,Bachelors,18-24,13,0,0,Flexible,Tier2_City,1,2,3,3,2,0,2,34.91,Other,3,1,2,4,4,3,1,2,3,5,1,1,1,4,62.24
Physics,Sound Engineer,2.6593922313624274,4,1,3,0,9,1,2,0,3,1,2,0,2,1,Science,Bachelors,25-30,2,1,41,Remote,Tier1_City,4,1,3,1,3,5,1,29.54,Other,4,3,3,3,3,0,5,2,3,3,0,1,2,2,39.96
Art,Cybersecurity Analyst,4.070443539651409,0,1,3,1,6,1,2,2,4,2,2,4,3,0,Arts,Masters,18-24,13,1,15,Remote,Tier1_City,4,5,1,2,5,1,5,13.84,Finance,5,4,2,2,5,0,5,2,3,1,1,1,2,5,61.71
Engineering,Clinical Psychologist,3.0229704249037384,8,2,2,0,7,0,1,0,4,4,4,2,0,0,Science,Masters,25-30,5,0,0,Hybrid,Tier2_City,2,2,0,1,4,5,3,5.94,Finance,5,2,2,2,2,1,3,3,1,3,0,0,3,4,55.19
Marketing,Curriculum Developer,2.832833442901052,6,1,0,0,7,1,1,2,0,2,2,2,2,0,Commerce,Bachelors,25-30,13,0,0,Hybrid,Any,1,5,5,3,5,0,3,21.17,Finance,5,2,1,3,1,4,3,2,1,4,0,0,3,2,52.73
Architecture,Judge,2.83543422101113,5,1,0,0,8,0,4,2,0,0,1,0,4,0,Interdisciplinary,Bachelors,25-30,3,0,0,Remote,Tier2_City,5,3,2,5,2,2,4,33.44,Tech,1,4,2,4,4,2,4,2,1,2,1,0,4,2,33.33
Education,Data Scientist,3.246413645865287,0,0,4,1,0,1,3,4,2,0,4,0,3,1,Arts,Bachelors,31-35,7,0,0,Office,Tier2_City,4,1,3,3,1,1,4,49.61,Healthcare,4,2,5,3,0,3,5,5,2,5,1,0,3,3,58.8
Architecture,Market Research Analyst,2.675831059231313,4,1,0,0,3,0,2,0,2,2,1,1,3,0,Interdisciplinary,PhD,36-40,0,0,0,Hybrid,Tier2_City,5,1,0,2,2,2,3,14.12,Finance,2,5,4,3,1,5,1,5,5,4,1,1,3,2,50.34
Psychology,Investment Banker,4.422308332569629,0,1,2,0,9,0,2,1,1,1,2,0,2,0,Arts,Bachelors,25-30,12,0,0,Hybrid,Tier2_City,2,2,0,4,4,5,3,46.14,Manufacturing,5,5,1,5,4,4,5,2,1,1,0,1,1,4,44.24
Physics,School Counselor,2.8345657967070723,7,2,0,0,6,0,1,2,4,3,2,4,4,1,Science,PhD,18-24,5,1,32,Remote,Tier1_City,1,4,2,1,0,0,2,6.21,Tech,2,4,2,5,5,0,2,5,3,2,0,0,3,5,62.48
Psychology,AI Researcher,2.5423955523451127,2,1,1,1,2,1,0,0,2,2,2,0,2,1,Arts,Masters,25-30,1,1,48,Hybrid,Tier3_City,3,3,1,5,2,1,1,46.76,Finance,2,5,1,1,1,4,5,5,3,1,1,0,5,2,32.58
Physics,Data Scientist,2.9850788744615384,2,0,0,0,6,0,0,2,0,3,3,0,1,0,Science,Bachelors,36-40,5,0,0,Office,Tier2_City,2,4,0,4,5,5,1,42.12,Finance,2,3,4,1,5,1,1,3,1,3,1,0,4,5,41.78
Marketing,Graphic Designer,4.897096805918231,7,1,3,0,3,0,1,2,4,3,1,4,0,0,Commerce,High School,25-30,13,0,0,Flexible,Tier1_City,3,1,2,3,5,3,5,3.98,Other,2,2,4,3,1,1,5,4,5,2,1,1,1,1,61.17
Medicine,Lawyer,3.368420988171457,5,2,4,1,9,0,2,3,2,3,3,0,4,1,Science,Bachelors,25-30,0,1,16,Flexible,Tier2_City,1,1,4,5,3,5,1,17.01,Other,3,3,1,5,1,0,1,5,5,5,1,0,2,2,52.11
Finance,Lawyer,4.920367329348798,7,0,2,0,8,0,0,0,1,1,4,2,4,0,Commerce,Bachelors,18-24,14,1,13,Hybrid,Tier1_City,3,4,0,4,3,4,5,5.39,Healthcare,2,4,3,4,2,0,4,4,5,2,1,1,5,5,58.53
Psychology,Education Administrator,3.213642115269287,7,0,4,0,8,0,4,3,2,3,4,3,2,1,Arts,Bachelors,25-30,1,0,0,Flexible,Tier2_City,1,5,4,5,3,3,4,49.79,Healthcare,1,5,4,1,2,2,3,1,3,3,1,1,5,1,54.9
Physics,Physical Chemist,4.576627124288996,2,2,0,1,3,0,1,0,3,4,3,3,1,0,Science,Masters,25-30,8,1,21,Remote,Tier2_City,5,4,4,2,0,2,5,23.11,Tech,2,3,5,4,3,3,4,2,2,5,0,0,2,4,60.0
Marketing,Civil Engineer,4.16414013029846,1,0,2,1,2,0,4,4,1,0,1,4,3,0,Commerce,PhD,36-40,5,0,0,Remote,Tier1_City,2,4,0,2,4,3,5,34.12,Manufacturing,5,3,5,4,0,3,3,4,4,3,1,1,5,1,66.51
Business,Data Scientist,4.314885495701056,7,2,4,0,3,1,3,4,3,4,2,3,4,1,Commerce,Masters,36-40,7,0,0,Office,Tier3_City,5,5,2,1,1,5,1,14.01,Education,2,1,2,1,0,4,4,4,1,3,0,0,3,1,60.69
Physics,Digital Marketing Specialist,4.1960557505249145,3,0,2,1,2,1,4,4,2,0,2,1,1,0,Science,Masters,18-24,6,0,0,Remote,Tier2_City,1,5,4,1,5,3,3,46.89,Other,5,3,3,3,2,3,4,1,1,5,1,1,4,2,61.65
Biology,Manager,2.756193958488273,0,1,0,0,1,0,4,2,4,2,1,1,4,0,Science,Bachelors,25-30,8,1,22,Remote,Any,1,5,1,2,5,4,4,15.89,Manufacturing,2,5,3,5,1,0,3,2,4,5,0,0,5,2,67.24
Physics,Cybersecurity Analyst,4.206435245575657,4,1,2,1,7,1,0,2,0,4,1,2,3,0,Science,Bachelors,18-24,8,0,0,Flexible,Tier3_City,5,3,3,5,4,5,2,15.23,Other,4,2,2,1,1,4,1,2,4,3,1,1,2,5,48.11
Medicine,Chemist,2.5897238426210047,6,0,1,0,5,1,1,3,3,0,4,1,2,0,Science,Bachelors,25-30,10,0,0,Office,Tier2_City,5,1,5,2,0,4,5,17.79,Healthcare,3,2,4,2,5,3,2,2,3,3,0,0,1,1,54.91
Marketing,Education Administrator,3.0744496542388102,6,0,1,0,8,1,1,1,3,3,4,4,2,1,Commerce,Masters,36-40,3,1,40,Remote,Tier1_City,5,1,4,1,3,3,5,24.74,Healthcare,5,2,1,2,4,2,3,5,3,5,1,0,3,1,61.32
Law,Curriculum Developer,2.750180333778804,5,0,3,1,3,0,3,4,4,1,1,2,4,1,Arts,PhD,25-30,6,1,41,Office,Tier3_City,2,5,4,2,4,4,5,3.87,Education,1,5,3,4,5,0,1,3,1,3,0,1,3,1,61.95
Finance,Special Education Teacher,3.006465945754531,7,0,4,0,4,0,0,4,3,2,2,3,3,0,Commerce,Masters,25-30,4,1,58,Office,Tier2_City,2,5,3,2,1,3,3,31.1,Manufacturing,2,2,3,2,5,0,1,3,2,1,0,1,3,3,45.37
Marketing,Pharmacist,3.3683088600967444,5,1,3,0,4,0,2,0,1,2,4,3,2,1,Commerce,Bachelors,18-24,6,0,0,Flexible,Tier2_City,1,3,2,5,3,1,2,4.49,Manufacturing,5,2,4,4,4,3,1,5,1,1,1,1,5,5,45.19
Biology,Chemist,3.2917493731931966,9,0,4,0,4,0,2,1,2,3,4,4,3,1,Science,Bachelors,36-40,3,1,54,Hybrid,Tier1_City,4,3,1,4,1,3,1,28.34,Education,3,4,1,5,4,2,5,2,1,1,0,0,2,2,48.06
Psychology,Financial Controller,4.385936920681381,7,2,4,1,4,1,1,1,3,4,3,3,1,0,Arts,Masters,31-35,11,0,0,Office,Tier2_City,5,2,1,1,2,0,4,24.52,Healthcare,2,4,5,1,5,5,3,1,1,1,1,1,1,4,57.46
Architecture,Animator,4.505676547108561,3,1,3,0,7,0,2,1,3,4,0,2,3,1,Interdisciplinary,Bachelors,25-30,9,0,0,Office,Tier1_City,3,4,4,5,1,4,3,14.4,Tech,3,1,3,1,0,2,3,5,3,3,1,0,1,1,54.72
Art,Chemist,2.850809682002451,4,1,3,1,3,1,3,2,1,4,0,2,3,0,Arts,Masters,18-24,10,0,0,Office,Tier1_City,3,1,0,2,3,4,2,18.5,Manufacturing,1,1,4,5,0,5,4,5,1,3,1,0,3,4,57.72
Computer Science,Legal Secretary,4.664373025136615,9,1,0,0,5,0,3,3,0,2,4,0,2,0,Science,Masters,25-30,10,0,0,Hybrid,Any,3,1,0,2,2,2,4,36.17,Finance,5,3,3,4,4,1,3,4,2,2,0,1,3,4,55.32
Architecture,Digital Marketing Specialist,4.86682743014307,8,1,2,1,1,0,0,0,1,4,2,2,1,0,Interdisciplinary,Masters,40+,0,0,0,Hybrid,Tier2_City,5,3,5,4,3,2,1,3.45,Manufacturing,1,3,5,3,4,0,1,5,2,2,0,1,5,2,40.61
Music,Human Resources Specialist,3.770395066204845,3,2,4,0,7,0,0,0,4,4,3,3,0,1,Arts,Bachelors,25-30,3,1,31,Hybrid,Tier2_City,4,4,4,1,5,0,4,17.88,Manufacturing,3,3,2,2,4,0,2,2,2,2,0,1,1,5,44.8
Engineering,Artist,2.9724072712472887,6,0,2,0,5,1,1,0,3,4,0,0,3,0,Science,Bachelors,25-30,14,0,0,Flexible,Tier2_City,4,3,5,1,3,4,5,34.97,Manufacturing,4,1,4,5,0,3,2,5,1,2,1,0,4,3,50.81
Psychology,Music Teacher,3.205033431120965,3,0,4,1,8,0,2,2,0,3,4,0,0,1,Arts,Bachelors,25-30,12,0,0,Hybrid,Tier1_City,2,2,0,3,2,4,5,10.16,Healthcare,4,2,1,2,2,3,4,3,4,3,0,0,2,5,56.75
Law,Lawyer,4.523941872767944,8,0,4,0,1,0,3,2,0,2,4,3,2,0,Arts,Bachelors,31-35,9,0,0,Remote,Tier3_City,4,2,1,1,1,2,3,29.34,Finance,5,3,2,3,5,2,3,3,1,2,1,0,1,4,51.89
Medicine,Web Developer,3.527139940507343,9,2,3,1,1,0,1,0,2,3,4,2,3,1,Science,Bachelors,25-30,14,0,0,Office,Tier1_City,3,2,1,4,5,2,4,10.94,Manufacturing,2,2,1,4,5,0,2,5,4,3,0,1,2,5,60.92
Art,Construction Manager,3.390186849297403,0,1,3,1,3,0,3,2,3,2,4,2,1,1,Arts,Masters,18-24,2,0,0,Remote,Tier3_City,3,3,3,3,0,3,5,10.27,Tech,1,2,5,2,5,3,3,1,1,1,1,0,4,3,46.94
Psychology,Inorganic Chemist,4.680144633004639,8,1,2,0,5,0,2,4,4,0,0,2,3,0,Arts,Masters,25-30,8,1,47,Hybrid,Tier2_City,5,4,1,3,0,5,3,39.3,Other,4,1,1,4,5,2,4,4,2,3,1,1,1,3,52.66
Marketing,Zoologist,2.9272816545048816,7,1,2,0,2,0,0,4,2,1,0,4,3,0,Commerce,Bachelors,31-35,4,1,12,Remote,Tier1_City,2,5,5,2,0,4,3,15.53,Other,4,4,3,3,1,0,3,5,4,2,1,1,2,3,45.37
Physics,Education Administrator,4.420168018175329,5,2,4,1,1,1,4,3,1,0,4,0,4,1,Science,Bachelors,31-35,3,1,15,Hybrid,Tier1_City,1,1,2,2,0,4,3,20.66,Finance,2,4,5,4,5,5,4,2,2,3,1,1,3,4,42.91
Art,Chemical Engineer,4.329466285153309,6,2,0,1,5,0,4,2,4,4,0,0,0,0,Arts,Bachelors,36-40,7,0,0,Flexible,Tier3_City,2,5,1,1,4,3,1,37.31,Education,1,5,2,3,5,1,5,1,1,3,1,1,1,5,51.95
Chemistry,Biochemist,4.897995935466241,9,2,3,1,5,1,2,2,2,3,3,4,4,0,Science,Bachelors,25-30,14,0,0,Office,Tier2_City,1,4,4,3,0,4,5,11.44,Tech,3,4,3,1,2,0,2,2,3,5,1,1,4,2,60.31
Psychology,Special Education Teacher,2.80322004512785,0,1,0,0,0,1,3,0,1,1,2,0,0,0,Arts,Masters,18-24,4,0,0,Remote,Tier2_City,2,3,5,2,2,0,5,27.99,Education,4,3,3,2,0,1,4,2,4,2,1,0,2,3,42.44
Psychology,Legal Consultant,2.619765972903007,3,2,0,1,0,0,2,0,1,1,1,3,3,0,Arts,High School,40+,2,1,33,Flexible,Tier1_City,4,3,0,4,0,2,2,46.14,Manufacturing,5,1,5,2,0,0,4,4,1,4,1,1,1,2,31.44
Chemistry,Music Therapist,3.8526256657829454,6,0,3,1,0,0,3,3,1,0,3,2,0,0,Science,Bachelors,25-30,1,0,0,Hybrid,Tier3_City,2,3,0,2,3,2,1,29.03,Healthcare,5,2,1,3,4,2,4,4,2,4,1,1,4,2,41.93
Chemistry,Interior Designer,3.245544294299347,0,2,0,0,6,1,4,4,1,0,4,3,2,1,Science,Bachelors,31-35,14,0,0,Hybrid,Tier1_City,5,2,1,2,0,5,5,5.3,Manufacturing,3,1,1,3,2,0,4,3,5,3,1,0,3,4,67.05
Chemistry,Quantum Physicist,3.303752496960879,5,0,2,0,2,1,2,1,2,2,1,3,3,0,Science,Masters,31-35,7,0,0,Hybrid,Tier2_City,1,2,1,3,1,2,5,30.72,Manufacturing,2,5,2,5,0,3,4,2,3,5,1,0,5,3,60.95
Engineering,Accountant,4.642159810151561,4,1,4,1,6,1,2,2,2,3,2,3,0,1,Science,Masters,25-30,11,0,0,Flexible,Tier1_City,4,2,0,3,2,1,2,7.24,Education,2,5,5,3,3,2,4,5,5,3,0,0,3,4,66.74
Computer Science,Judge,3.69086542777184,5,0,0,1,3,0,1,1,2,1,0,0,3,1,Science,Bachelors,18-24,1,0,0,Remote,Tier1_City,4,5,0,5,2,0,4,16.26,Manufacturing,4,5,2,3,2,1,3,2,5,2,0,0,1,4,37.49
Chemistry,Physical Chemist,2.5211630558542235,4,2,3,0,2,1,3,2,3,1,4,0,3,0,Science,Bachelors,31-35,13,0,0,Office,Tier2_City,2,1,1,4,5,0,4,42.93,Tech,4,2,4,4,2,0,1,3,3,1,0,1,1,5,61.1
Psychology,Chemist,3.720797870370325,3,0,2,1,4,1,3,2,4,3,3,0,2,0,Arts,Masters,36-40,7,1,52,Hybrid,Tier1_City,4,3,2,3,4,3,1,3.52,Healthcare,4,5,5,4,0,5,4,2,2,3,1,0,5,4,65.49
Law,Fluid Mechanics Engineer,3.8780833705271,2,2,0,0,1,1,4,3,0,4,3,2,3,1,Arts,PhD,25-30,4,1,14,Remote,Any,3,3,2,1,3,1,3,6.62,Education,3,5,4,2,1,1,1,4,5,4,1,0,5,5,67.87
Computer Science,Composer,4.555360493500334,4,0,0,0,5,0,0,3,4,4,4,2,1,1,Science,Bachelors,25-30,7,0,0,Flexible,Tier2_City,3,5,0,4,2,4,2,20.08,Finance,3,5,2,4,0,3,5,3,5,3,1,0,2,5,65.35
Computer Science,Financial Analyst,4.077288858832239,1,2,4,1,0,0,0,0,1,2,3,2,3,0,Science,Masters,18-24,4,0,0,Hybrid,Any,3,1,3,4,1,5,2,49.97,Other,4,2,4,4,2,5,5,1,1,2,0,0,5,3,37.55
Physics,Chemical Engineer,3.248268810824713,7,1,0,0,8,1,4,4,1,1,2,4,0,1,Science,PhD,18-24,0,1,23,Office,Tier1_City,2,1,2,3,0,0,5,16.72,Manufacturing,2,5,4,2,3,2,2,2,3,2,1,1,5,2,52.27
Psychology,Organic Chemist,2.9795518941670167,3,0,2,1,1,0,0,3,1,0,1,2,3,0,Arts,PhD,25-30,11,0,0,Remote,Tier1_City,1,5,4,4,2,1,5,10.39,Other,1,3,3,1,2,1,4,2,4,4,1,0,5,3,59.33
Business,Biomedical Engineer,4.322185052530049,5,2,1,1,9,0,3,4,0,3,0,4,4,0,Commerce,Masters,25-30,12,0,0,Office,Tier2_City,2,3,5,3,1,1,2,28.82,Education,4,1,3,5,0,5,2,4,5,4,1,1,3,5,68.84
Architecture,Dentist,3.650539959635789,8,2,1,1,9,0,3,0,0,1,4,0,1,0,Interdisciplinary,Masters,40+,10,1,15,Office,Tier1_City,5,4,0,2,0,0,3,27.4,Other,2,5,2,4,5,4,2,1,1,5,0,1,2,1,52.22
Biology,Landscape Architect,4.2888743534185725,7,2,1,1,6,1,0,0,2,4,3,2,4,0,Science,Bachelors,31-35,13,0,0,Hybrid,Tier2_City,4,4,2,5,4,3,4,24.13,Manufacturing,2,5,2,1,4,5,2,2,3,5,0,1,5,2,59.34
Marketing,Civil Engineer,3.1456308526837407,3,2,3,1,1,1,2,1,0,2,4,2,1,1,Commerce,Masters,31-35,10,0,0,Hybrid,Tier2_City,3,1,1,2,2,1,1,47.49,Manufacturing,5,1,1,5,1,0,2,2,4,1,0,1,2,2,60.01
Biology,Legal Secretary,3.2597883704612114,6,1,2,1,0,0,1,4,0,4,0,4,4,0,Science,Bachelors,25-30,1,0,0,Flexible,Tier3_City,2,1,3,3,2,2,4,16.17,Education,1,5,4,2,2,1,3,1,4,4,0,0,5,1,46.94
Architecture,Financial Analyst,4.381718563745073,2,2,3,0,5,1,2,1,2,4,4,0,0,0,Interdisciplinary,Masters,18-24,13,0,0,Office,Tier1_City,2,3,5,3,1,1,1,16.79,Tech,4,5,1,4,3,4,4,4,5,5,0,0,2,3,68.85
Psychology,Risk Analyst,3.678041432680285,7,2,3,1,8,0,4,4,0,2,2,3,3,0,Arts,Bachelors,40+,5,0,0,Hybrid,Tier3_City,4,1,5,2,5,4,3,9.59,Finance,1,3,1,4,3,4,3,5,2,4,0,0,2,1,54.83
Medicine,Physical Chemist,2.71932525904216,7,1,4,0,3,1,3,4,4,3,1,2,1,1,Science,Masters,25-30,2,0,0,Office,Tier2_City,2,5,1,1,3,0,2,35.77,Manufacturing,4,4,5,3,3,3,2,1,3,3,1,0,5,1,57.26
Architecture,Artist,3.612445874484432,2,0,3,0,0,1,3,0,2,4,4,3,4,0,Interdisciplinary,Masters,18-24,7,0,0,Office,Tier2_City,3,4,5,1,4,4,3,18.1,Tech,1,2,1,4,1,1,4,4,1,5,0,1,5,3,67.55
Finance,Mechanical Engineer,3.991245236815608,6,1,0,0,6,0,4,3,2,0,1,4,0,1,Commerce,Bachelors,25-30,4,0,0,Remote,Tier1_City,4,4,1,1,3,3,2,40.73,Manufacturing,1,2,1,4,5,3,5,2,3,4,1,0,2,1,55.76
Education,Pharmacist,2.506564638577962,7,0,3,0,5,0,4,1,2,2,1,3,3,1,Arts,Masters,36-40,2,0,0,Hybrid,Tier2_City,1,1,3,3,2,5,5,48.67,Manufacturing,2,1,4,1,2,0,3,1,1,4,0,0,1,1,48.01
Architecture,Financial Controller,3.600205933644267,1,0,4,1,8,1,1,1,4,0,0,1,2,0,Interdisciplinary,Bachelors,36-40,11,0,0,Flexible,Tier3_City,3,5,0,4,3,2,1,5.05,Tech,1,3,1,1,4,5,5,4,5,3,1,1,2,5,52.49
Music,Mechanical Engineer,3.687277020910772,6,2,0,1,6,0,1,3,0,4,1,3,3,1,Arts,Masters,18-24,9,0,0,Flexible,Tier3_City,5,1,5,3,0,0,5,49.68,Manufacturing,1,2,4,4,0,2,4,2,3,4,0,0,3,4,56.78
Psychology,Artist,3.0436747648502704,5,1,4,0,5,0,4,3,2,1,3,4,2,1,Arts,Bachelors,36-40,6,0,0,Office,Tier1_City,5,1,1,4,4,1,2,14.94,Finance,4,1,4,5,5,4,2,3,5,5,0,1,4,3,69.09
Chemistry,Illustrator,4.513248116981344,2,0,4,0,0,0,2,2,4,4,1,0,1,1,Science,Bachelors,25-30,13,0,0,Remote,Tier2_City,4,5,5,2,3,2,1,22.75,Other,2,1,1,2,2,1,4,4,2,5,0,0,2,5,58.91
Chemistry,Actuary,3.2201888445634985,6,0,3,0,2,0,4,4,4,1,2,2,3,1,Science,PhD,18-24,7,0,0,Flexible,Tier1_City,3,5,0,5,0,1,1,39.55,Education,1,1,4,1,2,0,2,4,1,1,1,1,2,3,58.38
Computer Science,Surgeon,3.421809857218169,2,1,0,0,4,1,2,3,1,4,3,0,3,0,Science,Bachelors,36-40,3,0,0,Hybrid,Tier3_City,3,2,0,4,1,3,5,34.27,Other,2,2,2,5,4,1,5,4,2,1,0,1,1,1,45.32
Architecture,Accountant,3.3969346224661674,3,2,1,1,7,1,1,1,4,4,1,4,1,1,Interdisciplinary,Masters,36-40,12,0,0,Remote,Tier2_City,3,4,0,1,3,5,1,39.59,Tech,2,4,2,4,1,4,4,2,1,5,0,0,5,5,66.97
Music,Web Developer,2.548918721697233,1,0,4,0,5,0,3,0,4,3,4,1,1,0,Arts,Bachelors,25-30,12,0,0,Office,Tier3_City,5,1,5,3,4,0,2,24.92,Other,3,1,4,3,0,2,4,5,2,1,1,0,1,2,59.69
Business,Special Education Teacher,4.505427207204869,1,0,1,1,5,0,4,3,0,2,1,3,1,1,Commerce,Bachelors,25-30,10,0,0,Flexible,Tier2_City,4,3,1,2,0,3,2,46.06,Healthcare,4,5,2,1,0,0,4,5,3,1,1,1,1,2,52.13
Engineering,Nuclear Physicist,2.9814008475098275,3,1,1,1,3,1,3,4,1,2,1,1,0,0,Science,Bachelors,36-40,8,1,29,Remote,Tier1_City,5,1,0,1,3,3,5,40.13,Manufacturing,3,4,5,1,0,4,3,3,1,3,1,1,1,1,47.48
Engineering,Microbiologist,2.930721908293867,6,2,2,1,0,1,2,3,1,2,2,4,3,1,Science,Masters,31-35,5,0,0,Flexible,Tier2_City,2,1,1,2,1,5,3,17.53,Education,2,4,3,3,5,0,1,1,5,2,0,1,1,2,54.92
Marketing,Marketing Specialist,4.108011396861061,1,2,4,1,0,0,2,4,3,3,4,4,2,1,Commerce,Bachelors,36-40,13,0,0,Flexible,Tier1_City,1,3,0,5,3,3,2,47.58,Finance,1,5,2,4,2,5,3,3,1,1,1,0,1,1,64.62
Business,Surgeon,4.99383430876496,8,1,2,1,0,1,2,0,3,0,1,1,0,1,Commerce,High School,25-30,0,0,0,Remote,Tier1_City,5,4,4,3,0,3,2,48.17,Finance,4,2,1,1,4,5,5,1,4,2,1,0,2,4,26.13
Engineering,Cybersecurity Analyst,3.985807289668797,8,2,2,0,5,1,4,4,1,4,1,3,1,0,Science,Bachelors,40+,4,1,41,Flexible,Tier1_City,4,2,1,3,3,1,1,22.51,Healthcare,5,2,2,4,4,1,2,1,1,1,0,0,4,5,51.24
Computer Science,Credit Analyst,4.544797511208387,3,2,2,0,6,1,0,1,3,0,2,4,4,0,Science,High School,40+,4,0,0,Flexible,Tier3_City,5,5,4,5,4,4,1,33.64,Other,4,3,5,5,1,4,5,3,1,2,1,1,1,3,41.12
Psychology,Teacher,4.0008742525602825,7,0,1,0,2,1,4,4,4,0,0,4,3,0,Arts,PhD,18-24,6,0,0,Remote,Tier1_City,2,2,0,3,2,1,2,41.29,Finance,3,2,5,1,4,4,4,3,4,4,1,0,1,4,68.64
Art,Physicist,3.170358227619557,1,0,4,1,5,1,1,1,1,0,0,0,2,0,Arts,PhD,36-40,6,0,0,Remote,Any,2,1,1,4,0,5,5,41.41,Other,4,3,5,4,4,4,1,4,2,2,1,1,1,1,39.16
Finance,Chemist,3.716661276204417,9,2,4,1,9,0,2,3,1,0,2,0,1,1,Commerce,Bachelors,25-30,5,0,0,Hybrid,Tier1_City,2,1,5,2,0,2,3,3.66,Education,1,1,2,5,0,2,4,2,2,2,0,0,5,2,42.19
Law,Brand Manager,2.702013902902471,5,1,1,1,3,0,1,1,2,1,0,4,0,1,Arts,Masters,25-30,14,1,51,Hybrid,Any,2,3,3,1,0,5,1,32.56,Healthcare,4,2,3,1,1,4,3,5,1,4,0,0,5,3,48.91
Biology,Nuclear Physicist,3.755996411225464,6,0,2,1,7,1,1,0,1,3,2,3,1,0,Science,Bachelors,31-35,14,1,25,Office,Any,1,3,4,5,0,5,1,48.76,Other,5,2,1,2,4,0,2,1,2,4,0,1,2,5,50.23
Finance,Curriculum Developer,4.793218010377476,4,2,1,0,7,1,3,1,2,3,3,2,0,1,Commerce,Masters,18-24,7,0,0,Hybrid,Tier1_City,3,1,2,4,3,5,3,13.87,Tech,3,5,3,4,4,4,5,1,4,1,1,0,3,1,60.46
Biology,Human Resources Specialist,4.228608307020409,6,1,2,1,4,1,2,4,2,2,0,0,0,0,Science,Masters,25-30,1,0,0,Flexible,Any,2,2,2,1,4,5,1,40.39,Other,3,1,2,5,4,2,3,4,5,1,0,1,2,5,50.66
Architecture,Nuclear Physicist,4.40319745010951,9,2,4,0,5,1,4,0,2,1,0,4,1,0,Interdisciplinary,PhD,36-40,13,1,9,Flexible,Any,1,2,3,1,1,3,5,28.11,Other,2,3,3,2,4,2,1,5,2,2,0,1,1,3,57.49
Finance,Human Resources Specialist,4.520915887536495,0,1,4,0,9,0,0,1,1,1,2,4,4,1,Commerce,Bachelors,18-24,12,0,0,Hybrid,Tier1_City,5,4,3,5,4,5,1,13.41,Healthcare,3,1,4,4,0,5,3,2,1,5,1,0,5,5,55.64
Law,Cybersecurity Analyst,2.8807093057302584,1,0,2,1,8,1,2,4,0,0,3,1,2,0,Arts,Masters,25-30,12,0,0,Hybrid,Any,2,1,5,4,0,2,1,5.4,Tech,5,4,1,1,2,1,3,4,5,2,1,1,5,2,58.24
Biology,Artist,3.538551605478676,4,1,2,1,9,1,3,3,1,1,2,0,0,1,Science,Bachelors,36-40,6,1,49,Hybrid,Tier1_City,5,5,2,1,5,5,2,38.72,Finance,5,5,4,4,5,0,1,2,5,5,1,0,3,3,58.88
Medicine,Lawyer,4.396615185881174,4,1,0,1,1,0,0,3,0,4,4,0,3,1,Science,PhD,25-30,9,0,0,Hybrid,Tier1_City,5,5,1,1,3,1,5,17.87,Education,3,4,4,5,1,3,5,1,5,4,0,1,3,3,69.8
Computer Science,Inorganic Chemist,2.725244327920346,6,0,4,0,9,1,0,1,2,3,3,2,1,1,Science,High School,25-30,14,1,45,Hybrid,Tier2_City,4,2,0,4,5,3,5,20.65,Other,4,3,3,1,2,0,2,5,1,2,1,1,3,1,48.85
Psychology,Geneticist,3.9569532688342544,7,0,1,1,6,1,1,0,0,3,2,1,2,1,Arts,Masters,25-30,6,0,0,Remote,Tier1_City,1,3,1,3,3,1,2,25.81,Manufacturing,5,2,4,1,5,3,3,1,5,1,1,1,1,4,48.23
Biology,Ecologist,2.655746344975994,3,2,4,1,7,0,3,2,2,4,4,2,0,0,Science,Masters,25-30,3,0,0,Remote,Tier1_City,1,3,2,1,0,3,4,26.84,Healthcare,3,2,1,1,0,0,4,4,4,3,0,1,5,2,53.11
Medicine,Data Scientist,3.945470205520577,3,1,2,1,6,1,4,1,1,3,1,3,1,0,Science,Masters,31-35,11,0,0,Remote,Any,2,2,4,2,3,1,3,12.69,Finance,3,2,4,3,2,4,5,2,5,1,1,1,4,1,60.34
Chemistry,Software Developer,2.9806879741280654,3,2,3,1,6,0,1,4,3,2,1,2,0,0,Science,Bachelors,36-40,9,1,23,Flexible,Any,2,4,4,4,0,0,5,34.52,Other,4,3,2,5,5,3,5,2,4,3,0,0,4,3,60.52
Education,Acoustics Specialist,4.922562674636732,4,0,4,0,6,1,4,4,2,0,1,4,0,1,Arts,PhD,25-30,1,0,0,Remote,Tier3_City,2,1,0,1,4,4,4,35.55,Education,3,4,1,2,4,0,1,1,1,5,0,0,3,2,54.72
Psychology,Doctor,4.433771316707327,0,0,1,0,7,1,0,4,0,3,2,0,4,1,Arts,Bachelors,36-40,3,0,0,Remote,Tier2_City,1,5,0,5,2,4,3,9.69,Manufacturing,1,3,2,1,1,5,5,4,1,1,1,1,1,3,30.2
Biology,Interior Designer,4.60008307246289,4,2,0,0,7,1,4,3,1,0,4,3,1,1,Science,Masters,25-30,3,1,51,Hybrid,Any,5,2,5,2,3,3,5,28.05,Healthcare,2,3,2,5,4,5,4,5,1,2,0,0,5,3,53.32
Engineering,Education Administrator,4.961740672307474,7,0,0,1,8,0,0,0,2,3,0,4,1,0,Science,Bachelors,25-30,11,0,0,Remote,Tier1_City,5,3,2,1,0,0,1,31.64,Education,5,4,5,3,1,5,5,3,5,3,0,1,5,1,54.56
Art,Cybersecurity Analyst,4.696086893596231,9,1,0,0,5,0,3,4,3,4,4,0,3,1,Arts,Bachelors,31-35,11,0,0,Remote,Any,2,1,2,2,5,2,5,11.75,Finance,4,2,5,3,2,5,2,4,2,4,1,1,5,2,70.39
Computer Science,Counselor,4.203365536319776,8,0,4,1,1,0,3,3,3,3,4,3,0,0,Science,Bachelors,31-35,5,0,0,Hybrid,Tier1_City,5,5,0,2,0,0,3,45.04,Other,4,5,2,1,4,1,1,5,2,2,0,0,3,5,49.44
Chemistry,Zoologist,2.780623609293525,5,1,2,0,1,1,0,1,0,2,1,0,2,1,Science,Bachelors,25-30,13,0,0,Hybrid,Any,2,4,4,3,5,3,4,25.69,Other,2,3,4,5,0,2,4,5,5,1,1,0,4,3,50.52
Marketing,Lawyer,4.608837853785195,4,0,3,0,9,0,0,4,3,4,1,1,1,0,Commerce,Bachelors,18-24,6,0,0,Remote,Tier2_City,3,2,3,2,3,0,1,8.41,Other,1,3,2,3,4,0,2,2,3,4,0,1,4,3,54.3
Business,Construction Manager,4.117677211128832,7,2,1,0,0,0,3,0,1,3,3,1,0,0,Commerce,Bachelors,18-24,2,0,0,Hybrid,Any,5,1,3,3,1,2,3,18.72,Healthcare,2,4,2,1,3,0,1,3,3,4,1,0,1,1,45.0
Architecture,Legal Analyst,4.122156871156596,4,0,1,1,0,1,3,1,4,3,3,0,1,1,Interdisciplinary,Bachelors,25-30,14,1,47,Hybrid,Any,1,5,3,4,5,3,3,25.42,Other,3,5,5,4,0,2,1,3,4,4,0,1,2,5,67.09
Psychology,Inorganic Chemist,3.525819190492552,6,0,0,1,9,1,2,2,3,4,1,2,1,0,Arts,Masters,25-30,9,0,0,Hybrid,Any,4,4,4,3,0,4,5,3.48,Healthcare,4,3,3,4,1,3,2,3,2,4,0,1,1,2,61.97
Art,Physician Assistant,3.507690185094897,4,1,2,0,9,1,1,4,0,1,4,0,1,1,Arts,Masters,31-35,0,1,31,Office,Tier2_City,1,3,1,5,3,5,2,4.5,Other,3,1,3,4,3,3,5,1,5,2,1,1,4,5,48.41
Business,Zoologist,3.62346509019948,6,2,0,0,2,0,0,1,4,4,3,3,0,1,Commerce,Bachelors,18-24,2,0,0,Remote,Tier3_City,1,1,1,1,0,0,2,5.61,Tech,4,5,3,2,4,5,4,2,1,5,0,1,4,2,49.09
Chemistry,Civil Engineer,2.9934225467165403,4,0,1,1,2,0,2,1,0,2,1,1,0,1,Science,Bachelors,31-35,8,1,38,Hybrid,Tier3_City,4,2,4,4,1,4,1,28.29,Other,4,3,2,5,4,4,4,4,2,4,0,1,5,2,48.18
Architecture,Data Scientist,3.812608593978093,2,1,4,1,9,1,3,3,2,2,2,4,4,0,Interdisciplinary,Bachelors,25-30,0,0,0,Office,Tier1_City,2,5,1,4,2,4,3,18.8,Tech,3,5,2,4,4,5,3,1,5,5,0,1,2,5,54.97
Medicine,Dentist,3.383483125130105,3,1,3,1,3,0,4,4,2,4,3,0,1,0,Science,High School,25-30,12,0,0,Flexible,Tier2_City,5,3,3,5,1,1,4,44.98,Healthcare,2,1,4,3,4,4,3,1,3,5,0,1,5,1,65.83
Music,Music Therapist,4.13822362662988,1,1,0,0,5,0,3,0,2,4,1,2,1,0,Arts,Masters,25-30,7,0,0,Flexible,Tier1_City,1,3,4,3,4,2,1,29.28,Education,5,1,5,2,5,5,1,3,3,1,1,0,2,5,55.03
Finance,Electrical Engineer,4.906609008280057,7,0,0,1,7,0,4,0,0,1,1,3,3,0,Commerce,Masters,18-24,1,0,0,Hybrid,Any,5,5,0,1,3,5,1,38.72,Finance,5,5,2,4,3,5,3,3,3,2,1,0,3,1,40.3
Business,Acoustics Specialist,3.3902610758022744,3,0,4,1,0,0,4,1,0,4,2,0,0,0,Commerce,Bachelors,36-40,5,0,0,Hybrid,Tier1_City,4,5,4,3,1,0,5,35.3,Manufacturing,2,2,1,1,0,4,4,5,4,4,0,0,5,1,50.79
Architecture,Financial Advisor,4.204091219049431,7,2,0,0,1,0,1,3,1,0,0,4,1,1,Interdisciplinary,Bachelors,18-24,2,0,0,Hybrid,Any,4,5,2,2,2,4,4,27.46,Tech,1,5,1,3,5,1,4,5,5,3,0,1,1,5,44.73
Biology,Clinical Psychologist,4.2537293433200025,6,0,1,1,4,0,0,1,4,1,3,3,0,1,Science,High School,25-30,6,0,0,Flexible,Tier2_City,5,1,3,3,0,4,3,38.0,Finance,2,4,5,2,3,2,3,2,5,1,0,0,1,3,43.11
Finance,Urban Planner,4.926702589761615,7,2,2,0,3,1,2,2,2,4,3,1,4,1,Commerce,Masters,36-40,1,0,0,Office,Tier1_City,5,2,5,4,3,2,3,28.6,Other,2,2,1,2,0,3,3,2,1,2,1,1,3,4,44.71
Physics,Legal Analyst,3.442707949033144,2,1,1,1,6,1,4,4,4,1,0,4,1,1,Science,PhD,31-35,3,0,0,Hybrid,Any,4,3,3,1,5,5,3,21.12,Healthcare,2,1,1,3,2,1,1,4,5,2,1,1,2,1,66.24
Business,Illustrator,3.7078450446575073,3,0,0,1,5,1,1,1,4,4,1,2,2,1,Commerce,Bachelors,25-30,9,1,59,Remote,Tier1_City,2,4,2,3,1,5,1,23.48,Finance,5,2,5,4,2,5,4,1,1,5,0,1,2,1,55.34
Business,Physicist,4.572386388404339,9,2,3,0,0,0,2,4,4,3,1,1,2,1,Commerce,Bachelors,25-30,8,1,56,Hybrid,Tier2_City,5,5,3,1,2,4,5,42.41,Finance,4,1,2,1,0,4,5,3,3,1,0,1,5,2,51.95
Chemistry,Principal,2.710528639843978,7,2,4,1,1,1,3,2,2,4,1,0,2,1,Science,Masters,31-35,5,0,0,Remote,Tier3_City,3,2,5,1,1,4,1,29.47,Other,1,1,2,1,0,5,4,3,2,2,0,0,1,3,44.41
Psychology,Forensic Psychologist,3.789853625590901,0,2,1,1,5,0,2,2,0,0,4,4,3,0,Arts,PhD,40+,3,0,0,Flexible,Tier1_City,3,4,2,2,4,4,2,20.73,Finance,1,1,4,1,0,2,1,2,3,1,1,0,3,2,47.95
Engineering,Conductor,4.781385236076501,4,2,2,1,2,1,1,0,2,1,3,2,4,0,Science,Bachelors,36-40,1,0,0,Remote,Tier2_City,5,1,5,2,3,4,2,11.45,Healthcare,1,4,2,2,2,4,2,5,5,2,0,1,4,5,44.39
Business,Financial Analyst,3.567312855051514,6,2,3,1,2,0,2,3,0,3,3,3,0,1,Commerce,Bachelors,25-30,9,1,42,Remote,Tier3_City,1,3,2,4,0,1,3,26.28,Tech,3,4,1,4,0,0,3,4,1,5,0,1,3,3,57.03
Medicine,Teacher,3.573523604435733,6,0,4,1,9,0,1,4,2,1,2,4,3,0,Science,High School,40+,13,1,12,Flexible,Any,4,2,3,5,2,1,5,14.86,Manufacturing,2,3,1,3,0,5,2,1,3,4,0,1,5,5,59.2
Computer Science,Counselor,2.878938410840715,9,1,3,0,2,0,1,0,0,3,1,1,2,1,Science,Masters,18-24,8,0,0,Remote,Tier1_City,2,2,4,1,1,5,3,47.91,Education,4,4,4,5,3,4,3,2,5,4,1,1,2,5,54.61
Biology,Musician,4.949179768731739,1,1,4,1,1,0,3,1,3,3,0,0,0,0,Science,Bachelors,18-24,14,0,0,Remote,Tier1_City,3,3,2,5,3,3,3,26.08,Tech,4,1,5,1,1,5,3,5,5,2,1,1,1,3,54.53
Chemistry,Clinical Psychologist,3.800448902426076,8,2,1,0,0,0,0,0,2,3,0,4,3,0,Science,High School,36-40,3,0,0,Hybrid,Tier2_City,3,3,0,4,1,0,1,3.42,Manufacturing,3,5,1,3,4,2,5,5,1,2,1,0,5,5,30.33
Engineering,Biochemist,3.5338333285767534,8,0,3,0,9,1,2,4,1,4,3,2,2,1,Science,Masters,18-24,8,0,0,Hybrid,Tier2_City,1,5,2,1,3,2,3,7.37,Healthcare,5,2,2,3,4,5,5,1,4,1,0,0,1,5,63.88
Medicine,Architectural Technologist,3.024124148225501,6,1,0,1,6,1,1,2,3,0,3,1,2,0,Science,High School,18-24,13,0,0,Hybrid,Tier2_City,5,3,0,1,4,3,3,16.36,Manufacturing,3,5,2,1,5,3,3,1,2,5,0,1,1,4,55.86
Chemistry,Microbiologist,4.566323020426095,3,2,4,0,8,0,1,3,2,3,2,3,3,0,Science,Masters,18-24,1,0,0,Hybrid,Tier1_City,1,2,4,5,1,1,5,7.33,Healthcare,3,1,2,5,3,2,4,2,4,1,1,1,2,3,45.62
Computer Science,Legal Analyst,4.944776600466685,2,0,4,0,7,1,3,1,1,0,0,1,2,0,Science,Bachelors,25-30,6,0,0,Remote,Tier2_City,2,5,2,3,4,1,5,45.02,Manufacturing,2,5,1,2,0,3,1,1,3,1,1,0,4,4,39.47
Chemistry,Mechanical Engineer,4.280123616042761,7,1,1,0,6,1,1,0,4,2,0,3,1,0,Science,High School,31-35,10,0,0,Hybrid,Any,5,3,2,2,5,1,5,43.15,Tech,5,2,3,2,1,5,1,3,4,3,1,0,2,5,56.59
Finance,Acoustics Specialist,3.441353528559883,3,0,3,0,2,1,2,4,4,2,3,1,0,1,Commerce,Masters,31-35,10,1,57,Hybrid,Tier1_City,3,4,2,3,5,3,3,48.63,Other,3,3,1,4,3,5,3,5,1,3,1,0,2,3,67.29
Physics,Nuclear Physicist,2.543040083413442,7,2,3,1,2,0,4,1,1,1,2,0,3,1,Science,Bachelors,18-24,4,0,0,Office,Tier1_City,3,4,0,5,2,1,5,36.2,Other,4,3,1,2,1,2,1,5,2,4,1,1,5,4,43.37
Computer Science,Sound Engineer,3.075612984592982,3,2,1,0,3,1,0,2,3,1,2,0,0,0,Science,PhD,25-30,7,0,0,Hybrid,Tier2_City,4,3,4,2,4,3,5,33.34,Other,2,4,3,3,2,2,1,3,4,5,1,0,2,1,60.49
Marketing,Interior Designer,3.3398437165300123,9,2,3,1,2,1,2,0,3,3,2,4,0,0,Commerce,Bachelors,36-40,10,0,0,Hybrid,Tier1_City,2,2,3,3,3,1,4,46.4,Healthcare,5,5,3,2,1,3,4,4,4,5,1,0,1,3,65.58
Law,Advertising Manager,4.680074345673269,2,0,2,1,5,0,1,3,2,4,1,3,4,1,Arts,Bachelors,36-40,13,0,0,Hybrid,Tier2_City,3,5,5,2,2,4,4,47.48,Finance,4,4,2,4,3,0,4,4,2,4,1,0,3,5,61.1
Law,Cybersecurity Analyst,4.7661791281654935,3,0,1,1,8,1,3,0,4,3,0,3,3,0,Arts,Masters,25-30,7,1,58,Remote,Tier1_City,1,5,5,1,1,4,2,44.24,Other,1,4,2,3,5,2,3,1,3,5,1,0,2,5,61.99
Engineering,Composer,3.745195906546343,6,0,2,0,4,0,1,0,2,4,2,4,4,1,Science,Bachelors,40+,13,0,0,Remote,Tier1_City,3,5,1,3,1,0,1,43.49,Healthcare,2,5,2,3,4,2,1,2,1,3,0,1,4,3,52.47
Engineering,Counselor,3.89757071110771,9,0,1,0,3,1,2,1,2,3,3,4,1,1,Science,PhD,31-35,13,0,0,Office,Tier2_City,1,1,2,2,3,1,1,34.57,Healthcare,4,5,1,5,2,5,3,4,2,3,0,0,1,3,71.27
Architecture,Counselor,4.066286808030632,8,2,2,1,2,1,4,4,2,3,3,3,3,0,Interdisciplinary,Bachelors,18-24,3,0,0,Remote,Tier1_City,1,3,2,2,0,0,5,3.08,Manufacturing,3,2,5,1,1,1,4,2,3,3,0,1,1,1,53.06
Computer Science,Landscape Architect,3.758358206783096,6,1,3,1,4,0,4,0,3,0,3,2,0,0,Science,Bachelors,18-24,12,0,0,Office,Tier3_City,5,1,2,2,0,3,2,23.19,Healthcare,3,5,4,1,4,4,1,2,2,1,0,1,3,4,47.31
Chemistry,AI Researcher,4.418396790998022,3,2,0,1,4,0,3,0,1,3,2,1,3,0,Science,Bachelors,18-24,3,1,7,Remote,Any,5,1,3,3,1,0,2,32.88,Manufacturing,2,5,5,1,1,1,4,4,1,2,1,1,2,5,32.83
Chemistry,Landscape Architect,3.549505237771561,1,0,3,1,1,0,0,0,2,3,2,3,3,1,Science,Bachelors,31-35,14,0,0,Office,Tier2_City,3,4,4,4,3,1,4,28.71,Tech,5,4,3,4,5,5,2,2,1,4,0,0,1,4,54.67
Medicine,Financial Controller,2.6352857800159235,5,1,2,1,5,1,4,1,0,1,0,3,4,1,Science,Masters,18-24,7,0,0,Flexible,Tier2_City,3,5,0,3,0,3,2,41.59,Healthcare,3,3,1,2,1,2,1,1,4,1,0,1,4,1,44.72
Chemistry,Fluid Mechanics Engineer,3.441335335052026,0,0,4,1,7,1,1,2,2,0,3,0,2,0,Science,Masters,25-30,2,0,0,Hybrid,Tier1_City,1,1,3,5,4,3,3,41.49,Finance,4,1,1,1,0,2,2,3,4,5,1,0,1,5,48.02
Architecture,Zoologist,4.117786104208796,7,1,0,0,3,0,1,4,3,0,1,3,2,1,Interdisciplinary,Bachelors,18-24,6,0,0,Hybrid,Tier3_City,5,2,4,3,1,4,5,31.14,Finance,1,3,4,2,4,2,2,3,5,2,0,1,5,3,49.25
Biology,Chemist,3.295473580633059,5,0,1,0,4,0,1,2,4,2,3,4,4,0,Science,Bachelors,36-40,7,0,0,Hybrid,Tier2_City,3,3,1,2,5,3,3,4.03,Tech,5,5,5,1,5,0,4,1,5,5,1,1,3,5,70.02
Education,Architect,2.861829543490111,5,0,3,1,3,1,2,1,0,1,1,3,3,1,Arts,Masters,25-30,7,0,0,Flexible,Tier1_City,5,2,5,1,4,3,1,20.36,Other,2,1,3,5,2,1,4,1,4,4,1,1,1,5,59.08
Physics,Musician,4.429077824702445,1,2,3,0,8,1,4,0,3,3,3,4,4,0,Science,PhD,36-40,10,0,0,Remote,Tier1_City,2,5,4,3,3,0,4,13.75,Finance,3,5,4,2,2,4,5,5,1,2,0,0,3,2,68.98
Education,Fluid Mechanics Engineer,4.50882175018933,8,2,4,1,1,1,4,2,2,3,3,3,2,1,Arts,Bachelors,36-40,9,1,31,Office,Tier1_City,1,4,4,3,5,5,3,18.92,Manufacturing,5,2,1,4,2,0,1,3,3,3,0,1,5,2,65.47
Marketing,Organic Chemist,4.2689768498108975,9,1,4,1,8,0,0,4,0,0,4,4,1,0,Commerce,Bachelors,18-24,3,0,0,Office,Tier1_City,5,2,0,2,4,3,5,32.01,Healthcare,1,5,4,4,1,3,5,1,4,3,0,0,1,1,51.36
Finance,Advertising Manager,4.768217897902391,4,1,2,1,3,1,2,2,3,1,3,0,4,0,Commerce,Bachelors,25-30,8,0,0,Hybrid,Tier2_City,3,2,4,1,0,2,3,6.12,Education,5,1,2,2,5,5,3,4,5,2,1,0,4,2,53.62
Physics,Marketing Manager,2.517606269316675,5,1,0,1,8,1,0,1,0,4,4,0,2,1,Science,Masters,18-24,14,0,0,Remote,Any,1,1,4,1,0,5,3,4.05,Healthcare,5,2,5,4,4,2,3,2,1,3,1,1,1,3,53.87
Finance,Marketing Manager,4.959882691478243,5,2,2,0,9,0,2,0,0,4,0,4,2,1,Commerce,Bachelors,36-40,9,0,0,Remote,Tier3_City,4,2,5,5,5,4,2,23.53,Healthcare,2,1,3,3,2,0,4,1,2,3,1,1,1,1,52.13
Education,Sound Engineer,4.104662858332326,7,2,3,0,1,0,4,1,0,4,4,2,3,0,Arts,Bachelors,25-30,3,0,0,Office,Tier2_City,1,4,2,3,2,4,4,40.3,Education,1,2,2,4,5,5,3,4,4,3,0,1,4,4,54.94
Finance,Biochemist,4.888892256061257,5,1,2,0,3,1,3,0,0,4,0,3,1,0,Commerce,Masters,18-24,7,0,0,Remote,Tier2_City,2,2,0,1,1,3,1,4.44,Other,1,4,5,5,2,5,2,5,4,4,0,0,2,4,59.77
Computer Science,Curriculum Developer,4.444227478096707,2,0,4,0,4,0,4,1,4,3,0,1,1,0,Science,Bachelors,18-24,5,0,0,Hybrid,Tier1_City,1,2,4,1,5,0,5,42.91,Finance,5,1,2,5,5,3,3,3,3,2,1,1,5,5,52.43
Medicine,Game Developer,3.954362002023344,1,2,1,1,9,1,4,0,3,3,4,4,2,1,Science,Bachelors,25-30,4,1,58,Hybrid,Tier2_City,5,5,4,4,3,5,5,21.04,Finance,3,4,4,2,1,2,5,4,1,2,1,0,2,5,54.05
Engineering,Music Teacher,3.876571232164826,2,1,4,1,3,0,4,2,0,0,1,0,1,1,Science,Bachelors,36-40,14,0,0,Remote,Tier1_City,5,4,2,4,1,4,1,8.56,Healthcare,5,4,3,4,3,0,1,2,3,1,0,1,4,4,45.3
Finance,Architect,2.5810234748464884,8,0,0,1,7,1,3,2,2,1,3,3,0,1,Commerce,Bachelors,31-35,3,1,44,Hybrid,Tier1_City,3,2,0,1,4,4,5,29.67,Finance,4,5,4,2,5,2,4,4,2,5,0,1,5,3,52.41
Computer Science,Construction Manager,2.7080605611089386,4,1,2,1,9,1,1,4,0,1,2,1,2,1,Science,Bachelors,36-40,4,1,51,Flexible,Tier2_City,3,5,1,5,3,2,2,47.76,Manufacturing,3,3,4,1,2,1,1,5,1,5,1,1,3,2,42.03
Engineering,Industrial-Organizational Psychologist,3.236720177818735,1,2,1,1,2,0,3,1,0,3,4,1,1,1,Science,Bachelors,25-30,14,1,9,Hybrid,Tier1_City,1,3,0,1,3,3,3,28.5,Manufacturing,2,2,5,3,4,2,4,2,3,1,1,0,1,5,55.72
Business,Education Administrator,4.3396019557981305,1,0,2,1,2,0,1,2,1,3,2,1,4,0,Commerce,Bachelors,18-24,12,0,0,Office,Tier1_City,1,2,3,2,0,5,2,35.27,Education,1,1,3,2,2,5,3,3,2,5,0,0,1,1,50.61
Music,Pharmacist,4.042942810567771,5,0,0,0,6,0,1,0,4,0,4,1,4,1,Arts,Masters,40+,14,1,49,Hybrid,Tier1_City,1,2,4,3,4,4,2,41.37,Healthcare,3,4,3,2,1,4,3,2,2,3,0,1,3,4,59.61
Law,Analytical Chemist,4.754506723402173,5,2,0,0,8,1,4,0,4,0,2,0,1,1,Arts,Masters,18-24,10,1,18,Office,Tier1_City,5,5,5,5,0,4,2,40.57,Other,2,5,4,2,3,4,4,4,4,2,1,1,2,2,54.49
Finance,Biochemist,4.155024395755727,4,0,3,0,3,0,4,1,3,2,2,0,2,1,Commerce,Masters,36-40,0,0,0,Hybrid,Tier2_City,5,5,3,2,0,4,1,6.44,Manufacturing,5,1,3,2,3,2,1,1,1,1,1,0,4,5,35.3
Finance,AI Researcher,3.8984587028718254,7,2,2,0,2,1,1,1,1,2,4,1,2,0,Commerce,Bachelors,25-30,6,0,0,Flexible,Tier1_City,4,5,3,5,2,4,4,37.83,Tech,2,5,1,5,4,0,2,1,2,4,1,1,3,3,51.21
Architecture,Biotechnologist,4.866389973066484,6,0,0,1,0,0,3,1,4,0,4,2,3,1,Interdisciplinary,Bachelors,18-24,7,0,0,Hybrid,Tier1_City,4,2,1,2,0,0,1,47.62,Finance,4,1,3,3,5,5,4,2,3,3,0,0,3,2,52.93
Marketing,Clinical Psychologist,4.939419544083511,0,2,2,0,4,1,4,3,4,1,4,4,2,1,Commerce,Bachelors,31-35,11,0,0,Hybrid,Tier1_City,4,1,4,3,1,1,1,35.93,Other,2,5,4,1,3,3,2,2,1,4,0,0,2,3,65.51
Biology,Manager,3.3339212353529577,8,0,2,1,6,0,0,1,0,4,2,0,3,1,Science,Bachelors,40+,8,0,0,Hybrid,Tier1_City,3,1,0,3,3,2,2,42.31,Healthcare,3,5,1,3,5,3,5,5,2,3,1,1,5,1,47.81
Marketing,Lawyer,3.1995296297454163,7,1,0,1,4,1,0,1,3,0,2,3,2,0,Commerce,Bachelors,40+,12,0,0,Hybrid,Any,5,5,5,4,0,0,4,25.82,Manufacturing,1,3,1,2,2,4,4,4,4,1,0,0,5,3,50.57
Finance,Landscape Architect,2.9494062463714985,2,1,1,0,7,1,4,3,3,1,0,1,1,1,Commerce,Masters,18-24,2,1,22,Remote,Tier1_City,1,1,2,2,5,2,1,18.0,Education,3,4,5,5,5,4,4,2,5,2,1,1,1,4,56.68
Business,Architect,2.712665460672385,8,2,3,1,4,1,4,0,4,4,3,0,2,0,Commerce,Bachelors,18-24,14,0,0,Remote,Tier1_City,1,3,4,4,1,4,4,34.78,Manufacturing,3,2,4,1,0,0,2,1,5,4,0,1,1,4,65.95
Engineering,Physicist,2.9389210802962835,2,2,2,0,5,1,1,3,2,2,4,1,4,1,Science,High School,25-30,8,1,19,Office,Tier2_City,4,1,3,2,4,2,2,26.13,Tech,1,2,3,2,1,1,2,3,5,2,1,0,1,5,54.53
Education,Actuary,3.6206281357203967,4,0,4,0,6,1,1,1,4,0,2,2,2,0,Arts,Bachelors,31-35,9,0,0,Remote,Tier1_City,3,1,3,4,3,3,1,45.08,Manufacturing,4,1,1,2,2,4,3,4,2,3,0,1,1,2,51.15
Marketing,Biochemist,4.568457286338584,6,2,2,0,6,0,3,0,0,3,4,1,1,1,Commerce,Masters,31-35,4,0,0,Hybrid,Tier2_City,3,2,4,3,5,3,4,48.8,Healthcare,3,1,4,4,5,4,1,5,2,2,1,0,1,5,51.32
Law,Clinical Psychologist,4.7992586599953455,4,2,3,1,6,1,0,0,0,0,3,2,1,1,Arts,Bachelors,18-24,9,0,0,Flexible,Tier1_City,4,1,1,5,5,1,5,41.53,Education,1,3,5,3,2,2,3,4,3,2,1,1,3,1,46.11
Engineering,Art Director,3.29839254925661,5,2,3,0,7,1,3,3,1,4,2,1,3,0,Science,Masters,40+,5,0,0,Hybrid,Any,1,5,0,4,4,1,1,49.66,Education,1,1,2,3,1,1,3,1,5,2,0,1,2,5,59.31
Marketing,Brand Manager,3.532066858237739,0,2,4,1,9,0,0,2,3,2,4,3,3,1,Commerce,Bachelors,31-35,0,1,50,Remote,Any,3,2,5,2,5,2,1,19.37,Tech,3,2,2,3,1,1,2,4,5,2,1,1,1,3,48.65
Engineering,Artist,4.477970374875225,1,0,2,1,1,0,1,1,1,4,2,0,3,0,Science,Masters,36-40,8,0,0,Office,Tier2_City,2,1,2,2,1,0,1,45.1,Healthcare,1,4,3,4,2,4,4,5,1,2,0,1,1,2,48.23
Engineering,AI Researcher,4.777741792448472,7,2,2,0,5,1,0,3,3,3,3,3,4,1,Science,Masters,25-30,8,0,0,Remote,Tier3_City,4,3,5,3,4,0,4,18.51,Tech,5,3,2,5,3,2,4,5,1,5,0,0,2,4,67.74
Education,Surgeon,4.267414712855649,8,1,3,1,9,0,1,2,2,3,3,1,1,1,Arts,Bachelors,25-30,5,1,19,Hybrid,Tier2_City,1,2,5,2,5,4,3,8.55,Tech,3,1,1,5,4,5,2,3,2,2,0,1,2,4,47.7
Architecture,Chemical Engineer,4.840160647410574,4,2,0,1,5,1,4,0,1,3,3,0,3,0,Interdisciplinary,Bachelors,40+,7,0,0,Hybrid,Any,2,2,1,1,4,0,1,32.2,Tech,4,3,1,5,2,5,4,4,2,4,0,0,5,5,58.87
Biology,Investment Banker,3.909622597891912,3,2,1,1,8,1,2,1,3,4,1,1,1,0,Science,Bachelors,25-30,3,1,11,Remote,Tier2_City,5,2,5,5,4,1,5,24.38,Manufacturing,5,3,4,1,0,0,1,3,4,5,0,0,5,2,53.85
Psychology,Web Developer,4.207314194745007,1,2,1,0,5,1,3,2,2,4,4,4,4,0,Arts,Bachelors,36-40,4,0,0,Remote,Tier1_City,1,1,5,4,0,0,5,46.32,Finance,4,3,3,4,2,3,5,2,5,4,0,0,5,4,60.06
Music,Legal Consultant,4.554844529374295,1,1,2,0,5,0,0,2,2,1,4,3,2,0,Arts,Masters,40+,4,0,0,Remote,Tier1_City,2,5,0,5,0,4,2,26.13,Manufacturing,3,1,4,4,5,4,4,3,5,3,1,0,5,4,52.35
Education,Aerospace Engineer,4.4713627888264025,6,2,1,1,6,1,0,4,4,4,3,1,1,0,Arts,Masters,31-35,6,0,0,Remote,Tier1_City,5,4,4,3,0,3,3,46.6,Healthcare,2,5,4,5,0,3,4,2,2,4,1,1,5,1,62.77
Chemistry,Paralegal,3.800028925470973,7,2,3,0,1,0,3,2,0,3,3,4,3,0,Science,Masters,25-30,6,1,15,Remote,Tier2_City,3,4,1,4,5,0,3,6.7,Other,1,1,3,5,2,3,3,2,3,5,0,0,3,4,68.53
Medicine,Legal Secretary,4.708601501979738,4,2,1,0,5,1,0,3,0,1,3,3,2,0,Science,Masters,18-24,6,0,0,Flexible,Tier1_City,1,4,5,4,3,0,4,42.03,Tech,5,1,4,5,2,5,2,2,1,3,0,0,2,3,47.36
Art,Financial Controller,4.433295068015244,2,2,2,0,0,0,1,2,0,4,0,2,2,1,Arts,Bachelors,18-24,4,1,17,Hybrid,Tier2_City,1,1,2,1,1,1,2,38.68,Tech,3,1,2,4,0,3,4,1,5,3,0,1,2,5,45.19
Engineering,Industrial-Organizational Psychologist,3.5191712396412984,4,0,1,0,6,1,0,1,0,0,1,3,4,0,Science,Bachelors,18-24,3,1,16,Flexible,Tier1_City,3,3,0,3,5,2,4,36.84,Finance,1,1,5,5,4,5,2,5,3,2,1,1,1,2,40.97
Music,Cybersecurity Analyst,4.890210560124766,1,2,0,1,0,0,2,2,4,3,1,0,1,1,Arts,Masters,18-24,7,0,0,Hybrid,Any,1,2,4,2,0,3,2,19.69,Education,2,1,4,3,0,5,3,2,1,4,1,0,2,3,54.8
Marketing,Urban Planner,4.413126389617692,3,2,3,1,1,1,4,3,2,0,4,0,2,0,Commerce,Bachelors,25-30,0,0,0,Office,Tier2_City,4,2,0,1,4,2,3,39.84,Tech,4,3,1,5,4,4,1,4,4,2,0,1,4,1,47.06
Business,Composer,3.0709858982387552,4,1,0,1,2,0,3,1,1,3,0,2,2,1,Commerce,Masters,25-30,0,1,52,Remote,Tier2_City,2,5,2,1,5,4,4,25.71,Manufacturing,3,3,1,3,4,0,5,1,2,2,1,0,5,1,40.96
Architecture,Musician,3.576407929740995,7,2,2,0,8,1,2,4,4,4,2,2,4,0,Interdisciplinary,Bachelors,25-30,5,0,0,Remote,Tier2_City,5,2,4,5,4,4,2,36.61,Tech,3,1,2,2,0,1,1,2,3,2,0,0,4,1,58.35
Music,Legal Secretary,3.5479864539701573,4,1,1,0,5,1,1,2,2,3,0,4,0,1,Arts,Bachelors,25-30,1,0,0,Hybrid,Any,5,5,3,5,4,2,3,28.95,Healthcare,2,4,4,2,5,2,5,2,1,2,1,0,4,3,38.37
Education,Physicist,4.567244137960614,4,1,4,0,1,1,3,1,4,4,3,1,3,1,Arts,PhD,18-24,11,0,0,Flexible,Tier1_City,2,1,3,5,4,1,3,10.4,Finance,4,4,4,4,1,1,1,5,2,5,0,1,1,2,73.76
Architecture,Illustrator,4.387487079655674,4,1,3,1,7,1,4,2,4,4,4,2,1,1,Interdisciplinary,Bachelors,18-24,2,1,34,Remote,Tier1_City,4,4,1,1,2,5,1,6.03,Other,3,5,3,1,0,2,5,1,2,4,0,1,4,2,56.07
Law,Principal,4.160514668793732,9,1,0,1,9,1,2,1,0,2,3,3,4,0,Arts,PhD,31-35,3,1,15,Hybrid,Tier3_City,1,5,4,2,3,1,4,20.21,Education,1,4,4,2,1,1,1,1,5,5,0,0,3,3,57.49
Psychology,Ecologist,3.323425990080499,2,0,2,1,7,1,0,3,3,4,3,0,4,0,Arts,PhD,25-30,13,0,0,Remote,Tier3_City,3,5,4,4,1,5,1,46.84,Other,2,2,4,4,5,4,2,3,1,5,1,0,4,1,64.92
Law,Industrial-Organizational Psychologist,3.185181020694675,5,0,3,0,5,0,3,1,0,4,2,2,1,0,Arts,Masters,25-30,1,0,0,Hybrid,Tier2_City,3,2,1,5,1,5,3,27.9,Healthcare,3,2,1,4,5,4,5,4,2,3,0,1,5,2,44.94
Art,Music Therapist,3.1082325417763066,0,1,3,0,5,0,1,1,4,4,4,1,2,1,Arts,Masters,31-35,9,1,24,Hybrid,Tier1_City,1,1,5,2,0,1,4,40.7,Manufacturing,4,4,3,3,5,3,2,5,5,2,1,1,1,3,61.51
Marketing,Market Research Analyst,4.833925546386944,9,0,4,1,2,1,4,3,2,3,0,4,1,0,Commerce,Masters,36-40,6,0,0,Office,Tier1_City,5,4,0,3,2,5,4,30.07,Other,5,1,4,3,5,2,3,3,2,4,1,1,3,4,61.82
Finance,Nurse,3.079097929438966,1,0,2,0,6,1,3,2,1,0,1,1,2,0,Commerce,Masters,25-30,14,1,9,Remote,Tier1_City,2,1,1,5,5,5,5,48.02,Healthcare,3,4,2,5,2,5,4,3,1,4,1,1,3,2,57.81
Law,Industrial-Organizational Psychologist,4.139322811213243,2,1,0,1,4,1,3,0,0,0,2,4,0,1,Arts,Bachelors,31-35,9,0,0,Remote,Any,2,4,5,4,5,5,2,20.36,Other,4,2,4,2,1,0,3,4,2,4,1,1,1,5,52.77
Finance,Microbiologist,4.207560636430608,0,1,2,1,1,1,3,0,3,2,2,2,2,0,Commerce,Bachelors,40+,0,1,43,Hybrid,Tier1_City,5,3,4,3,1,3,5,5.68,Tech,2,4,3,3,3,4,3,5,4,4,1,0,4,1,43.49
Art,Judge,2.8236140485706853,7,1,2,1,3,0,1,2,2,1,4,3,1,0,Arts,Masters,36-40,2,1,17,Flexible,Tier2_City,2,1,5,3,3,4,5,39.69,Finance,4,3,2,1,2,2,5,4,4,2,1,1,2,4,49.27
Education,Curriculum Developer,4.097918456392431,6,2,0,1,3,1,4,2,4,3,4,2,2,0,Arts,Bachelors,25-30,1,0,0,Hybrid,Tier3_City,5,3,3,4,4,5,3,36.16,Tech,4,5,2,4,2,4,5,5,4,3,0,1,5,1,57.27
Psychology,Principal,3.227929033513856,5,1,0,0,6,1,1,0,3,0,4,4,1,0,Arts,Bachelors,31-35,12,0,0,Hybrid,Tier1_City,4,4,0,5,0,4,2,27.79,Finance,2,3,2,5,1,0,3,2,4,5,0,1,4,4,61.74
Law,Lawyer,2.6674755307223625,5,1,3,1,7,1,3,0,0,0,4,3,3,0,Arts,Bachelors,18-24,8,0,0,Hybrid,Tier1_City,1,5,5,1,3,4,5,18.34,Manufacturing,5,3,1,3,1,2,1,1,3,3,0,1,5,2,54.93
Psychology,Manager,4.900378227892128,8,2,2,1,1,0,1,1,4,4,3,4,0,1,Arts,Masters,25-30,7,0,0,Remote,Tier1_City,5,3,4,4,1,3,5,11.85,Healthcare,1,5,1,3,3,3,4,2,2,3,0,1,5,4,61.43
Psychology,Art Therapist,3.7498960945763975,2,2,0,1,8,1,4,3,3,4,3,1,1,1,Arts,Masters,40+,2,0,0,Office,Tier2_City,4,4,2,4,2,4,4,25.67,Other,5,1,2,3,2,2,2,2,2,2,1,0,4,5,54.49
Marketing,School Psychologist,2.912468119243896,6,1,0,1,4,1,2,4,1,4,2,0,1,0,Commerce,Bachelors,25-30,4,0,0,Remote,Tier1_City,5,4,3,4,0,2,3,34.31,Finance,1,5,1,2,1,0,2,2,2,3,0,0,4,2,43.88
Music,Accountant,4.998497654470878,1,2,3,1,1,1,2,4,0,3,2,4,3,0,Arts,PhD,36-40,2,0,0,Office,Tier1_City,4,3,3,3,1,0,5,30.21,Healthcare,1,1,2,3,0,5,1,4,2,1,1,0,3,1,48.25
Physics,Biomedical Engineer,3.846235856449012,3,1,4,1,5,0,2,4,1,1,0,0,4,1,Science,Masters,25-30,13,0,0,Hybrid,Tier1_City,4,1,1,2,5,3,2,23.56,Other,1,2,2,4,4,3,4,5,5,4,0,0,1,2,67.21
Physics,Cybersecurity Analyst,2.867911586751796,5,0,0,0,4,0,1,4,0,2,3,4,1,1,Science,Masters,40+,10,1,19,Hybrid,Tier1_City,4,5,4,1,0,0,1,28.37,Finance,3,4,5,3,5,5,1,2,3,1,0,0,5,1,59.36
Education,Architect,3.842959915805757,8,1,4,0,5,0,4,1,3,0,2,2,4,1,Arts,Masters,25-30,12,0,0,Remote,Tier1_City,1,4,4,5,1,2,1,8.07,Tech,5,2,1,1,4,5,2,1,2,2,0,0,4,4,54.31
Finance,Marketing Manager,3.385139726546927,3,2,1,0,5,0,3,2,1,0,0,1,1,1,Commerce,Masters,18-24,11,0,0,Flexible,Tier1_City,5,1,1,5,5,1,3,35.7,Finance,4,2,5,3,1,5,1,2,5,4,1,0,3,5,59.75
Law,Landscape Architect,3.552865145203861,0,0,4,1,0,1,1,3,3,3,4,0,4,0,Arts,High School,25-30,10,0,0,Remote,Tier1_City,5,4,4,2,5,1,1,37.51,Finance,3,2,2,5,3,4,5,3,3,3,1,1,1,3,64.04
Biology,Surgeon,4.511996900790697,3,0,0,1,3,0,4,3,0,0,3,4,1,0,Science,Masters,25-30,11,1,30,Office,Tier3_City,5,4,4,4,4,5,4,3.54,Education,2,4,2,5,1,5,2,3,5,3,0,1,4,4,70.59
Marketing,Music Therapist,3.195468235054832,4,2,4,0,3,1,0,4,4,3,0,4,3,0,Commerce,High School,18-24,10,0,0,Office,Tier1_City,4,4,5,1,2,1,4,15.71,Other,2,1,5,1,3,3,5,4,4,4,0,0,2,2,60.71
Music,Data Scientist,2.626633035493261,0,0,1,0,4,0,3,4,1,1,0,2,3,0,Arts,Masters,36-40,5,0,0,Hybrid,Tier2_City,2,1,3,5,4,3,2,7.33,Other,1,5,3,5,2,4,4,1,4,2,1,0,3,4,55.37
Biology,Physicist,2.9992150548556777,6,2,1,0,8,1,4,1,1,0,1,3,1,0,Science,PhD,25-30,4,0,0,Hybrid,Tier2_City,2,2,0,5,1,1,3,49.92,Manufacturing,3,1,2,2,0,0,5,4,5,1,1,0,3,2,53.79
Law,Inorganic Chemist,4.629399742849452,1,2,1,0,5,0,4,4,1,4,2,2,0,1,Arts,Bachelors,31-35,10,1,55,Flexible,Any,5,5,2,4,3,3,3,30.89,Other,3,1,1,4,2,5,1,4,2,2,1,0,5,4,61.74
Psychology,Ecologist,4.2942062283771625,9,1,0,0,3,1,0,2,2,3,0,4,0,0,Arts,Bachelors,25-30,1,1,41,Remote,Tier1_City,2,5,2,2,4,3,1,24.89,Tech,2,3,4,4,0,1,4,4,3,3,1,0,5,4,43.17
Business,Human Resources Specialist,4.156983268713585,1,1,1,1,3,1,4,1,3,0,1,4,3,0,Commerce,Masters,18-24,13,0,0,Flexible,Tier1_City,2,2,0,1,3,0,5,24.76,Tech,4,4,4,2,3,1,3,2,1,2,1,1,3,5,59.37
Computer Science,Legal Secretary,3.9552003578478336,2,0,3,1,6,1,1,2,3,4,1,3,4,0,Science,Bachelors,40+,9,0,0,Remote,Any,2,4,2,2,5,1,5,48.34,Healthcare,5,1,4,5,1,0,4,5,5,2,1,0,4,2,65.9
Law,Marketing Specialist,2.6534931426037294,9,0,3,0,2,0,1,3,1,1,0,2,3,0,Arts,Masters,25-30,7,0,0,Hybrid,Tier3_City,4,2,0,2,1,4,5,34.01,Finance,5,1,5,1,1,4,3,5,5,3,1,0,1,5,52.64
Education,Musician,3.0893807373218705,2,0,0,1,5,0,0,0,2,1,2,2,1,0,Arts,Bachelors,31-35,5,1,22,Remote,Tier1_City,5,3,4,1,2,1,2,10.93,Finance,1,2,2,1,1,3,3,1,5,4,0,1,2,4,43.87
Medicine,Biomedical Engineer,4.925435286733716,0,2,2,0,4,1,0,4,1,3,1,0,3,0,Science,Bachelors,31-35,13,0,0,Remote,Tier1_City,5,3,1,1,3,1,3,24.06,Other,1,3,3,4,1,4,4,2,2,4,1,0,4,4,54.26
Biology,Manager,2.7243595125660383,6,0,0,1,8,0,3,4,1,0,4,4,0,1,Science,PhD,25-30,14,0,0,Remote,Any,3,1,5,5,1,1,1,39.39,Finance,1,5,1,1,2,1,3,5,5,1,1,1,2,2,68.34
Business,Biologist,3.5585094454089607,9,1,2,1,1,1,2,3,2,4,0,1,1,1,Commerce,Masters,36-40,2,0,0,Remote,Tier1_City,3,1,4,5,3,5,2,22.9,Tech,2,3,4,2,2,5,5,3,1,2,1,1,3,5,39.72
Music,Geneticist,4.1288393628836895,1,1,3,0,0,1,4,4,4,3,1,3,4,0,Arts,Masters,31-35,12,1,31,Flexible,Any,2,3,1,1,4,4,4,17.55,Education,2,2,4,4,3,3,5,4,4,5,0,1,5,3,78.55
Computer Science,Lawyer,4.186608598694366,1,2,0,1,0,0,3,2,0,4,2,3,2,0,Science,Bachelors,25-30,14,0,0,Office,Any,5,2,0,3,1,4,4,49.59,Healthcare,5,2,1,3,0,2,4,5,4,4,1,1,4,5,64.43
Engineering,Manager,4.18201606345002,2,1,1,1,1,0,0,0,4,1,1,3,2,0,Science,Masters,36-40,12,0,0,Remote,Tier1_City,2,1,4,5,4,3,4,46.97,Finance,1,2,4,2,0,1,3,4,3,5,0,1,2,4,59.96
Medicine,Interior Designer,4.0168610940751295,3,0,4,1,4,0,3,2,0,0,1,3,2,1,Science,Masters,18-24,0,0,0,Remote,Tier3_City,4,2,0,3,0,4,3,47.25,Education,3,4,5,2,0,0,1,2,3,2,0,1,5,1,37.84
Chemistry,Art Therapist,2.56418088442929,7,1,4,0,4,1,1,3,0,2,1,1,3,0,Science,Masters,25-30,4,0,0,Office,Tier2_City,5,1,5,1,1,3,4,9.19,Other,4,2,2,1,1,3,4,5,4,2,1,0,4,5,39.23
Computer Science,Teacher,2.8925329824907697,8,1,0,0,0,0,4,0,2,3,4,4,3,1,Science,Masters,40+,11,0,0,Hybrid,Tier3_City,4,5,5,5,3,0,5,14.01,Manufacturing,2,1,2,1,2,4,3,4,1,4,0,1,1,3,63.75
Art,Mechanical Engineer,2.571484636806453,9,2,3,1,7,0,2,0,3,3,2,4,2,0,Arts,Masters,31-35,10,0,0,Office,Tier2_City,4,2,3,2,0,3,4,23.78,Tech,1,4,3,1,4,5,3,5,1,3,0,0,2,1,52.98
Engineering,Composer,4.026279330116916,8,2,2,0,4,0,1,1,3,2,3,1,3,1,Science,Bachelors,36-40,1,0,0,Hybrid,Tier1_City,5,3,5,1,4,1,2,42.11,Manufacturing,1,2,5,3,4,2,3,5,2,3,0,1,4,5,42.11
Chemistry,Human Resources Specialist,2.907488567046097,7,0,0,1,1,1,2,2,1,1,0,0,4,0,Science,Bachelors,31-35,12,0,0,Office,Tier3_City,2,3,5,4,4,2,4,37.63,Tech,2,4,3,2,1,1,1,1,4,4,1,0,5,1,51.47
Law,Industrial-Organizational Psychologist,3.841957246308259,0,1,1,0,2,1,4,3,3,2,1,2,3,0,Arts,Masters,36-40,1,0,0,Hybrid,Tier1_City,3,1,0,3,3,2,5,42.93,Healthcare,5,1,4,5,4,3,5,1,4,1,1,0,3,4,51.39
Education,Psychologist,3.336620016555366,5,0,0,0,2,1,2,0,0,3,3,0,2,0,Arts,Bachelors,36-40,8,0,0,Hybrid,Any,2,2,5,1,0,5,4,46.28,Other,5,2,2,4,0,1,2,2,3,3,0,0,1,4,47.62
Marketing,Construction Manager,3.595964600167825,6,0,2,1,7,0,2,4,4,3,3,4,0,0,Commerce,Masters,25-30,10,0,0,Remote,Tier2_City,3,4,4,1,5,1,1,39.7,Manufacturing,5,2,3,1,0,0,1,4,2,1,1,0,5,3,67.11
Chemistry,Risk Analyst,3.9725225397358574,3,2,0,0,4,0,3,0,3,1,1,1,0,1,Science,Bachelors,18-24,12,0,0,Hybrid,Tier1_City,1,3,1,5,2,3,5,15.3,Healthcare,5,1,3,1,3,1,2,1,4,2,1,1,2,2,49.94
Psychology,Education Administrator,3.2928497540307435,3,2,1,1,9,0,2,2,4,2,4,3,4,1,Arts,Masters,25-30,14,0,0,Remote,Tier1_City,3,3,3,5,3,1,3,16.42,Healthcare,3,2,5,2,1,5,5,1,3,5,0,0,2,1,74.77
Finance,Illustrator,4.205928001301988,0,2,4,1,9,1,1,1,0,4,0,3,2,1,Commerce,Masters,31-35,9,0,0,Hybrid,Any,5,2,4,5,4,5,4,19.57,Healthcare,1,1,4,3,3,4,3,2,3,4,1,1,4,3,56.43
Education,Chemist,4.587601886616521,8,0,3,1,2,1,4,0,3,0,1,4,4,0,Arts,Bachelors,18-24,6,0,0,Hybrid,Tier1_City,3,2,4,4,1,4,2,17.24,Manufacturing,5,2,1,1,0,4,2,3,3,5,0,1,2,5,52.11
Law,Marketing Manager,4.821792007655434,4,1,4,1,0,1,1,2,0,1,3,1,1,0,Arts,Bachelors,18-24,5,0,0,Office,Any,1,1,4,5,0,3,4,14.71,Manufacturing,5,2,5,3,2,0,2,3,3,2,0,0,1,4,42.04
Marketing,Dentist,3.45294756992982,5,1,3,0,4,0,2,3,2,1,0,3,4,1,Commerce,Bachelors,25-30,14,0,0,Remote,Tier1_City,3,4,3,1,5,1,2,38.37,Manufacturing,4,3,5,3,1,0,1,5,1,2,1,1,4,5,51.5
Business,Industrial-Organizational Psychologist,3.278870860203908,5,1,4,1,4,1,2,4,4,0,0,2,4,0,Commerce,Masters,40+,12,1,17,Hybrid,Tier2_City,2,3,4,5,2,4,1,4.6,Finance,4,4,4,5,5,2,5,2,5,3,1,1,4,2,65.05
Computer Science,Education Administrator,4.135904099165832,7,2,2,0,1,0,1,1,4,4,1,2,1,0,Science,Masters,31-35,0,0,0,Remote,Any,3,2,5,2,1,5,3,37.23,Healthcare,1,5,1,3,3,3,4,4,3,3,0,0,5,1,43.52
Education,Architect,2.964931313933042,9,2,2,1,7,1,4,4,2,3,0,1,3,1,Arts,High School,25-30,14,0,0,Hybrid,Tier1_City,5,3,1,5,0,4,5,41.71,Other,2,3,5,5,3,1,2,1,1,1,1,0,2,3,48.75
Finance,Doctor,4.315811749116996,9,1,4,1,3,0,2,0,4,2,3,1,3,0,Commerce,Masters,18-24,13,0,0,Office,Tier1_City,5,4,5,4,5,3,5,6.1,Finance,5,3,3,4,0,0,1,3,5,1,0,0,5,2,64.15
Biology,Industrial-Organizational Psychologist,4.420969050439081,2,1,2,0,6,1,1,3,1,3,3,0,3,1,Science,Bachelors,25-30,9,0,0,Office,Any,4,5,4,2,3,5,3,5.91,Tech,3,4,3,3,3,3,3,1,1,1,0,0,1,1,48.61
Psychology,Entrepreneur,3.008570924496764,4,1,0,0,0,0,1,0,2,4,2,2,3,1,Arts,Bachelors,18-24,1,0,0,Flexible,Tier2_City,2,5,2,1,5,5,1,16.42,Manufacturing,4,3,3,4,0,0,5,5,5,1,0,1,2,4,48.19
Art,Zoologist,4.682312834372748,4,0,2,0,7,0,4,0,4,0,3,3,1,0,Arts,PhD,18-24,10,1,53,Flexible,Tier3_City,2,4,0,1,3,5,1,12.79,Other,5,1,3,3,2,0,3,1,1,3,1,0,2,2,66.14
Engineering,Marketing Manager,3.585274890708772,2,0,2,0,1,1,2,1,3,3,2,3,0,0,Science,Bachelors,36-40,6,0,0,Office,Tier3_City,3,2,2,3,0,0,4,30.31,Education,2,3,1,5,3,2,3,2,2,1,0,0,2,5,48.42
Computer Science,Market Research Analyst,2.9873740102729043,6,0,4,1,6,0,4,2,2,0,1,4,3,1,Science,Bachelors,40+,14,0,0,Remote,Tier2_City,3,5,5,2,5,5,1,34.75,Tech,3,5,4,5,0,5,4,4,1,1,0,0,4,3,53.12
Art,Civil Engineer,3.515384051385159,5,1,4,1,4,1,4,2,3,4,2,0,4,0,Arts,High School,18-24,2,1,46,Remote,Tier3_City,5,2,1,3,2,0,4,32.8,Healthcare,4,1,4,4,0,5,2,1,2,4,1,1,3,3,48.2
Medicine,Biologist,3.9157759643179824,5,0,4,1,7,1,3,3,2,4,3,4,0,1,Science,Bachelors,18-24,1,0,0,Hybrid,Tier2_City,4,1,1,2,5,4,2,19.8,Healthcare,2,4,1,2,2,5,4,4,5,2,1,0,3,3,59.56
Art,Analytical Chemist,4.983748400943694,1,1,4,1,6,1,0,0,4,2,4,0,3,0,Arts,Bachelors,25-30,5,0,0,Flexible,Tier2_City,1,3,0,2,0,0,3,26.42,Other,2,4,4,2,3,4,1,2,4,3,0,0,2,2,43.84
Physics,Chemist,4.816531564418513,9,1,1,0,3,0,3,3,1,4,0,4,3,1,Science,High School,25-30,7,0,0,Hybrid,Tier1_City,3,1,1,4,1,4,2,33.08,Finance,3,4,3,2,5,3,4,5,4,3,0,1,1,2,49.96
Art,Geneticist,3.809037402386291,3,2,2,0,1,1,4,3,1,2,2,2,1,0,Arts,Masters,18-24,14,0,0,Remote,Any,2,5,1,3,1,0,2,8.61,Manufacturing,3,1,1,3,5,2,1,2,3,4,1,1,5,4,63.65
Finance,Legal Analyst,2.7785705279754764,7,2,4,1,5,1,3,3,2,3,3,4,0,0,Commerce,Bachelors,25-30,7,0,0,Flexible,Tier3_City,3,5,4,4,5,4,2,13.79,Other,4,4,3,2,2,4,2,3,5,4,1,0,4,2,70.74
Psychology,Legal Analyst,3.0662554691687727,4,0,0,0,9,1,4,0,3,3,3,4,3,0,Arts,Bachelors,18-24,10,0,0,Hybrid,Tier1_City,4,2,0,2,5,4,2,44.85,Manufacturing,3,4,4,4,2,0,2,5,1,4,0,1,3,5,64.56
Biology,Financial Controller,4.846850309491192,1,1,4,1,6,0,1,1,3,2,3,1,0,0,Science,Bachelors,31-35,1,0,0,Office,Tier2_City,2,5,2,1,3,5,5,19.09,Tech,5,5,5,2,2,5,4,1,3,2,0,0,5,5,40.32
Physics,Acoustics Specialist,3.6929666624464472,5,2,0,0,6,1,3,3,4,2,0,0,0,0,Science,Bachelors,31-35,5,1,16,Office,Tier1_City,4,2,4,2,0,5,1,40.65,Other,3,2,1,4,5,2,3,4,1,3,0,0,1,5,43.03
Chemistry,Advertising Manager,2.549381624502431,2,0,2,0,6,1,4,3,2,2,2,4,1,0,Science,Masters,31-35,11,1,26,Office,Tier2_City,2,4,4,4,3,4,3,14.8,Tech,2,2,2,4,3,4,4,5,4,4,0,1,2,4,76.31
Education,Landscape Architect,2.856111288764267,6,2,4,1,9,0,2,3,0,0,4,3,1,1,Arts,PhD,25-30,4,1,11,Office,Any,3,5,2,3,2,5,3,4.96,Tech,3,2,2,3,4,4,5,5,3,1,1,0,4,1,49.76
Physics,Biochemist,3.82280031324208,9,1,3,0,3,0,2,2,3,4,4,3,1,0,Science,Bachelors,36-40,6,1,31,Office,Tier1_City,4,4,1,3,1,4,2,26.52,Education,4,4,3,5,5,2,2,3,5,1,0,1,1,3,59.62
Art,Pharmacist,2.9048349771495907,0,2,4,0,5,0,2,2,3,3,1,2,1,0,Arts,Masters,40+,3,0,0,Office,Any,5,4,3,4,4,5,3,44.95,Education,5,1,4,3,0,1,5,1,5,4,0,0,3,1,59.81
Architecture,Advertising Manager,3.9484243762156632,4,0,3,0,2,0,0,2,3,0,3,0,2,1,Interdisciplinary,Masters,18-24,11,0,0,Hybrid,Tier1_City,2,3,5,3,4,2,4,41.51,Healthcare,3,4,3,3,0,5,5,5,3,4,1,0,2,5,57.23
Chemistry,Civil Engineer,3.419549589719611,5,0,1,1,5,1,3,4,1,0,2,2,1,1,Science,Masters,18-24,12,0,0,Office,Tier2_City,4,2,3,5,0,0,3,14.89,Healthcare,5,2,2,1,2,2,5,3,3,3,1,1,5,2,56.32
Marketing,Industrial-Organizational Psychologist,4.468116499816397,1,2,0,0,7,0,3,3,3,0,3,3,0,1,Commerce,Bachelors,25-30,1,1,40,Office,Tier2_City,4,4,5,1,0,4,2,45.77,Healthcare,3,5,1,2,2,0,3,4,1,3,1,1,2,3,40.38
Law,Biomedical Engineer,3.3341510903693368,7,1,2,1,8,1,4,4,0,2,2,3,4,0,Arts,Bachelors,18-24,9,0,0,Hybrid,Tier1_City,1,3,1,1,4,1,3,25.55,Other,5,4,3,2,4,1,2,4,1,4,1,0,3,4,60.46
Education,Education Administrator,3.746886072816812,6,0,3,1,8,1,4,1,1,3,0,3,4,0,Arts,Bachelors,25-30,2,0,0,Remote,Tier2_City,1,5,4,1,0,5,1,5.3,Manufacturing,3,4,4,4,1,2,2,1,5,5,1,1,4,2,53.36
Psychology,Biomedical Engineer,3.659483938049198,0,0,4,1,7,0,3,4,4,4,1,2,3,1,Arts,Masters,25-30,8,1,41,Hybrid,Tier3_City,3,5,2,3,1,5,2,4.31,Healthcare,3,4,2,5,0,4,2,1,5,2,1,0,5,1,71.64
Chemistry,Animator,4.679619138344105,7,2,4,1,0,0,4,0,0,2,3,2,2,0,Science,Bachelors,25-30,9,1,27,Hybrid,Tier1_City,5,4,3,3,2,3,5,25.8,Finance,1,1,1,2,1,5,4,1,3,2,0,1,1,1,50.34
Finance,Physicist,2.899128555737295,5,0,0,1,1,1,1,0,2,4,2,2,2,1,Commerce,PhD,25-30,7,1,58,Remote,Tier1_City,5,5,4,2,2,1,1,28.68,Tech,2,5,3,2,2,3,1,4,2,2,0,0,3,5,55.22
Marketing,Marketing Manager,4.676230894913105,1,0,3,1,7,0,0,2,1,1,1,4,1,0,Commerce,Bachelors,25-30,12,0,0,Office,Tier2_City,4,2,3,2,3,1,3,6.76,Other,4,5,1,5,0,2,2,2,3,2,1,0,3,4,54.51
Marketing,Interior Designer,2.605354905947113,1,2,1,1,1,0,3,4,2,0,2,2,2,1,Commerce,Bachelors,40+,8,0,0,Remote,Tier3_City,4,5,2,1,1,2,5,46.35,Manufacturing,4,5,5,2,0,4,3,1,3,2,1,0,5,5,49.36
Finance,Software Developer,3.044955033179076,1,1,1,0,0,0,4,1,2,1,4,4,3,1,Commerce,Masters,18-24,4,0,0,Remote,Any,4,1,4,5,0,0,1,36.76,Education,1,5,2,1,2,2,3,2,4,4,0,1,2,4,58.42
Biology,Astronomer,3.038629483633408,2,1,0,1,7,0,1,1,3,1,2,2,4,1,Science,Bachelors,31-35,12,0,0,Remote,Tier1_City,2,5,0,2,0,2,4,40.66,Tech,3,2,3,2,1,5,1,2,3,4,0,1,4,4,56.34
Psychology,Sound Engineer,4.885176567306219,4,0,3,1,5,1,2,3,3,0,3,0,2,1,Arts,Bachelors,18-24,4,0,0,Hybrid,Any,3,4,4,2,3,0,1,30.45,Healthcare,2,4,1,1,1,0,4,1,4,5,1,0,2,3,54.57
Biology,Electrical Engineer,3.455019297292542,1,0,0,0,2,0,2,0,3,1,2,0,2,0,Science,Masters,18-24,6,0,0,Remote,Tier2_City,3,3,0,3,3,4,5,34.19,Education,5,5,3,3,3,0,3,2,1,1,0,0,5,4,44.11
Finance,Chemist,3.9793026769054176,5,0,4,1,9,0,1,4,3,1,2,1,2,1,Commerce,PhD,25-30,6,0,0,Hybrid,Tier1_City,1,2,1,5,0,2,4,21.23,Education,1,3,4,3,3,4,1,2,2,2,0,0,5,1,52.58
Engineering,Civil Engineer,4.194061561864759,0,1,4,1,9,1,1,3,0,3,4,4,4,1,Science,Masters,18-24,0,0,0,Flexible,Any,4,2,2,1,0,3,3,34.93,Education,4,3,4,1,4,5,3,2,3,5,0,0,3,1,50.34
Computer Science,Astronomer,4.77947526132972,2,1,1,0,7,1,2,0,1,2,1,0,1,1,Science,Masters,18-24,11,1,49,Office,Tier1_City,4,3,3,2,1,0,2,48.97,Other,4,2,3,4,4,4,1,3,1,2,1,0,4,1,48.22
Medicine,Game Developer,2.805147212219543,7,1,3,1,6,1,3,1,2,0,2,1,0,1,Science,Masters,18-24,14,1,12,Flexible,Tier3_City,2,2,1,5,3,2,3,33.44,Tech,4,3,2,1,1,1,3,5,3,4,0,1,3,1,58.38
Engineering,Graphic Designer,2.5915232763037617,7,2,0,0,1,1,4,1,0,0,4,4,3,1,Science,PhD,25-30,13,0,0,Hybrid,Tier3_City,4,4,1,5,1,3,2,19.06,Manufacturing,3,3,3,4,2,0,4,1,3,4,1,1,3,2,70.03
Psychology,Conductor,4.250074901162407,5,0,0,0,8,0,2,0,4,3,3,1,4,1,Arts,Bachelors,31-35,4,0,0,Flexible,Tier2_City,4,4,5,1,5,1,2,16.41,Tech,5,3,3,5,1,3,4,3,1,2,1,0,3,3,47.43
Psychology,Game Developer,3.505942458917457,5,2,0,0,3,0,3,1,0,3,1,3,0,1,Arts,High School,18-24,7,0,0,Office,Tier2_City,3,3,5,5,0,5,5,48.28,Finance,5,2,3,5,0,0,3,1,3,2,0,0,1,5,44.03
Biology,Game Developer,3.4892886078291903,3,1,2,1,9,0,3,4,1,4,0,1,4,0,Science,Bachelors,31-35,6,0,0,Flexible,Tier2_City,4,4,4,5,4,4,4,11.7,Healthcare,5,4,3,1,3,0,3,5,2,5,0,1,3,5,50.75
Marketing,Surgeon,4.812888419205949,8,0,3,1,2,0,0,3,2,4,0,0,1,0,Commerce,Bachelors,18-24,10,1,56,Remote,Tier1_City,2,1,4,5,4,4,4,40.89,Other,3,2,2,4,3,3,5,2,3,4,1,1,4,2,58.18
Marketing,Psychologist,3.4744462442403257,5,2,2,1,3,1,4,2,2,1,2,2,0,0,Commerce,Masters,31-35,1,1,51,Remote,Tier3_City,2,4,5,2,5,1,1,24.87,Manufacturing,4,1,5,3,5,5,2,3,4,2,1,1,2,5,50.6
Education,Psychologist,4.447272737610823,1,0,1,0,0,0,1,4,3,1,1,0,3,1,Arts,Masters,25-30,13,1,30,Remote,Any,5,2,5,1,0,2,3,23.86,Other,4,1,5,1,1,5,4,1,1,5,0,0,5,2,51.82
Physics,AI Researcher,4.409293332767694,5,1,2,0,4,1,4,2,1,4,1,1,2,1,Science,Masters,31-35,7,0,0,Flexible,Tier2_City,5,3,0,5,3,5,5,38.13,Manufacturing,3,3,1,1,0,0,3,2,4,1,1,1,3,5,54.13
Medicine,Astronomer,2.826805919193979,5,1,1,1,7,0,1,4,0,1,0,3,2,0,Science,High School,40+,1,1,35,Hybrid,Any,1,1,0,5,4,1,3,9.96,Healthcare,2,3,2,4,1,2,2,4,2,5,1,1,5,5,39.13
Physics,Software Developer,4.365550329030548,2,0,3,1,4,0,1,1,3,0,0,4,0,1,Science,Masters,36-40,9,0,0,Hybrid,Tier2_City,2,4,1,2,3,3,1,24.92,Finance,3,4,2,5,5,2,3,3,3,5,1,1,3,3,59.66
Chemistry,Financial Analyst,4.119500319685121,9,2,1,0,9,0,1,1,1,4,4,1,0,1,Science,Bachelors,18-24,0,0,0,Hybrid,Tier2_City,2,1,1,1,4,5,1,4.68,Education,3,3,2,3,1,0,2,3,1,2,1,0,1,4,37.18
Business,Paralegal,2.862672403113801,2,2,1,1,0,1,2,3,0,4,0,4,4,1,Commerce,Masters,36-40,10,0,0,Office,Tier2_City,3,5,4,3,3,0,5,34.51,Healthcare,4,1,4,4,1,0,2,4,1,1,1,0,1,4,54.81
Computer Science,Landscape Architect,4.983474126233721,6,0,2,1,3,0,2,3,3,2,0,1,3,0,Science,Masters,18-24,10,1,38,Flexible,Tier1_City,5,5,4,2,4,2,1,5.74,Education,5,3,2,4,0,3,4,2,4,3,0,1,3,2,61.63
Law,Lawyer,4.432298539974314,0,2,1,1,4,0,2,2,2,0,0,1,0,0,Arts,Bachelors,40+,13,0,0,Office,Any,1,1,3,1,3,5,5,7.1,Healthcare,4,4,4,3,3,0,5,5,2,1,0,0,5,1,43.82
Medicine,Market Research Analyst,2.6877163748361834,0,0,2,0,3,0,0,3,4,1,2,1,2,1,Science,Bachelors,25-30,10,0,0,Office,Tier3_City,3,5,2,5,5,0,1,42.71,Tech,2,1,5,1,2,4,1,4,4,3,0,1,3,3,57.32
Music,Fluid Mechanics Engineer,4.473164547298278,4,2,0,1,4,1,0,3,2,3,0,1,1,1,Arts,Bachelors,25-30,2,0,0,Hybrid,Any,3,5,3,1,1,1,4,23.82,Other,1,3,5,1,5,2,3,4,5,5,0,1,2,1,45.91
Law,Financial Analyst,4.6152477902357,1,0,0,1,3,1,0,2,2,4,0,3,3,1,Arts,Masters,18-24,2,0,0,Hybrid,Tier2_City,5,5,2,1,3,4,5,12.45,Finance,1,4,4,2,4,0,2,1,2,1,0,1,3,3,37.83
Architecture,Brand Manager,4.833888262730145,8,1,0,0,5,1,1,3,1,1,0,4,4,1,Interdisciplinary,PhD,18-24,5,0,0,Flexible,Any,3,3,1,1,1,5,4,30.85,Other,3,4,3,3,0,4,5,3,3,4,0,1,5,1,53.8
Education,Financial Analyst,4.029502411027247,6,2,2,1,3,1,4,2,1,4,1,4,4,0,Arts,Masters,31-35,11,0,0,Office,Tier2_City,5,3,4,3,1,5,4,27.41,Finance,1,1,5,4,3,5,2,5,5,3,1,1,3,2,68.71
Marketing,Legal Consultant,4.894404075196228,5,2,3,1,5,0,4,0,3,1,3,1,3,0,Commerce,Bachelors,36-40,2,0,0,Office,Tier2_City,2,5,3,1,0,0,5,22.31,Healthcare,5,1,3,2,1,0,3,5,4,1,0,0,5,2,43.0
Music,Organic Chemist,4.151980830660257,7,0,3,1,0,0,2,1,4,4,0,4,2,0,Arts,Bachelors,31-35,6,0,0,Remote,Any,2,2,5,3,5,0,3,45.55,Finance,4,1,1,2,2,1,1,5,4,2,0,0,3,3,59.53
Computer Science,Manager,3.971211754017583,9,2,0,1,0,1,1,1,4,0,4,2,0,0,Science,Masters,31-35,7,0,0,Remote,Tier2_City,5,5,2,5,1,4,2,38.22,Education,2,4,4,2,4,4,4,3,2,3,1,1,3,5,55.69
Psychology,Biotechnologist,3.946595862402031,2,1,4,0,5,0,1,1,4,1,4,4,4,0,Arts,Masters,31-35,2,0,0,Remote,Tier2_City,4,5,5,3,2,0,1,10.12,Finance,2,1,1,1,5,2,1,5,2,3,1,1,1,3,49.85
Computer Science,Biochemist,3.230418076963105,9,1,3,1,8,1,4,0,3,0,2,1,2,0,Science,Bachelors,25-30,8,0,0,Hybrid,Tier1_City,4,5,5,5,1,0,1,29.83,Finance,2,1,4,5,4,2,4,1,4,3,1,0,4,2,57.89
Music,Pharmacist,3.072699337470522,4,2,3,0,8,1,3,0,2,2,4,0,0,0,Arts,High School,18-24,0,1,28,Hybrid,Any,1,2,0,5,3,5,3,7.17,Other,4,4,1,2,0,1,2,2,1,2,0,0,3,4,33.51
Finance,Entrepreneur,4.612090550951349,7,1,4,1,6,0,0,4,4,3,0,2,1,0,Commerce,Masters,18-24,14,0,0,Flexible,Tier1_City,4,2,2,3,1,4,2,14.5,Finance,5,4,1,4,1,4,5,1,3,4,1,0,5,5,61.32
Chemistry,Curriculum Developer,4.711775539965954,5,1,0,0,3,0,4,3,1,0,0,2,0,1,Science,Bachelors,25-30,2,0,0,Office,Tier1_City,1,5,2,2,3,4,3,45.76,Manufacturing,2,1,2,1,1,5,4,2,2,4,0,0,4,1,42.23
Music,Social Media Manager,3.6968426476314353,7,1,0,1,1,1,2,0,2,1,3,2,0,0,Arts,Bachelors,18-24,11,0,0,Remote,Tier1_City,5,4,5,4,3,5,2,24.72,Healthcare,1,1,5,5,2,4,2,3,1,5,1,0,4,5,58.42
Marketing,Surgeon,2.974147520488663,2,0,1,1,7,1,4,0,4,2,2,4,0,1,Commerce,High School,18-24,2,0,0,Remote,Tier2_City,5,1,4,1,2,1,5,44.93,Tech,5,1,4,5,4,3,3,4,4,5,1,0,2,3,54.14
Biology,Physician Assistant,3.217343926492382,1,1,4,0,4,0,3,2,1,0,2,2,0,0,Science,Bachelors,18-24,6,1,37,Office,Tier1_City,5,3,3,4,1,1,5,10.8,Tech,5,4,5,2,0,0,3,4,4,1,0,1,2,4,47.34
Chemistry,Financial Advisor,4.853168941042481,7,1,0,1,5,1,3,3,2,2,0,1,3,0,Science,Masters,18-24,10,0,0,Hybrid,Tier3_City,1,1,1,1,1,5,4,12.65,Manufacturing,5,5,2,2,1,4,5,5,1,1,1,1,3,3,50.98
Music,Aerospace Engineer,4.202053239798726,4,2,3,1,7,1,0,3,4,2,2,3,4,0,Arts,PhD,36-40,10,0,0,Office,Tier1_City,3,3,3,1,4,0,4,19.58,Other,2,2,5,1,4,3,5,5,4,1,1,0,5,5,66.61
Architecture,Doctor,4.11083242298702,2,1,4,1,1,0,4,1,2,4,0,2,4,1,Interdisciplinary,Masters,18-24,4,0,0,Hybrid,Tier3_City,1,1,1,5,4,2,5,20.22,Manufacturing,5,3,4,2,4,1,3,3,3,2,1,1,3,4,54.86
Marketing,Judge,3.985078625698947,0,2,3,0,8,1,4,0,1,1,1,0,2,1,Commerce,Bachelors,25-30,3,0,0,Remote,Tier1_City,3,2,5,1,0,1,4,38.03,Tech,2,2,2,1,3,1,3,4,1,4,1,1,5,1,37.18
Marketing,Digital Marketing Specialist,3.7309060012577695,1,1,3,1,8,0,4,3,0,2,1,0,3,0,Commerce,Bachelors,25-30,1,0,0,Remote,Tier1_City,2,5,0,1,3,1,5,31.17,Education,1,4,3,5,2,1,4,2,3,2,1,1,4,3,41.44
Business,Interior Designer,4.488639425805919,6,0,1,0,0,1,4,1,1,2,4,1,0,1,Commerce,Bachelors,25-30,6,1,53,Hybrid,Tier3_City,2,3,5,3,2,5,3,29.0,Tech,1,5,2,4,1,3,5,3,2,2,0,1,1,1,50.54
Education,Astronomer,2.848545168413352,0,2,0,1,1,1,1,2,1,3,0,2,4,1,Arts,Bachelors,18-24,2,1,11,Hybrid,Tier1_City,3,5,5,4,4,5,1,31.31,Tech,1,4,4,4,3,2,3,4,5,3,0,1,3,5,48.68
Physics,Credit Analyst,4.771660670822744,0,2,4,0,9,0,3,2,2,1,2,4,0,0,Science,Masters,25-30,6,0,0,Office,Tier1_City,3,5,4,3,1,2,5,37.41,Healthcare,1,1,1,3,2,1,4,2,3,5,1,0,4,3,61.47
Medicine,Zoologist,3.0876208201703017,7,0,4,1,9,0,1,1,0,4,2,4,3,1,Science,Bachelors,18-24,9,0,0,Hybrid,Any,4,2,2,1,0,2,5,44.96,Tech,5,3,5,3,3,3,2,5,5,5,1,0,3,3,57.72
Law,Manager,2.776320646308315,1,2,4,1,8,1,4,1,2,4,4,0,4,0,Arts,Bachelors,25-30,11,1,20,Flexible,Tier1_City,3,3,5,5,2,4,5,22.49,Tech,5,2,1,3,1,3,5,5,4,4,0,1,5,3,67.56
Education,Legal Analyst,2.8811202469653834,0,2,2,1,1,1,0,0,3,1,4,1,1,0,Arts,Bachelors,18-24,6,0,0,Flexible,Tier1_City,3,4,3,3,5,5,4,40.74,Finance,2,4,3,4,0,0,5,4,3,4,0,0,3,4,53.5
Physics,Art Therapist,3.891221209359132,5,1,2,0,5,1,0,0,3,1,1,1,2,1,Science,Bachelors,25-30,10,0,0,Hybrid,Tier1_City,5,2,3,3,1,1,4,26.27,Manufacturing,1,5,1,2,3,1,3,2,3,3,1,1,1,3,44.02
Education,Market Research Analyst,3.3754841570121776,4,1,0,1,8,1,0,1,0,1,2,0,4,1,Arts,Bachelors,31-35,1,0,0,Hybrid,Tier1_City,1,5,1,2,1,3,4,36.94,Tech,3,1,5,1,3,5,3,3,4,3,0,1,3,4,33.32
Engineering,Animator,4.246823218462092,3,2,1,1,2,0,3,1,0,1,1,2,3,0,Science,Bachelors,25-30,6,0,0,Office,Tier1_City,3,3,3,1,5,3,4,44.12,Tech,1,5,1,4,4,2,3,4,3,2,1,0,4,2,45.57
Physics,Software Developer,3.713618286661907,7,1,0,1,4,1,0,3,0,0,1,3,4,0,Science,PhD,25-30,5,1,34,Remote,Tier3_City,5,2,2,5,3,0,3,4.51,Education,4,3,2,3,5,3,3,4,4,3,1,1,4,3,54.38
Business,Data Scientist,2.887501565013155,7,2,4,1,6,1,2,0,1,3,4,1,0,0,Commerce,Bachelors,25-30,9,1,55,Flexible,Tier1_City,3,2,1,3,3,1,5,28.69,Tech,3,5,4,3,1,2,1,1,2,5,1,1,4,2,57.68
Education,Paralegal,4.179334070877709,9,1,3,1,4,0,0,4,2,2,3,1,4,1,Arts,Bachelors,36-40,3,1,19,Hybrid,Tier1_City,4,4,2,3,4,3,3,49.5,Healthcare,4,5,1,2,3,2,3,1,1,1,1,1,1,1,39.95
Education,Financial Analyst,4.3569713337722416,1,1,2,0,4,0,4,0,3,4,1,3,0,0,Arts,Masters,18-24,10,0,0,Flexible,Any,3,1,5,5,4,1,4,26.32,Other,3,1,4,3,5,1,2,1,3,1,0,0,1,5,61.91
Physics,Human Resources Specialist,2.8570682760580204,2,2,1,1,1,1,2,1,4,1,2,1,3,0,Science,PhD,31-35,4,1,53,Flexible,Tier2_City,3,3,1,1,1,5,3,43.62,Education,2,5,4,3,0,1,3,4,2,2,0,1,1,3,53.0
Education,Art Therapist,3.728384561087538,9,2,3,0,9,1,0,0,2,1,0,2,0,0,Arts,Masters,31-35,11,0,0,Hybrid,Tier1_City,5,3,2,2,1,1,5,11.74,Tech,5,1,4,1,3,0,3,2,1,2,0,0,2,1,38.61
Art,Credit Analyst,4.674916909103782,1,1,3,1,7,0,0,3,1,1,3,0,4,0,Arts,Masters,25-30,7,0,0,Remote,Tier2_City,3,3,1,3,4,3,5,31.4,Other,2,3,2,2,2,5,2,3,3,5,1,1,4,2,57.59
Engineering,Microbiologist,4.990298722453381,5,2,4,1,0,1,0,2,3,4,4,4,1,0,Science,Bachelors,25-30,4,0,0,Hybrid,Tier1_City,5,3,4,2,5,1,4,43.9,Healthcare,3,4,4,5,0,5,4,3,2,2,0,0,4,4,53.07
Marketing,Psychologist,3.768240645666057,7,1,4,1,9,0,2,0,4,3,2,2,1,0,Commerce,Bachelors,25-30,2,0,0,Hybrid,Tier2_City,1,1,3,4,4,2,5,23.28,Manufacturing,1,1,1,5,0,2,2,5,3,5,0,0,1,4,57.53
Biology,Pharmacist,3.472896269427939,9,2,0,0,0,0,3,1,3,0,4,0,2,0,Science,Bachelors,18-24,1,0,0,Office,Tier2_City,5,2,2,1,1,0,3,25.88,Tech,2,4,4,3,3,2,5,4,1,4,0,0,2,2,43.37
Business,School Counselor,4.225537515567566,5,2,4,0,8,0,1,1,1,2,3,0,1,0,Commerce,Masters,18-24,5,1,17,Remote,Any,1,2,0,4,2,4,2,6.85,Manufacturing,3,2,2,3,3,3,2,1,3,1,0,0,2,1,43.04
Music,Financial Analyst,3.0350295389166893,2,0,2,1,0,1,1,2,4,2,3,4,0,0,Arts,Masters,18-24,5,0,0,Hybrid,Tier1_City,3,1,5,4,1,3,5,4.98,Tech,1,5,4,1,4,3,5,3,4,5,1,0,1,3,62.68
Education,Entrepreneur,4.633979401525352,2,2,1,0,6,0,1,0,2,2,2,4,1,1,Arts,Bachelors,18-24,6,0,0,Flexible,Tier3_City,1,2,4,4,2,5,3,25.03,Education,5,4,1,5,1,5,1,2,2,3,0,0,2,1,51.46
Architecture,School Counselor,2.7605496300138377,8,2,3,0,8,1,4,0,0,4,3,4,4,0,Interdisciplinary,Bachelors,25-30,7,1,10,Flexible,Tier1_City,2,1,4,1,2,4,3,42.64,Education,3,5,2,2,4,5,2,2,3,5,0,0,1,4,58.57
Art,Microbiologist,2.5198677076996523,4,2,3,1,1,0,3,0,0,3,2,1,2,0,Arts,Masters,36-40,3,1,45,Remote,Tier2_City,2,1,5,1,1,0,3,46.77,Other,4,1,3,2,2,3,4,4,4,1,0,0,4,3,39.86
Chemistry,Artist,2.793500303643506,7,2,3,0,4,0,4,4,1,0,0,3,3,1,Science,Bachelors,18-24,11,0,0,Flexible,Tier1_City,5,2,2,5,0,2,5,33.96,Healthcare,4,5,3,4,1,2,1,2,1,1,1,1,3,2,50.08
Art,Art Director,3.186799375935196,0,0,1,1,8,0,0,1,4,1,2,0,1,0,Arts,Masters,36-40,7,0,0,Remote,Tier2_City,4,2,2,2,4,2,2,41.84,Finance,4,3,1,4,4,0,3,5,1,3,1,0,4,2,47.7
Chemistry,Paralegal,3.2749866178032563,7,2,3,0,7,1,4,1,0,1,0,4,0,0,Science,Masters,40+,11,1,15,Office,Tier2_City,3,1,0,2,3,2,4,37.54,Other,1,4,5,2,4,4,4,4,4,5,0,1,4,5,61.21
Music,Architect,2.8233910672041254,8,2,1,1,4,1,3,3,4,3,2,2,1,0,Arts,Masters,40+,0,1,16,Remote,Any,2,4,5,5,1,2,4,35.97,Other,1,5,4,4,3,3,2,4,1,1,1,0,5,2,43.31
Business,Analytical Chemist,3.28280128479098,9,1,2,1,0,0,0,1,3,3,3,1,3,0,Commerce,Masters,36-40,5,0,0,Flexible,Any,4,5,2,5,2,3,5,39.14,Healthcare,2,4,5,1,4,4,2,5,4,5,1,1,4,5,56.71
Chemistry,Acoustics Specialist,3.973009524289655,1,1,2,0,5,1,1,3,2,0,4,4,4,0,Science,Masters,25-30,5,0,0,Office,Tier2_City,5,3,5,4,1,3,5,26.75,Tech,1,4,2,3,3,0,4,5,1,2,1,1,5,2,48.08
Architecture,Credit Analyst,3.448975898723332,7,2,0,0,9,1,1,4,2,1,4,4,4,1,Interdisciplinary,Bachelors,18-24,2,0,0,Hybrid,Tier1_City,1,1,0,5,4,1,1,24.52,Manufacturing,3,3,4,2,0,2,3,2,5,5,1,1,2,4,59.76
Chemistry,Aerospace Engineer,2.5937905722595955,7,0,2,0,2,0,2,0,2,0,2,2,3,0,Science,Masters,25-30,8,1,10,Remote,Tier2_City,3,2,2,3,5,5,2,10.48,Manufacturing,4,1,5,5,1,5,3,1,5,1,0,1,1,4,59.43
Medicine,Astronomer,2.819542956364569,5,1,1,1,4,1,3,3,2,0,4,3,4,0,Science,Masters,25-30,11,0,0,Remote,Tier3_City,1,1,0,2,2,1,3,42.66,Tech,5,5,1,5,3,4,1,3,3,3,1,0,2,5,68.38
Chemistry,Nuclear Physicist,4.683280130526312,7,1,4,0,9,0,4,0,2,4,1,2,4,0,Science,Bachelors,36-40,11,0,0,Office,Tier1_City,3,2,1,5,3,5,3,5.1,Finance,4,2,2,2,5,1,4,4,1,2,0,1,2,3,55.13
Chemistry,Inorganic Chemist,4.823457126844676,1,2,0,0,9,1,0,2,2,3,2,0,2,1,Science,High School,40+,4,1,15,Flexible,Tier2_City,2,1,3,3,3,0,4,15.57,Finance,3,4,4,4,5,2,5,4,5,3,1,0,3,5,43.27
Education,Social Media Manager,4.233835517061589,8,1,3,0,1,1,4,0,2,1,0,0,1,1,Arts,Bachelors,25-30,14,0,0,Office,Tier1_City,4,2,3,3,3,1,5,27.44,Finance,5,1,3,4,5,1,4,3,4,3,0,1,1,1,57.3
Chemistry,Curriculum Developer,4.068867455885912,2,0,2,1,2,1,3,1,2,4,2,2,3,1,Science,Bachelors,25-30,0,1,54,Office,Tier1_City,5,4,2,3,5,0,2,48.67,Tech,2,2,4,2,5,5,3,2,1,4,0,1,3,1,44.83
Art,Zoologist,4.642116139781699,7,1,0,1,2,0,1,3,1,4,4,0,2,0,Arts,Masters,18-24,6,0,0,Office,Tier1_City,3,5,2,3,0,0,4,39.94,Education,1,4,2,2,4,0,3,3,2,3,1,0,3,5,48.34
Business,Actuary,4.177130137383606,7,1,2,1,4,0,4,0,1,3,3,1,0,0,Commerce,Masters,18-24,9,0,0,Flexible,Any,2,2,3,4,2,0,2,20.33,Other,3,2,3,2,5,4,1,1,4,5,0,1,3,5,67.42
Finance,Astronomer,2.8815678492239547,0,2,3,1,4,1,3,4,4,3,4,1,4,0,Commerce,Bachelors,25-30,14,0,0,Office,Tier1_City,5,4,3,3,5,2,5,36.56,Education,1,5,1,1,3,4,4,2,5,1,1,1,4,3,66.52
Physics,Brand Manager,3.8590996945607663,7,0,3,0,9,1,1,3,1,0,0,0,0,1,Science,Bachelors,25-30,13,1,55,Remote,Tier1_City,3,5,0,4,2,4,3,46.77,Tech,2,5,4,5,0,0,2,4,5,1,1,1,2,2,49.61
Physics,Biotechnologist,4.272196900427026,7,2,1,0,7,0,4,3,2,2,1,1,3,0,Science,PhD,36-40,2,1,21,Office,Any,2,2,0,4,5,4,1,28.33,Education,5,4,5,1,2,5,5,3,5,5,1,0,1,4,61.87
Biology,Chemist,3.5330164005301614,8,0,1,0,7,1,4,2,0,2,3,0,2,0,Science,Bachelors,25-30,9,1,12,Hybrid,Tier2_City,5,3,1,3,5,3,2,24.71,Finance,3,4,5,1,2,0,4,3,3,3,0,1,4,2,53.3
Computer Science,Accountant,3.718406369588586,3,2,2,1,8,1,2,3,3,1,2,2,2,1,Science,Bachelors,36-40,9,0,0,Flexible,Tier3_City,1,1,1,2,0,0,3,28.99,Education,5,5,1,3,0,2,5,2,3,4,1,1,3,5,59.22
Physics,Conductor,4.21747300804677,3,2,2,0,3,0,1,4,0,3,1,4,4,1,Science,Masters,31-35,10,0,0,Hybrid,Tier1_City,4,1,0,3,2,2,2,17.64,Tech,3,1,2,1,4,5,4,4,2,4,0,1,3,4,57.9
Business,Artist,2.884854105918264,6,2,1,1,6,1,2,1,0,3,2,4,1,0,Commerce,Bachelors,36-40,3,0,0,Remote,Tier2_City,4,1,1,3,5,1,2,45.65,Other,2,2,1,5,1,5,3,3,2,5,0,0,3,4,53.38
Architecture,Dentist,2.6434708358536274,9,0,1,1,8,1,1,2,1,3,1,4,1,1,Interdisciplinary,Bachelors,18-24,5,0,0,Remote,Tier1_City,1,2,4,3,0,1,2,40.47,Education,2,4,2,4,1,0,5,5,4,5,1,1,3,5,54.48
Architecture,Zoologist,3.454773481329404,8,1,3,0,2,1,1,2,1,1,2,4,2,1,Interdisciplinary,Bachelors,36-40,7,0,0,Office,Tier2_City,4,3,5,2,1,3,5,36.16,Education,2,4,3,5,3,3,4,3,2,1,1,1,5,4,45.73
Chemistry,Biochemist,4.4294636756680745,3,1,3,0,0,0,3,4,3,1,4,4,1,0,Science,Bachelors,31-35,12,1,58,Remote,Tier2_City,4,3,0,1,4,3,4,30.69,Education,1,3,2,2,2,1,2,3,4,5,1,0,5,2,76.09
Psychology,Marketing Specialist,4.046663314714696,3,2,2,1,6,0,3,1,1,2,1,1,1,1,Arts,Masters,18-24,3,0,0,Flexible,Tier2_City,3,3,1,1,5,0,2,48.57,Education,4,2,3,2,0,0,3,1,1,2,0,0,3,4,42.08
Business,Landscape Architect,3.0131718820873017,8,1,0,1,4,0,0,1,0,0,3,3,0,1,Commerce,Bachelors,18-24,14,1,49,Remote,Tier2_City,2,5,1,4,3,0,5,16.99,Other,5,5,4,2,4,3,2,1,3,3,1,1,5,2,49.0
Computer Science,Curriculum Developer,3.181302651002328,4,1,1,1,2,0,1,3,4,0,1,2,2,1,Science,Bachelors,36-40,11,1,17,Remote,Tier3_City,1,2,2,4,0,1,1,16.31,Tech,3,4,4,1,0,4,1,3,5,2,0,1,1,2,55.26
Computer Science,Artist,3.5786966796439432,5,2,0,1,8,0,4,3,4,4,4,4,2,0,Science,Masters,18-24,8,0,0,Remote,Tier2_City,2,4,2,2,0,1,4,14.38,Healthcare,5,4,1,3,2,0,1,3,4,5,0,0,3,1,76.26
Psychology,Interior Designer,3.021274775806164,0,2,4,0,8,0,0,1,3,2,0,2,2,1,Arts,Masters,25-30,7,1,9,Remote,Tier2_City,4,5,2,5,5,1,5,37.86,Education,4,5,1,4,0,1,1,1,2,3,0,1,5,4,54.65
Finance,Digital Marketing Specialist,3.583827120488474,2,1,4,0,5,1,4,2,1,0,4,0,4,1,Commerce,High School,25-30,9,0,0,Hybrid,Tier1_City,2,2,3,1,0,1,1,40.47,Healthcare,1,2,4,1,0,1,3,5,1,5,1,1,5,5,46.55
Finance,Pharmacist,3.7491682017810337,7,2,1,1,3,0,4,3,0,4,2,4,0,1,Commerce,Bachelors,31-35,9,1,28,Hybrid,Any,5,3,5,4,1,4,4,31.06,Other,1,1,5,2,0,2,2,4,2,4,0,0,2,3,56.98
Finance,Special Education Teacher,3.633644082748697,8,1,4,1,1,0,0,0,3,2,0,0,4,0,Commerce,Masters,36-40,5,0,0,Remote,Tier1_City,1,2,3,1,0,0,5,33.64,Tech,4,5,3,5,3,4,4,2,5,1,1,0,2,1,43.51
Education,Interior Designer,2.75633935677169,1,2,4,1,4,1,2,4,1,0,1,0,1,1,Arts,Bachelors,25-30,6,0,0,Remote,Tier2_City,1,3,3,2,4,0,1,19.4,Manufacturing,3,1,4,2,4,4,3,3,1,5,0,0,1,2,44.98
Music,Chemical Engineer,3.365232855614475,5,2,3,0,8,0,4,1,2,1,2,1,2,1,Arts,Bachelors,25-30,7,0,0,Hybrid,Tier1_City,1,4,0,2,4,1,5,4.87,Healthcare,4,4,5,5,1,1,4,4,2,2,0,1,3,1,50.03
Chemistry,Data Scientist,3.2025637251797487,0,2,2,0,1,1,3,3,4,2,3,0,2,0,Science,Masters,40+,1,1,35,Office,Any,3,3,2,5,3,2,1,14.92,Tech,1,1,2,4,4,3,3,3,4,1,0,0,2,1,54.36
Architecture,Music Teacher,4.266877333929752,2,1,1,1,3,0,1,3,3,3,3,0,2,0,Interdisciplinary,Masters,31-35,4,1,8,Hybrid,Any,2,5,2,5,1,1,2,30.46,Manufacturing,1,1,4,2,2,1,5,1,2,4,0,0,3,3,51.96
Physics,Biochemist,4.834764114250236,4,2,4,1,2,1,0,2,3,1,3,1,3,1,Science,Masters,36-40,12,0,0,Remote,Tier1_City,2,2,0,2,4,5,2,41.21,Education,5,5,5,4,1,0,1,3,3,4,0,1,2,5,63.81
Finance,Illustrator,4.547347143822181,2,0,0,1,9,1,0,2,0,0,0,4,1,0,Commerce,Masters,25-30,6,1,39,Hybrid,Tier3_City,3,1,3,4,5,3,4,39.53,Other,3,4,4,2,5,2,1,4,3,4,0,0,3,3,48.85
Chemistry,Dentist,3.787019917220753,5,0,0,1,8,1,0,4,1,2,4,4,4,0,Science,Masters,18-24,7,0,0,Hybrid,Tier1_City,1,3,5,1,2,5,1,11.44,Other,3,2,2,2,3,5,5,2,1,5,1,0,5,2,59.45
Business,Paralegal,4.456946461707425,7,0,3,1,7,0,1,0,4,0,3,3,2,1,Commerce,Bachelors,25-30,4,1,33,Hybrid,Tier1_City,3,3,1,3,2,2,2,5.42,Tech,1,3,2,5,1,0,2,1,3,4,1,0,5,5,54.12
Finance,Clinical Psychologist,3.9831305741669945,1,0,1,0,0,1,4,4,3,4,1,1,4,1,Commerce,Masters,31-35,2,0,0,Hybrid,Tier3_City,3,1,4,5,2,3,4,42.98,Finance,4,1,3,3,1,4,1,5,2,1,1,1,1,5,48.81
Biology,Astronomer,2.5152372292169725,0,0,0,1,9,1,3,3,4,2,2,2,2,0,Science,Bachelors,18-24,14,0,0,Flexible,Tier1_City,4,5,2,3,5,2,3,6.55,Manufacturing,1,4,2,5,1,0,1,3,5,5,1,0,4,1,77.06
Business,Manager,3.8319347885692463,7,1,0,1,2,0,0,2,4,0,2,3,4,0,Commerce,Bachelors,25-30,5,0,0,Remote,Tier1_City,1,4,3,4,0,3,2,21.49,Finance,5,3,2,1,0,4,2,2,3,5,0,0,5,1,49.95
Chemistry,Accountant,3.1737071014783047,3,0,0,1,9,1,2,4,0,0,1,3,0,1,Science,Masters,18-24,4,0,0,Remote,Tier2_City,5,4,1,5,5,1,2,7.43,Other,4,2,3,4,2,2,2,4,4,3,1,1,2,4,52.22
Art,Animator,4.895609522569874,5,1,0,0,1,0,4,3,4,1,1,3,0,0,Arts,Masters,25-30,7,0,0,Remote,Tier3_City,4,5,2,3,0,1,5,29.51,Other,1,3,4,4,5,4,5,1,2,1,0,0,3,5,56.91
Education,Industrial-Organizational Psychologist,2.9196699494393803,2,1,3,1,9,1,4,2,3,0,4,1,3,1,Arts,Bachelors,36-40,8,0,0,Hybrid,Tier1_City,1,2,2,4,2,2,3,20.08,Education,3,2,4,3,3,2,1,2,3,5,1,0,3,3,61.87
Chemistry,Lawyer,3.738969156626849,8,0,3,1,6,1,4,2,4,3,3,1,0,0,Science,PhD,18-24,8,0,0,Remote,Tier1_City,1,4,4,1,3,3,1,12.52,Education,5,3,3,2,5,3,5,5,1,1,0,1,1,3,63.88
Chemistry,Musician,4.716777750554112,8,0,0,1,0,1,2,0,2,4,3,1,4,0,Science,High School,31-35,11,0,0,Hybrid,Tier1_City,1,5,3,4,3,4,4,30.97,Healthcare,1,2,4,4,2,3,3,3,5,5,0,1,5,1,62.44
Architecture,Legal Secretary,4.839099781590536,5,0,2,1,1,0,3,3,2,3,4,3,1,0,Interdisciplinary,Bachelors,36-40,11,1,42,Flexible,Tier1_City,2,3,5,5,0,2,3,20.08,Other,1,1,4,3,0,2,2,1,5,4,1,0,4,4,70.91
Art,Architectural Technologist,2.732555911879195,1,1,1,0,0,0,2,4,3,3,1,2,0,0,Arts,Bachelors,18-24,5,0,0,Remote,Tier1_City,1,1,0,2,2,2,1,10.84,Education,2,3,5,1,3,1,2,2,5,3,1,0,4,5,55.31
Chemistry,Paralegal,3.5609850047729514,0,2,4,1,9,1,1,0,3,1,0,3,1,0,Science,Masters,31-35,14,0,0,Hybrid,Any,1,2,1,1,5,5,2,35.9,Healthcare,4,2,3,4,5,2,1,4,5,2,1,0,4,1,62.41
Physics,Advertising Manager,4.468355883365449,2,2,4,0,9,0,2,0,2,2,0,0,4,0,Science,Masters,40+,3,0,0,Office,Tier1_City,5,2,1,3,3,0,4,42.33,Manufacturing,2,4,3,1,0,4,4,4,4,3,1,1,4,5,44.79
Physics,Civil Engineer,3.3286247264001525,9,0,3,1,6,1,4,4,1,1,4,0,4,1,Science,Bachelors,40+,3,0,0,Remote,Tier2_City,1,3,3,5,0,2,4,15.87,Finance,3,5,1,5,3,3,5,5,3,3,0,0,5,1,47.98
Art,Surgeon,4.917317006013859,8,1,1,1,6,1,4,4,3,3,3,3,1,1,Arts,Masters,18-24,8,1,44,Remote,Any,3,4,1,2,5,4,3,11.76,Manufacturing,4,3,5,4,3,5,2,3,5,1,1,1,5,4,71.99
Medicine,Human Resources Specialist,3.478442223568529,8,0,3,0,1,1,0,1,1,0,1,4,0,0,Science,Bachelors,18-24,3,1,26,Hybrid,Tier2_City,1,2,0,4,2,1,5,6.54,Finance,5,3,4,4,4,3,2,5,4,1,1,1,4,5,36.13
Physics,Chemist,3.260544226062205,2,1,0,0,9,1,2,1,4,3,3,3,1,0,Science,Masters,18-24,7,0,0,Remote,Tier1_City,1,1,1,2,1,3,1,27.81,Tech,4,3,1,2,0,2,1,2,4,2,1,1,3,1,57.77
Biology,Physicist,3.323046271311173,8,2,4,0,8,0,4,2,1,0,1,3,0,0,Science,Bachelors,31-35,8,0,0,Office,Tier2_City,1,3,3,5,2,0,3,42.07,Manufacturing,1,3,5,1,2,1,1,1,5,1,0,0,3,4,53.5
Law,Microbiologist,4.485794980589544,0,0,2,0,4,1,0,3,2,4,4,1,2,1,Arts,Bachelors,31-35,4,1,32,Remote,Any,2,2,0,5,2,3,5,14.79,Tech,1,5,4,5,5,2,4,1,5,4,1,1,3,2,58.85
Chemistry,Software Developer,4.537493917125986,1,0,3,1,3,1,1,3,1,3,1,1,1,0,Science,PhD,31-35,12,1,13,Hybrid,Tier1_City,4,3,4,2,5,1,5,24.65,Finance,1,3,5,3,0,4,3,2,4,1,0,0,2,3,60.07
Medicine,Musician,2.954471467561356,5,2,4,1,0,1,0,3,3,4,0,2,2,0,Science,Bachelors,25-30,5,0,0,Office,Tier1_City,2,4,5,4,5,2,5,10.56,Other,4,1,2,5,5,4,3,1,4,2,1,0,5,4,53.64
Education,Artist,3.661029230226522,3,0,1,0,8,0,2,0,0,4,0,4,2,0,Arts,Bachelors,18-24,2,0,0,Remote,Tier1_City,5,5,3,2,4,5,4,22.0,Other,1,1,4,4,0,0,1,2,1,5,1,0,3,4,45.81
Medicine,Physicist,2.675384597683361,7,0,1,1,1,0,3,0,3,3,0,0,4,0,Science,Masters,25-30,11,0,0,Remote,Tier2_City,5,3,5,5,4,4,1,3.73,Healthcare,1,4,5,1,0,1,4,5,4,1,0,1,5,5,52.96
Marketing,Advertising Manager,4.202013631993591,1,1,4,1,0,1,1,2,0,1,1,4,1,0,Commerce,PhD,25-30,4,0,0,Remote,Tier1_City,3,4,4,5,5,0,1,45.8,Manufacturing,2,5,5,4,4,3,1,3,1,3,0,1,4,5,50.97
Music,Web Developer,3.2121270834433107,2,0,0,0,6,1,1,3,4,2,2,2,3,0,Arts,Bachelors,31-35,4,1,46,Flexible,Tier3_City,3,2,1,3,5,4,3,34.8,Manufacturing,1,4,1,3,4,5,3,4,2,3,1,0,5,2,49.81
Art,Nurse,3.2018387796732584,6,2,4,1,1,1,1,1,1,1,3,1,3,0,Arts,Bachelors,25-30,14,0,0,Office,Tier2_City,5,2,5,3,1,4,2,18.64,Healthcare,2,1,5,3,4,4,5,4,2,1,0,0,4,3,46.69
Music,Conductor,4.143826297916928,9,0,2,0,8,0,1,3,4,0,3,1,0,0,Arts,Bachelors,25-30,13,0,0,Remote,Tier2_City,4,4,0,1,1,4,3,44.42,Healthcare,3,3,2,4,4,4,2,4,1,4,0,1,1,3,54.27
Psychology,Legal Analyst,3.466436200519751,3,2,4,1,8,0,1,3,2,4,2,0,2,0,Arts,Bachelors,25-30,1,0,0,Office,Tier3_City,4,2,5,5,2,4,1,11.6,Education,4,3,2,4,0,1,2,1,2,3,1,1,5,4,42.71
Law,Market Research Analyst,4.954155210968526,0,1,4,0,3,0,1,1,2,1,0,0,0,0,Arts,Bachelors,18-24,9,0,0,Office,Tier1_City,5,2,1,3,3,1,4,6.7,Other,2,2,5,4,2,2,4,5,4,4,1,1,2,3,48.61
Medicine,Nuclear Physicist,2.581800896576886,8,1,2,0,2,1,1,2,1,4,0,1,4,1,Science,Masters,25-30,5,0,0,Flexible,Tier3_City,1,2,3,2,1,4,3,47.3,Education,4,5,4,1,1,0,3,5,4,2,1,1,5,2,41.84
Business,Sound Engineer,4.971133534878673,5,1,0,0,3,0,4,0,0,0,0,2,0,0,Commerce,PhD,18-24,8,0,0,Hybrid,Tier2_City,2,4,4,4,2,5,2,17.52,Finance,4,2,1,2,0,5,4,4,5,1,1,1,5,1,53.26
Architecture,School Psychologist,4.671893087819596,2,1,2,1,3,0,2,4,0,0,1,0,3,0,Interdisciplinary,Bachelors,25-30,10,1,47,Flexible,Tier2_City,2,4,4,2,0,4,3,46.99,Other,5,5,4,3,5,4,4,5,3,5,1,0,3,1,48.84
Music,Investment Banker,4.297400765700504,6,1,4,0,1,1,4,4,3,0,3,1,4,1,Arts,Bachelors,18-24,14,0,0,Hybrid,Tier1_City,1,3,1,4,4,1,5,32.97,Manufacturing,2,5,5,1,2,0,4,2,5,3,0,0,1,5,64.69
Business,Architect,3.049717305093531,0,2,0,0,8,0,2,2,4,4,0,2,0,1,Commerce,Bachelors,18-24,6,0,0,Flexible,Tier2_City,4,1,3,3,3,3,2,49.06,Healthcare,1,3,2,3,1,3,2,4,5,5,1,1,3,1,65.14
Education,Music Teacher,3.0221726597056406,3,0,1,1,4,0,4,1,0,3,4,1,2,0,Arts,Bachelors,31-35,13,0,0,Remote,Tier2_City,2,5,1,1,2,1,5,38.41,Healthcare,5,3,3,4,1,0,4,4,3,3,0,0,4,2,60.96
Medicine,Dentist,4.384106350020266,0,0,1,0,4,1,4,1,0,3,1,4,4,0,Science,Masters,25-30,7,0,0,Remote,Tier2_City,2,2,5,2,5,5,4,7.96,Other,2,4,1,3,4,4,3,3,1,4,1,1,1,4,56.65
Medicine,Doctor,3.760367429670272,6,0,0,0,1,0,4,1,3,0,0,3,1,1,Science,Bachelors,31-35,1,0,0,Office,Tier1_City,3,1,2,2,0,5,1,43.05,Tech,2,1,4,5,1,5,3,4,4,3,1,1,1,5,45.7
Computer Science,Electrical Engineer,4.775645536889991,2,0,0,1,5,1,2,0,4,3,3,2,4,1,Science,Bachelors,31-35,10,0,0,Office,Tier1_City,4,1,3,2,4,2,3,9.95,Education,3,1,2,3,5,2,5,1,3,2,0,1,1,2,63.71
Engineering,Fluid Mechanics Engineer,3.837708483607569,2,2,3,1,0,1,2,0,2,0,1,3,1,1,Science,Masters,25-30,12,1,31,Hybrid,Tier2_City,5,4,3,4,0,1,3,35.53,Other,1,3,4,5,5,5,3,2,4,4,0,1,5,1,58.95
Law,Geneticist,3.5246194574895293,1,1,0,1,9,0,1,1,4,4,1,1,3,1,Arts,Bachelors,40+,13,0,0,Hybrid,Tier2_City,5,4,0,3,2,3,5,26.52,Other,3,1,5,1,2,4,2,5,1,5,1,1,3,2,55.06
Music,Cybersecurity Analyst,3.5895120752235465,0,0,1,1,7,1,1,0,1,4,1,0,0,0,Arts,Masters,18-24,8,1,20,Hybrid,Tier2_City,1,1,2,2,1,2,5,36.26,Tech,4,5,4,1,4,3,3,1,2,4,0,1,4,5,47.46
Music,Entrepreneur,3.5154263483669785,8,1,1,1,9,1,2,4,3,4,3,3,4,0,Arts,Bachelors,31-35,2,0,0,Remote,Tier2_City,2,4,4,2,4,2,1,38.95,Healthcare,1,1,1,5,0,0,1,2,5,3,0,1,5,4,60.55
Law,Inorganic Chemist,3.0833353253965714,5,2,1,1,0,0,0,1,4,4,0,2,2,0,Arts,Masters,40+,9,0,0,Remote,Tier1_City,5,3,1,1,0,0,3,40.77,Manufacturing,3,4,3,3,0,2,4,3,5,2,1,0,2,4,57.37
Marketing,Music Therapist,2.743911609040909,5,1,3,0,5,0,1,4,2,2,0,2,4,0,Commerce,PhD,36-40,4,0,0,Remote,Tier1_City,1,3,4,1,1,4,1,42.24,Manufacturing,3,1,3,1,4,5,5,4,4,2,1,0,2,4,50.78
Law,Financial Advisor,4.268635745237837,0,0,4,0,3,0,1,4,3,3,3,1,2,0,Arts,Masters,18-24,13,0,0,Hybrid,Tier2_City,3,5,3,3,3,2,5,42.82,Tech,1,1,5,3,4,2,1,5,3,2,0,1,2,3,63.86
Engineering,Electrical Engineer,2.86321436086008,6,0,1,0,9,1,4,0,4,4,3,0,4,0,Science,PhD,25-30,6,0,0,Remote,Tier2_City,4,5,5,3,2,2,5,22.39,Education,2,4,1,2,1,5,3,4,2,5,0,0,3,2,65.1
Music,Electrical Engineer,4.324301241814967,0,0,1,0,4,1,1,4,1,3,1,4,1,1,Arts,Bachelors,18-24,3,0,0,Remote,Tier2_City,2,5,1,5,2,5,2,44.79,Finance,4,4,3,2,1,0,3,1,4,4,0,1,5,2,49.07
Education,Human Resources Specialist,4.663490042539728,9,2,2,1,8,1,3,4,1,4,1,4,0,0,Arts,Bachelors,31-35,6,0,0,Flexible,Any,2,2,4,1,4,3,5,36.82,Other,5,3,2,5,2,0,4,4,5,1,0,1,1,3,61.32
Art,Animator,3.4651178302874874,4,1,4,1,8,1,4,2,3,1,0,0,1,0,Arts,Masters,31-35,7,0,0,Remote,Tier3_City,1,3,1,5,0,2,5,42.43,Manufacturing,5,4,4,5,4,0,4,2,4,5,0,1,5,5,60.46
Chemistry,Sound Engineer,3.904787538738722,6,0,3,0,7,0,1,0,0,4,1,4,2,1,Science,Masters,25-30,14,0,0,Office,Tier1_City,2,2,4,4,3,3,1,49.49,Finance,5,3,5,3,0,3,2,4,4,4,0,0,5,5,64.16
Architecture,Brand Manager,4.133857616749599,8,1,1,1,8,0,2,2,3,2,4,4,2,1,Interdisciplinary,Bachelors,25-30,12,1,51,Flexible,Tier2_City,4,3,1,5,5,4,2,8.47,Other,4,5,2,2,2,2,5,4,5,2,0,0,1,1,67.7
Psychology,Biochemist,2.8219629927384107,3,0,4,0,7,0,4,0,1,3,4,4,0,1,Arts,Bachelors,31-35,9,1,6,Remote,Tier2_City,5,1,4,2,4,5,2,20.42,Education,1,2,5,2,0,4,2,3,2,3,1,1,2,5,61.96
Architecture,Chemist,3.644943604323404,4,1,2,0,3,1,3,2,0,0,0,4,3,0,Interdisciplinary,Bachelors,25-30,13,0,0,Remote,Tier1_City,1,2,4,5,5,0,3,40.91,Tech,1,1,1,5,0,3,3,4,4,3,1,0,1,5,60.7
Business,Entrepreneur,2.68343582140892,4,0,1,0,6,1,0,3,1,0,2,0,4,1,Commerce,Bachelors,36-40,9,0,0,Hybrid,Any,4,5,1,3,4,0,4,7.06,Education,1,4,5,4,2,0,5,3,3,3,1,0,2,4,51.5
Psychology,Legal Secretary,4.443889853845382,2,1,2,0,6,1,2,0,0,3,3,4,1,0,Arts,Bachelors,31-35,3,0,0,Hybrid,Tier2_City,2,3,0,4,0,4,3,28.42,Healthcare,5,1,3,3,0,0,5,1,3,3,0,0,5,2,44.48
Marketing,Human Resources Specialist,3.184525872215658,6,0,2,0,1,1,1,1,4,1,0,4,3,1,Commerce,Masters,18-24,14,0,0,Hybrid,Tier3_City,5,5,1,2,3,4,3,43.34,Education,2,5,1,3,4,5,2,3,1,1,0,0,2,4,52.83
Engineering,Construction Manager,2.7923974103403943,1,2,4,0,3,0,3,2,0,2,1,2,0,0,Science,Bachelors,31-35,4,1,15,Hybrid,Any,4,4,5,5,0,5,3,3.89,Tech,3,2,5,1,5,4,3,3,1,4,0,0,1,2,40.48
Marketing,Actuary,2.658389686872715,7,2,3,1,4,1,1,3,4,3,3,4,1,0,Commerce,Bachelors,18-24,10,0,0,Flexible,Tier1_City,5,3,4,4,2,5,2,47.16,Tech,5,4,2,5,4,5,3,1,1,4,0,1,4,2,62.51
Education,Acoustics Specialist,3.6675387684122223,8,1,4,0,6,1,1,4,0,1,2,3,0,1,Arts,Masters,25-30,2,0,0,Remote,Tier1_City,5,3,2,4,5,1,1,48.97,Education,4,3,1,1,2,4,2,3,3,5,1,1,2,2,49.54
Music,Urban Planner,2.967803024991248,3,1,2,0,7,0,0,4,3,2,2,4,1,1,Arts,Masters,40+,4,1,13,Office,Tier1_City,1,5,3,2,1,2,5,18.15,Other,1,3,1,4,0,4,5,4,2,3,0,1,3,1,53.23
Law,Game Developer,4.765866966232636,2,0,4,1,9,0,3,4,2,2,0,3,1,0,Arts,Masters,36-40,7,1,14,Remote,Tier1_City,2,5,0,5,2,2,2,39.04,Tech,3,4,5,1,0,1,5,1,4,5,1,0,5,4,63.71
Finance,Entrepreneur,4.520028638501332,4,0,2,1,5,1,0,4,4,4,0,4,4,1,Commerce,Masters,25-30,2,1,20,Hybrid,Tier1_City,3,5,5,4,2,2,5,8.98,Healthcare,1,4,5,4,1,3,1,1,3,3,0,0,1,3,52.0
Music,Counselor,3.280006071551086,8,0,2,1,0,0,4,4,2,4,2,0,1,1,Arts,Bachelors,25-30,14,1,13,Remote,Any,3,3,1,4,5,3,5,39.32,Finance,1,5,1,1,3,1,2,3,1,1,1,0,1,3,58.05
Finance,Industrial-Organizational Psychologist,3.013855233311072,3,2,3,1,4,0,1,0,3,4,3,1,4,1,Commerce,Masters,18-24,13,1,38,Hybrid,Any,3,1,3,1,4,1,4,25.63,Education,1,2,4,5,2,4,3,3,1,1,0,1,4,1,57.25
Law,Surgeon,4.366743841850457,1,2,4,0,7,0,4,1,4,3,2,3,0,0,Arts,Bachelors,25-30,12,0,0,Office,Tier2_City,4,4,5,4,2,2,3,43.43,Tech,2,4,4,4,5,2,1,2,4,2,0,0,2,4,65.19
Music,Organic Chemist,3.959075667089464,7,0,0,1,8,1,1,0,4,1,1,1,2,1,Arts,Bachelors,18-24,4,0,0,Remote,Tier3_City,3,5,0,1,3,3,4,12.99,Other,3,3,3,3,0,3,2,1,1,3,1,1,5,1,37.91
Business,Chemist,3.9864287029432734,1,1,3,0,3,1,0,1,3,0,2,0,2,0,Commerce,Masters,25-30,9,0,0,Remote,Tier1_City,2,1,2,5,2,3,3,34.61,Other,5,2,1,5,2,1,5,5,5,3,1,0,5,1,57.69
Marketing,Financial Analyst,4.497450667255968,3,0,2,0,4,0,1,3,4,4,3,2,3,1,Commerce,PhD,18-24,0,0,0,Hybrid,Tier2_City,3,5,3,5,3,0,2,39.95,Other,2,4,4,5,1,5,4,4,2,4,1,0,2,4,61.31
Law,Actuary,2.9754753790884445,0,0,1,1,8,0,0,0,1,0,1,3,0,1,Arts,Bachelors,25-30,1,1,24,Remote,Tier1_City,5,3,5,5,0,3,5,12.52,Finance,4,2,2,2,2,5,2,3,5,1,0,1,5,5,28.96
Marketing,Principal,2.825434726778932,6,1,0,0,3,0,3,4,2,1,2,4,0,1,Commerce,Bachelors,18-24,2,0,0,Office,Tier1_City,5,1,1,3,4,4,4,41.46,Healthcare,4,5,1,3,4,0,5,1,3,4,1,0,3,3,54.4
Medicine,Advertising Manager,2.924284620347185,9,2,2,0,4,1,3,1,1,0,2,0,4,0,Science,Bachelors,40+,0,0,0,Office,Tier1_City,5,3,2,5,3,5,2,48.03,Education,5,4,4,1,0,3,4,1,4,5,0,1,2,3,38.81
Engineering,Curriculum Developer,4.497402748770126,8,2,3,0,6,1,3,4,4,0,2,2,0,0,Science,Bachelors,31-35,12,0,0,Office,Tier2_City,3,2,1,4,2,3,2,31.96,Tech,3,4,5,5,1,2,3,4,2,4,1,0,3,2,62.56
Biology,Chemist,2.549598056289475,9,0,1,0,5,1,4,0,1,1,4,3,2,0,Science,Bachelors,25-30,10,0,0,Hybrid,Tier1_City,2,5,5,2,4,4,3,39.89,Finance,5,2,2,1,4,2,4,1,2,3,0,1,3,2,58.65
Law,Inorganic Chemist,3.734063785353817,7,1,4,0,3,0,1,2,3,0,2,2,2,0,Arts,Masters,18-24,11,1,8,Hybrid,Tier1_City,2,4,3,1,4,4,5,28.03,Healthcare,2,4,3,5,3,4,3,5,5,4,0,1,1,3,71.05
Law,School Counselor,2.6748880077311057,3,2,3,1,4,1,3,1,0,2,2,1,1,0,Arts,Bachelors,25-30,10,0,0,Remote,Tier2_City,3,1,1,3,3,0,3,31.11,Manufacturing,3,2,4,3,3,4,4,2,1,2,1,1,5,4,48.51
Biology,Physician Assistant,3.123413756348863,6,2,4,1,8,0,0,4,2,0,1,3,1,0,Science,PhD,18-24,8,0,0,Office,Tier2_City,2,2,5,5,3,0,3,3.63,Tech,4,2,5,5,2,0,5,4,3,4,1,0,5,1,63.54
Art,Zoologist,2.743449729997357,0,1,3,1,0,1,0,2,4,3,3,1,4,0,Arts,Masters,25-30,8,0,0,Hybrid,Tier1_City,3,5,2,5,1,3,2,27.64,Other,3,4,2,1,0,5,1,5,1,2,0,1,4,1,52.7
Finance,Digital Marketing Specialist,4.101553150360784,8,2,1,0,4,0,3,0,1,0,1,3,1,1,Commerce,Masters,36-40,4,0,0,Flexible,Tier1_City,2,2,2,2,1,0,3,30.05,Other,3,3,2,1,3,2,3,1,2,3,0,1,5,1,39.42
Medicine,Actuary,4.843774970735124,3,1,3,1,6,1,4,1,1,1,1,3,1,0,Science,Masters,31-35,13,1,23,Flexible,Any,1,1,3,2,4,0,1,34.49,Healthcare,3,5,3,3,1,4,2,1,1,5,1,0,2,4,63.38
Biology,Biotechnologist,4.771943751444473,8,0,3,0,9,0,4,1,1,4,4,4,1,1,Science,Bachelors,31-35,3,0,0,Flexible,Tier1_City,1,4,3,3,5,5,5,10.96,Finance,5,2,5,1,0,1,4,3,3,1,0,1,3,4,54.4
Chemistry,Urban Planner,3.970458339033637,8,2,2,1,3,1,1,2,2,1,1,3,2,1,Science,Bachelors,25-30,4,1,14,Hybrid,Tier3_City,2,1,4,1,5,2,3,14.34,Other,1,3,4,4,5,5,2,4,2,2,0,0,2,4,45.83
Education,Manager,3.1621571811154445,0,1,4,0,8,0,0,4,1,4,2,2,4,1,Arts,Masters,36-40,3,1,12,Hybrid,Tier1_City,5,4,2,5,1,3,3,38.53,Education,2,2,1,5,1,4,3,2,1,1,0,1,5,4,40.46
Education,Special Education Teacher,4.870572449223939,1,2,1,1,4,0,4,0,3,4,4,4,1,0,Arts,Masters,36-40,11,1,35,Flexible,Tier2_City,1,3,5,3,2,3,4,10.88,Finance,3,3,2,4,1,0,3,3,4,5,0,1,2,4,81.14
Finance,Construction Manager,4.548814014478035,9,0,1,1,2,1,1,1,2,4,0,2,1,0,Commerce,Masters,25-30,4,0,0,Office,Tier2_City,4,5,4,4,0,3,5,22.55,Other,3,4,4,2,1,0,4,1,1,4,1,1,5,4,43.56
Biology,Financial Analyst,4.973042195252717,2,1,3,1,8,0,4,3,0,4,2,1,4,0,Science,Bachelors,25-30,6,1,22,Office,Tier3_City,3,2,1,4,4,0,5,14.77,Education,5,5,1,2,5,1,2,2,4,5,1,0,4,2,58.83
Medicine,Special Education Teacher,2.926104700945125,4,2,3,0,9,0,4,1,1,1,1,3,4,1,Science,PhD,25-30,10,0,0,Remote,Tier1_City,4,3,3,3,0,5,3,28.62,Healthcare,2,3,4,5,3,3,1,4,5,5,0,1,4,4,71.17
Biology,Marketing Manager,4.677541583371699,9,0,4,0,3,0,1,2,3,4,3,3,1,0,Science,Bachelors,18-24,7,1,18,Office,Tier1_City,2,5,5,5,1,0,1,49.38,Healthcare,2,1,4,1,2,2,1,5,3,3,0,1,5,3,55.33
Business,Architectural Technologist,4.9517443525236295,6,0,3,1,9,0,2,0,0,3,0,1,1,0,Commerce,Masters,31-35,1,1,47,Hybrid,Tier3_City,2,2,0,3,3,4,4,43.05,Finance,4,2,2,3,3,0,1,2,4,2,0,1,2,2,36.56
Music,Financial Analyst,4.760103624656571,0,0,3,0,0,0,1,1,4,1,2,0,1,0,Arts,PhD,25-30,3,1,43,Hybrid,Tier2_City,5,3,5,5,4,1,1,15.67,Finance,2,3,2,2,3,2,1,3,3,5,0,1,3,2,56.22
Computer Science,Illustrator,3.724694227361852,0,1,2,0,5,1,3,3,0,1,0,3,2,1,Science,Bachelors,18-24,7,1,42,Flexible,Tier3_City,1,5,1,2,1,1,3,20.32,Education,2,5,4,1,2,1,1,5,5,2,1,0,5,2,48.47
Engineering,Lawyer,4.950388601352909,0,1,0,1,1,1,0,0,3,1,4,2,4,1,Science,Masters,18-24,6,0,0,Hybrid,Tier3_City,1,5,4,3,2,1,5,46.18,Tech,3,5,4,3,4,1,4,5,1,2,1,1,4,4,48.44
Business,Acoustics Specialist,3.6850060497784543,5,1,3,0,8,1,3,0,1,3,1,1,0,0,Commerce,High School,25-30,8,0,0,Office,Tier2_City,4,3,2,5,4,2,5,45.22,Finance,1,5,3,5,1,3,1,2,1,5,1,0,1,1,52.62
Medicine,Conductor,4.204286698580911,8,1,2,1,3,0,0,4,0,4,3,3,4,0,Science,Bachelors,36-40,4,0,0,Hybrid,Any,1,1,3,3,4,0,1,10.54,Other,3,3,1,1,5,5,3,2,4,1,1,0,5,5,47.02
Marketing,Curriculum Developer,3.8273024959387496,9,0,1,1,7,1,2,2,3,2,0,2,1,1,Commerce,Bachelors,25-30,5,1,10,Hybrid,Tier2_City,2,4,3,3,5,4,2,41.98,Tech,5,3,5,4,4,0,3,3,5,5,1,1,1,4,58.51
Education,Animator,4.657528828268997,6,0,2,1,2,1,4,2,0,4,0,4,0,1,Arts,Masters,31-35,14,0,0,Remote,Tier2_City,5,4,5,5,3,4,3,16.99,Tech,2,4,5,5,1,1,4,2,1,3,0,1,1,5,62.49
Finance,Doctor,3.9596509162575737,5,2,2,1,6,0,0,3,2,0,1,3,2,1,Commerce,PhD,25-30,10,0,0,Hybrid,Tier2_City,3,1,1,5,4,1,5,28.56,Tech,1,1,3,2,4,4,1,4,2,4,0,1,3,3,58.39
Education,School Counselor,3.7077109212773136,6,0,4,1,8,0,1,0,3,3,3,0,1,0,Arts,Masters,25-30,7,0,0,Hybrid,Tier2_City,4,5,5,1,3,5,2,3.24,Healthcare,3,3,4,5,1,2,4,5,5,4,1,1,4,4,60.76
Art,Fluid Mechanics Engineer,4.791761944138198,7,0,2,0,9,0,4,3,1,3,3,4,1,1,Arts,Bachelors,25-30,14,0,0,Hybrid,Tier2_City,4,2,1,3,1,2,5,49.93,Healthcare,4,4,4,5,2,2,4,5,2,3,0,1,5,4,66.03
Architecture,Architectural Technologist,4.622586237776009,0,0,2,0,9,1,1,2,1,0,4,0,4,0,Interdisciplinary,Masters,31-35,11,1,28,Office,Tier3_City,3,1,3,4,2,2,5,38.77,Tech,5,2,3,3,2,5,5,3,2,5,0,1,1,5,59.92
Music,Financial Advisor,2.6997799536588967,2,0,2,0,3,0,0,4,2,4,1,2,4,0,Arts,PhD,18-24,13,0,0,Hybrid,Tier2_City,2,5,4,3,2,1,2,14.36,Tech,5,1,5,2,5,4,3,2,5,5,1,1,4,3,73.38
Engineering,Forensic Psychologist,3.266816159267321,4,1,1,0,3,1,4,3,3,0,0,1,1,1,Science,High School,25-30,14,1,49,Flexible,Tier2_City,4,3,2,3,4,1,1,35.14,Healthcare,5,5,2,3,2,2,2,2,1,5,0,0,4,2,56.75
Finance,Biochemist,4.149906808513572,8,1,0,0,2,0,2,0,0,2,3,1,0,1,Commerce,PhD,25-30,10,0,0,Hybrid,Tier2_City,1,3,3,5,4,0,3,16.79,Education,3,1,2,5,0,5,4,5,5,1,1,1,4,2,61.75
Chemistry,Music Teacher,3.9906385768730814,0,1,1,0,0,0,4,0,1,2,1,0,3,1,Science,Bachelors,25-30,14,1,28,Office,Tier1_City,1,5,3,3,1,5,2,7.2,Other,1,2,4,1,5,5,4,5,1,4,0,1,4,3,47.77
Psychology,Biomedical Engineer,3.794257674647648,2,0,2,1,0,1,0,1,3,4,1,4,4,0,Arts,Masters,40+,4,0,0,Remote,Tier1_City,1,3,1,3,5,2,2,22.99,Manufacturing,1,3,1,4,5,4,4,3,3,1,1,0,4,2,52.84
Marketing,Nuclear Physicist,4.690391590603865,0,0,4,1,4,1,0,0,3,2,4,4,3,1,Commerce,Bachelors,18-24,13,0,0,Remote,Tier1_City,5,4,2,4,5,4,5,31.84,Finance,2,3,5,4,1,5,1,2,2,2,0,1,4,5,55.93
Education,Actuary,2.9306894424861274,8,2,3,1,5,0,1,2,2,3,2,4,0,0,Arts,Bachelors,25-30,8,1,36,Office,Tier2_City,3,1,3,5,5,1,2,7.22,Tech,1,4,1,3,2,2,2,1,4,2,0,0,2,5,56.24
Chemistry,Organic Chemist,3.2751002610033155,7,1,0,0,2,0,2,2,1,1,1,0,3,0,Science,Bachelors,25-30,3,0,0,Remote,Any,2,4,1,3,3,0,3,27.37,Healthcare,4,3,4,1,4,1,1,2,5,3,1,1,2,3,44.67
Marketing,Physical Chemist,2.610480180133901,1,2,3,0,7,1,0,4,4,0,0,1,3,0,Commerce,Masters,36-40,7,0,0,Flexible,Tier2_City,1,5,0,2,5,4,1,27.2,Tech,5,3,5,4,0,3,1,3,4,1,0,1,4,2,50.77
Education,Data Scientist,3.125293436035543,7,2,4,1,1,0,3,4,0,2,2,4,1,0,Arts,Bachelors,25-30,11,0,0,Remote,Any,1,1,3,1,2,2,1,32.55,Tech,3,1,2,1,5,5,2,5,3,5,0,0,2,2,63.71
Marketing,Pharmacist,4.181649596915907,3,1,0,0,4,0,2,4,0,2,1,0,2,0,Commerce,Bachelors,31-35,13,0,0,Flexible,Tier1_City,5,3,0,4,3,1,1,14.5,Tech,5,2,2,3,0,0,5,5,3,5,0,0,5,4,56.58
Engineering,Physician Assistant,3.1667665821301094,8,1,2,0,2,0,4,3,0,1,0,1,3,0,Science,Masters,36-40,2,0,0,Hybrid,Tier3_City,1,1,2,3,1,5,3,3.97,Tech,5,5,1,2,5,0,3,1,2,1,0,0,3,2,33.4
Education,Curriculum Developer,4.385442673588245,4,1,3,1,1,1,0,3,3,3,4,4,2,1,Arts,PhD,25-30,4,0,0,Hybrid,Tier1_City,5,1,2,2,2,1,5,18.27,Education,4,5,5,1,2,0,3,1,4,5,1,1,2,1,68.27
Biology,Pharmacist,4.701040867756202,8,1,1,1,9,1,1,2,1,1,3,4,4,1,Science,Bachelors,25-30,14,0,0,Remote,Tier1_City,3,3,3,3,2,5,3,21.73,Finance,5,4,4,1,3,0,3,3,3,5,1,0,2,4,57.92
Finance,Architectural Technologist,4.809188365473393,9,1,1,1,4,0,4,0,4,0,4,4,3,1,Commerce,Bachelors,25-30,7,0,0,Hybrid,Tier3_City,4,2,5,3,0,0,2,32.88,Finance,5,2,3,2,2,0,1,2,2,1,1,0,1,1,52.41
Computer Science,Software Developer,4.717718258920739,4,0,2,0,1,0,3,4,4,3,1,0,4,0,Science,Bachelors,36-40,14,0,0,Remote,Tier1_City,1,3,4,5,1,0,4,46.72,Healthcare,4,1,3,5,5,4,1,5,5,2,0,1,3,1,64.59
Education,Geneticist,3.614866384980632,6,1,4,0,9,1,1,0,1,4,0,2,4,0,Arts,High School,18-24,9,0,0,Hybrid,Tier1_City,1,4,1,5,1,2,4,12.56,Education,4,5,3,5,3,1,1,4,5,1,1,0,4,1,48.3
Medicine,Physical Chemist,4.943697503882364,7,1,2,1,6,1,0,3,0,3,3,3,0,1,Science,Masters,25-30,11,1,13,Hybrid,Tier1_City,3,2,1,5,0,5,4,35.3,Education,1,4,4,5,2,3,5,4,4,4,1,0,4,3,63.51
Finance,Data Scientist,4.033550276775807,9,2,4,0,6,1,0,4,3,3,0,1,1,1,Commerce,Masters,31-35,6,0,0,Office,Tier3_City,4,4,4,2,3,1,1,7.58,Finance,5,3,3,3,1,0,1,4,2,4,0,1,4,2,54.78
Computer Science,Legal Secretary,2.793460569772769,3,0,4,1,1,0,4,3,4,0,0,3,0,0,Science,Masters,25-30,0,1,35,Flexible,Tier2_City,5,5,0,3,5,0,3,11.96,Healthcare,2,3,1,5,4,2,2,5,2,4,1,0,5,4,54.68
Architecture,School Psychologist,4.154449685289224,6,0,3,1,8,1,2,3,2,3,4,1,3,1,Interdisciplinary,Bachelors,25-30,11,0,0,Hybrid,Tier1_City,4,4,5,1,5,1,3,26.93,Education,2,1,2,3,5,5,1,5,2,3,0,0,1,5,64.27
Marketing,Digital Marketing Specialist,4.258722769771953,9,0,3,1,1,0,3,4,4,1,3,2,3,1,Commerce,Masters,25-30,3,0,0,Remote,Tier1_City,1,1,5,4,5,2,1,36.29,Healthcare,2,5,3,2,5,2,1,4,1,3,0,0,3,3,53.82
Art,AI Researcher,4.069639939076245,8,1,3,1,9,0,1,2,1,3,1,2,0,0,Arts,Masters,18-24,1,0,0,Hybrid,Tier1_City,3,5,2,5,5,5,2,43.35,Finance,4,3,2,1,3,3,4,1,3,2,0,1,2,4,41.63
Finance,Education Administrator,3.1440372109813675,3,0,3,0,3,0,0,0,3,4,4,1,3,0,Commerce,Masters,25-30,1,0,0,Office,Tier1_City,2,2,3,5,5,1,4,37.96,Tech,5,4,1,4,3,5,2,4,2,1,0,0,1,1,44.87
Architecture,AI Researcher,4.194977900446718,9,2,4,1,7,1,0,3,1,2,4,2,4,0,Interdisciplinary,Masters,25-30,12,0,0,Remote,Any,3,4,1,3,0,4,4,3.72,Other,1,4,5,4,0,0,4,1,1,2,1,0,2,3,51.0
Biology,Chemist,3.401399197892629,5,1,0,0,5,1,2,0,3,0,3,1,0,0,Science,Masters,36-40,14,0,0,Hybrid,Any,5,5,1,3,1,1,1,35.14,Other,5,5,5,3,3,0,4,3,1,4,0,1,5,4,57.21
Business,Doctor,4.050230339208274,1,0,4,0,4,1,3,4,1,2,4,1,3,0,Commerce,Masters,25-30,6,1,11,Remote,Any,5,4,3,2,3,3,4,41.76,Other,2,1,4,3,1,1,1,4,5,4,1,1,1,2,64.93
Marketing,Construction Manager,4.7932293440649545,1,1,3,1,7,1,0,0,3,0,0,2,4,0,Commerce,Bachelors,36-40,11,0,0,Remote,Tier3_City,1,1,3,2,2,3,5,27.7,Education,3,4,2,1,4,2,5,4,3,3,1,0,1,2,46.67
Music,Lawyer,4.702690203554891,6,0,0,0,1,0,2,3,1,0,2,3,3,1,Arts,PhD,31-35,11,1,32,Hybrid,Any,3,1,1,5,5,2,3,48.38,Healthcare,2,2,4,2,3,2,2,1,5,4,1,1,2,3,70.75
Finance,Architectural Technologist,3.066057985779052,6,2,2,1,2,0,2,1,0,1,3,2,3,1,Commerce,Bachelors,18-24,2,1,17,Hybrid,Tier3_City,2,2,1,3,0,2,4,3.2,Tech,4,4,3,1,0,4,1,1,3,3,1,0,1,2,39.16
Physics,Analytical Chemist,3.8082611973551135,4,0,3,1,3,0,0,2,2,1,1,3,2,1,Science,Masters,31-35,2,0,0,Hybrid,Any,3,3,1,1,3,2,4,41.48,Finance,5,1,4,3,5,5,3,1,5,2,0,0,3,2,48.13
Education,Interior Designer,2.5134361432168832,8,2,2,0,1,0,2,1,2,3,2,0,4,0,Arts,Bachelors,18-24,14,0,0,Office,Tier3_City,5,3,3,4,3,4,5,18.74,Manufacturing,4,4,1,1,4,2,3,3,1,1,1,0,2,1,47.05
Medicine,Inorganic Chemist,3.1674769108818097,7,1,4,0,4,1,3,2,4,0,2,4,1,0,Science,Masters,40+,5,0,0,Remote,Tier2_City,3,1,5,3,3,5,2,33.57,Other,1,3,4,3,3,0,5,4,2,1,0,0,4,3,53.17
Biology,Musician,4.747204807874144,4,1,4,0,3,0,3,3,1,2,3,4,3,0,Science,Masters,36-40,5,0,0,Remote,Tier1_City,1,5,0,3,0,4,2,35.59,Education,5,1,3,4,1,0,2,1,2,1,1,1,5,5,51.0
Psychology,Analytical Chemist,3.6196451310873456,3,0,2,1,2,1,2,1,2,4,3,4,4,0,Arts,Bachelors,25-30,0,0,0,Office,Tier2_City,5,2,1,2,2,1,5,17.39,Education,5,3,3,1,1,2,2,3,3,1,1,1,2,3,41.23
Education,Counselor,4.674967282416902,4,1,3,0,0,1,2,1,1,1,1,0,0,0,Arts,Bachelors,25-30,14,1,55,Hybrid,Tier2_City,3,4,0,4,5,0,2,49.78,Healthcare,5,3,1,2,4,4,4,3,2,5,1,1,4,1,52.6
Music,School Psychologist,3.7185040855109257,8,0,2,0,3,1,3,2,3,4,4,3,0,1,Arts,Masters,25-30,14,1,20,Remote,Tier2_City,3,4,1,5,3,5,1,7.85,Finance,3,5,2,4,0,5,3,5,5,2,0,0,2,3,72.52
Psychology,Psychologist,4.217765341975726,2,2,0,1,2,1,1,0,1,4,1,0,4,0,Arts,Masters,25-30,14,1,28,Office,Tier3_City,1,5,3,3,0,3,5,10.38,Other,5,1,5,2,1,3,3,1,5,3,0,1,5,4,51.89
Law,Landscape Architect,4.904756454390119,3,1,0,0,3,0,4,3,1,3,1,3,2,0,Arts,Bachelors,25-30,0,0,0,Hybrid,Tier2_City,1,3,4,5,1,3,3,44.93,Finance,3,3,1,2,2,5,3,1,4,2,0,1,4,3,42.49
Art,Digital Marketing Specialist,3.726671506347702,3,0,1,0,4,1,3,2,2,4,3,0,1,1,Arts,Bachelors,25-30,10,0,0,Remote,Tier1_City,3,1,0,3,0,3,3,8.6,Education,5,5,5,3,2,2,2,1,4,2,1,0,2,3,57.81
Physics,Microbiologist,3.3938036540986047,1,2,0,1,3,0,0,3,1,3,4,0,1,1,Science,Masters,31-35,5,0,0,Office,Tier1_City,2,1,4,5,0,1,3,20.92,Education,2,5,1,2,3,3,1,5,2,5,0,1,2,1,47.99
Music,Risk Analyst,4.111783977016247,2,0,1,1,5,0,2,0,2,4,2,2,0,1,Arts,Bachelors,18-24,6,0,0,Hybrid,Any,5,2,1,4,0,1,4,37.46,Other,1,3,1,5,1,2,3,1,3,5,0,1,3,3,54.88
Engineering,Biochemist,4.158398301917686,5,2,2,0,5,1,1,4,3,2,1,3,2,0,Science,Bachelors,36-40,8,0,0,Remote,Tier2_City,3,1,1,2,3,2,5,40.2,Other,5,3,4,2,2,3,3,1,1,1,0,1,5,4,48.57
Computer Science,Construction Manager,3.948700628905224,6,1,3,1,6,0,1,2,4,1,4,0,4,1,Science,Bachelors,36-40,3,0,0,Hybrid,Tier1_City,1,3,5,4,0,0,5,47.87,Healthcare,4,2,4,1,3,0,5,3,5,1,0,1,3,3,46.51
Education,Aerospace Engineer,2.544343503450225,5,2,0,0,3,1,4,4,1,0,1,2,2,1,Arts,Bachelors,25-30,13,1,10,Hybrid,Any,5,3,3,1,1,2,2,40.11,Healthcare,2,1,4,3,3,0,4,1,4,4,1,1,3,2,57.63
Law,Aerospace Engineer,3.5799024705957363,2,1,3,0,4,0,2,4,0,4,0,0,3,0,Arts,Bachelors,36-40,9,1,9,Flexible,Tier1_City,1,5,4,2,3,1,5,42.69,Manufacturing,4,5,1,3,3,3,5,4,3,4,0,0,4,4,56.19
Business,Financial Controller,4.942076461115002,2,1,1,1,7,1,4,1,3,2,0,3,0,0,Commerce,Bachelors,18-24,5,0,0,Office,Tier2_City,5,2,4,4,1,4,5,47.62,Tech,4,1,4,5,0,1,1,2,1,5,1,1,5,3,53.56
Education,Electrical Engineer,4.201979228925778,8,2,4,0,0,0,4,2,4,0,2,3,0,0,Arts,Bachelors,18-24,11,1,23,Hybrid,Tier1_City,3,2,1,1,4,2,2,29.02,Healthcare,3,5,1,3,3,5,5,1,1,1,1,1,5,5,57.89
Physics,Music Teacher,2.629234273590602,5,1,4,1,9,0,1,0,2,3,4,0,4,0,Science,Bachelors,31-35,2,0,0,Remote,Any,4,1,2,3,0,5,5,19.14,Tech,1,4,4,3,0,0,5,3,3,3,0,1,3,3,42.99
Medicine,Cybersecurity Analyst,3.609327588920711,7,2,0,0,1,0,4,4,3,1,0,4,3,0,Science,Bachelors,25-30,12,0,0,Flexible,Tier3_City,4,4,5,3,5,1,5,38.8,Education,4,4,5,4,2,5,3,5,1,5,1,1,1,2,69.21
Education,Financial Analyst,3.3014333078628586,4,2,0,1,6,1,2,3,1,1,4,0,4,1,Arts,Bachelors,25-30,12,1,55,Office,Tier2_City,5,2,2,5,5,1,1,10.69,Manufacturing,2,5,2,4,3,4,3,5,4,4,0,0,4,2,65.01
Medicine,Urban Planner,4.512896611700379,7,0,2,0,2,1,4,1,2,3,3,3,3,0,Science,Bachelors,36-40,10,1,36,Remote,Any,1,1,4,2,3,4,2,6.21,Manufacturing,1,2,4,4,2,4,4,2,2,2,1,1,3,2,63.56
Computer Science,Psychologist,3.76890427594204,5,1,3,0,8,1,2,1,2,2,0,3,1,0,Science,Masters,40+,3,0,0,Remote,Any,1,4,4,3,5,4,1,39.91,Manufacturing,2,4,3,5,1,3,4,3,5,3,1,1,5,4,53.67
Medicine,Marketing Specialist,4.196056104024816,6,2,4,0,4,1,3,1,1,1,2,2,0,0,Science,Bachelors,31-35,8,0,0,Office,Tier3_City,1,1,0,2,3,4,4,47.68,Finance,4,1,2,3,0,5,5,1,4,3,0,0,3,5,52.93
Biology,Marketing Specialist,2.8329658548707,3,2,1,0,6,0,3,3,1,4,3,2,1,0,Science,Bachelors,31-35,13,1,53,Office,Any,3,5,1,3,0,0,2,23.8,Other,1,3,3,3,2,1,2,5,4,5,1,1,2,4,65.68
Finance,Biomedical Engineer,3.4977363264100294,9,2,1,0,6,1,3,4,0,3,3,3,0,0,Commerce,Bachelors,18-24,13,0,0,Remote,Tier3_City,5,2,2,5,2,5,5,10.57,Other,5,1,2,3,3,4,2,5,5,4,0,1,5,3,65.46
Computer Science,Nuclear Physicist,3.012175602605172,0,1,1,1,2,1,1,0,2,1,0,0,3,0,Science,Bachelors,18-24,0,0,0,Office,Tier2_City,3,1,3,4,2,1,5,26.36,Education,4,1,4,2,2,0,4,4,2,3,0,1,3,5,26.07
Education,Landscape Architect,2.545213614634815,4,2,0,0,9,1,1,1,1,0,4,2,3,0,Arts,Masters,31-35,4,0,0,Remote,Tier2_City,4,5,0,5,1,4,1,21.49,Finance,4,1,5,3,3,2,1,2,2,2,0,0,4,1,45.88
Art,Lawyer,3.654419555182784,9,1,2,0,6,0,3,2,1,1,1,3,0,1,Arts,Masters,25-30,14,1,46,Remote,Tier1_City,4,1,2,1,0,0,1,20.51,Finance,3,5,4,3,4,5,4,4,1,1,1,1,3,3,50.53
Chemistry,Data Scientist,4.412647027594367,9,1,3,0,3,1,4,3,4,1,0,2,4,1,Science,Masters,25-30,14,0,0,Hybrid,Tier1_City,1,3,1,3,5,3,4,32.52,Manufacturing,2,5,1,1,5,2,5,5,1,5,1,0,1,4,66.4
Marketing,Actuary,4.170144123493692,7,2,4,1,0,1,3,4,4,4,0,0,1,1,Commerce,Masters,25-30,10,1,30,Hybrid,Tier3_City,1,1,1,1,0,5,4,11.21,Finance,5,1,3,1,0,5,2,1,1,4,0,0,3,1,59.13
Chemistry,Data Scientist,4.391494212140191,0,2,3,1,7,0,3,3,0,0,3,0,0,0,Science,PhD,31-35,6,0,0,Office,Tier1_City,5,3,5,1,4,3,5,20.88,Education,1,3,2,3,1,0,5,1,4,4,1,0,4,3,59.1
Engineering,Doctor,2.815956318476344,5,0,0,1,3,0,3,4,0,3,3,3,3,1,Science,High School,18-24,2,0,0,Hybrid,Tier2_City,4,2,1,2,2,3,3,43.83,Education,4,2,5,2,2,5,1,4,1,3,0,1,5,3,38.98
Psychology,Quantum Physicist,4.173044329823256,8,0,3,0,7,0,1,4,3,4,2,3,0,0,Arts,Bachelors,31-35,14,1,48,Remote,Tier1_City,5,1,2,3,5,1,4,37.29,Finance,4,2,3,2,5,1,3,1,2,5,0,1,1,5,67.39
Medicine,Acoustics Specialist,2.9140542885361005,5,2,4,1,4,0,1,4,3,2,3,4,3,0,Science,High School,18-24,1,0,0,Flexible,Tier2_City,4,5,1,1,2,0,5,5.61,Other,5,4,5,5,2,3,4,2,3,1,0,1,3,4,45.37
Finance,Legal Analyst,3.297551725575108,6,1,4,0,8,0,1,3,3,3,4,2,0,1,Commerce,Bachelors,18-24,12,0,0,Remote,Tier1_City,2,2,5,4,0,0,4,27.15,Education,4,4,3,5,4,0,3,4,4,1,0,0,3,2,61.21
Medicine,Cybersecurity Analyst,3.21233448941808,8,1,2,0,3,1,4,3,2,4,3,2,1,0,Science,Bachelors,25-30,10,0,0,Office,Tier3_City,5,2,3,1,5,3,2,7.29,Other,2,3,4,3,3,2,2,3,4,4,1,0,1,1,72.51
Biology,Advertising Manager,4.023699821980845,7,1,4,1,4,1,2,1,2,3,2,4,1,1,Science,Masters,18-24,1,1,36,Office,Any,2,3,5,4,1,5,1,48.0,Tech,1,1,1,4,1,3,1,1,3,4,0,1,1,4,48.9
Chemistry,Electrical Engineer,4.48063993271316,4,0,2,0,8,0,2,3,3,0,2,3,3,0,Science,High School,36-40,0,0,0,Remote,Any,3,2,1,2,0,2,5,14.5,Finance,5,5,3,2,3,1,5,1,4,1,0,0,5,2,35.51
Biology,Psychologist,3.192441027186013,8,0,3,1,9,1,2,2,1,3,1,4,4,0,Science,PhD,18-24,4,0,0,Remote,Tier2_City,4,1,0,1,1,3,4,46.83,Manufacturing,5,4,5,4,3,5,4,3,3,2,1,1,1,1,54.04
Engineering,Ecologist,4.623918683980271,4,0,4,1,3,0,3,0,1,0,2,4,3,1,Science,Masters,18-24,12,0,0,Flexible,Any,2,1,5,5,5,1,1,42.2,Manufacturing,3,1,4,5,2,4,2,2,4,4,0,0,2,3,65.95
Engineering,Social Media Manager,3.9903268213156737,3,2,4,0,0,1,3,4,1,0,0,2,1,1,Science,Bachelors,25-30,2,0,0,Hybrid,Tier2_City,3,3,3,2,2,3,3,28.91,Education,1,2,2,2,2,5,1,4,3,5,0,1,5,1,46.44
Business,Dentist,4.537578230833236,3,2,4,0,2,0,2,1,4,1,0,1,1,1,Commerce,Bachelors,25-30,10,0,0,Remote,Tier2_City,5,1,0,4,4,5,4,18.81,Education,5,3,2,4,2,2,5,4,3,3,1,0,5,4,57.4
Law,Legal Analyst,2.88222129296521,9,2,1,0,7,1,4,0,0,4,2,3,2,1,Arts,Bachelors,18-24,11,1,46,Flexible,Tier1_City,2,3,5,2,3,5,5,43.32,Manufacturing,4,5,4,3,5,1,5,2,2,4,1,1,3,5,62.08
Marketing,Physician Assistant,4.621140758136216,1,0,1,1,0,1,3,2,0,4,2,0,4,1,Commerce,Bachelors,18-24,6,0,0,Hybrid,Any,2,4,5,1,2,3,2,10.18,Tech,1,5,2,4,0,0,2,4,3,2,1,1,4,5,48.34
Finance,Manager,3.5270048421858737,5,1,4,1,0,1,4,4,2,1,2,0,0,1,Commerce,Bachelors,40+,0,0,0,Hybrid,Tier1_City,3,3,0,3,1,0,1,11.46,Manufacturing,2,4,5,5,0,1,5,1,3,3,0,1,2,1,42.49
Medicine,Art Director,4.728941341556514,7,2,2,1,0,0,2,2,1,0,3,4,4,1,Science,Bachelors,31-35,8,0,0,Hybrid,Tier2_City,2,5,4,3,0,3,1,13.56,Finance,5,1,1,2,2,1,3,2,5,2,0,0,4,5,55.57
Biology,Marketing Manager,4.948747057684085,6,1,3,0,1,1,1,1,0,0,0,3,0,1,Science,Bachelors,25-30,13,1,53,Office,Tier3_City,3,5,4,4,5,4,2,31.09,Manufacturing,2,5,4,2,3,3,3,1,4,2,0,0,5,4,47.92
Law,Doctor,4.822317802875292,6,0,3,1,5,0,0,0,4,2,3,0,3,0,Arts,Bachelors,25-30,1,0,0,Hybrid,Tier2_City,4,1,1,4,2,4,5,17.77,Healthcare,5,2,1,2,1,2,1,1,4,3,0,0,2,2,44.13
Biology,Architectural Technologist,4.94004564219778,6,2,3,1,8,1,4,0,3,1,3,3,4,0,Science,PhD,25-30,7,0,0,Remote,Tier1_City,4,4,3,3,4,2,3,49.49,Tech,4,2,1,3,1,2,3,1,1,4,1,1,3,5,64.18
Business,Dentist,2.604464458931281,5,1,2,1,7,1,3,2,2,1,3,2,1,1,Commerce,Masters,25-30,9,1,34,Hybrid,Tier2_City,4,5,2,4,5,1,2,12.17,Tech,3,3,4,2,3,1,2,3,3,1,1,0,4,4,58.85
Chemistry,Sound Engineer,4.140062452524538,3,1,2,1,9,1,0,1,4,4,1,1,0,0,Science,PhD,31-35,3,0,0,Hybrid,Tier3_City,2,5,4,2,1,1,3,40.86,Manufacturing,4,3,3,4,5,0,1,2,3,3,0,0,3,1,49.79
Marketing,Legal Analyst,4.05845996427682,5,2,3,0,6,0,4,2,2,0,0,4,0,0,Commerce,Bachelors,36-40,5,0,0,Flexible,Tier1_City,2,5,3,5,5,0,5,7.5,Healthcare,2,2,5,1,4,1,4,1,4,3,0,1,2,1,50.24
Biology,School Counselor,3.0524746926486475,3,2,3,0,8,0,1,3,0,2,4,2,2,0,Science,Bachelors,18-24,8,0,0,Hybrid,Tier3_City,1,1,4,5,5,1,4,19.61,Finance,1,2,4,1,3,5,5,2,1,1,0,1,1,4,44.26
Music,Musician,2.696343377272601,2,0,0,0,9,0,0,1,4,2,0,1,4,0,Arts,Masters,36-40,6,1,26,Hybrid,Any,1,2,5,2,0,2,4,14.46,Manufacturing,2,1,5,3,1,5,3,5,2,3,1,0,2,4,45.76
Law,Psychologist,2.7234305580387703,2,0,1,1,1,0,0,3,1,1,0,0,3,1,Arts,Bachelors,18-24,14,0,0,Remote,Any,3,2,3,5,3,4,5,48.91,Finance,3,5,1,4,4,5,4,1,3,5,1,1,2,5,52.36
Business,Architect,4.651918972382143,2,0,1,0,6,0,2,1,4,0,0,2,0,1,Commerce,High School,18-24,7,1,41,Flexible,Tier2_City,2,2,1,1,1,0,3,4.21,Healthcare,5,1,1,3,5,0,5,4,5,4,1,0,3,2,52.92
Music,Interior Designer,3.462885622113359,7,0,2,1,6,0,3,3,1,2,0,1,1,0,Arts,Masters,18-24,14,0,0,Hybrid,Tier1_City,3,1,0,2,0,5,2,36.92,Manufacturing,5,3,3,1,5,5,2,5,4,1,1,1,3,1,51.02
Marketing,Industrial-Organizational Psychologist,2.6255253111604486,1,0,0,1,8,0,4,1,3,1,4,1,2,0,Commerce,Masters,18-24,6,0,0,Hybrid,Tier2_City,5,2,4,4,3,4,5,14.64,Manufacturing,2,3,1,2,4,5,4,4,1,4,1,1,4,4,55.29
Law,Art Therapist,3.25902228647511,7,0,1,0,6,0,3,2,0,1,2,1,0,1,Arts,Bachelors,36-40,1,0,0,Flexible,Tier2_City,2,3,0,2,0,2,5,41.13,Finance,1,3,4,1,1,3,1,5,3,1,0,1,1,2,30.03
Law,Inorganic Chemist,4.96917917233646,6,1,1,1,7,0,1,0,3,1,4,3,4,1,Arts,Bachelors,25-30,8,1,44,Office,Any,5,1,5,3,3,0,4,17.63,Manufacturing,5,5,5,1,4,2,2,3,1,3,0,0,2,1,51.64
Computer Science,Human Resources Specialist,3.6034528067904312,2,1,3,0,5,1,3,3,4,1,2,3,4,1,Science,Bachelors,18-24,14,0,0,Hybrid,Any,2,1,0,4,3,3,2,11.8,Healthcare,5,4,3,1,5,2,3,3,5,3,1,1,1,4,68.19
Architecture,Civil Engineer,3.22054549465339,4,1,1,0,9,1,4,3,1,1,3,4,2,0,Interdisciplinary,High School,40+,0,0,0,Office,Any,4,4,2,3,3,1,4,35.57,Manufacturing,3,3,4,3,0,2,4,5,1,4,0,0,1,2,40.79
Marketing,Psychologist,3.9855147245188594,7,0,1,1,1,0,0,0,4,3,4,1,1,0,Commerce,Bachelors,36-40,13,0,0,Flexible,Tier2_City,3,5,2,4,0,2,3,15.11,Education,3,3,5,5,2,5,2,5,4,2,0,1,5,5,60.75
Computer Science,Architect,4.670089130713938,5,2,1,0,0,0,4,2,2,4,0,4,3,1,Science,Bachelors,31-35,1,0,0,Office,Tier2_City,1,4,1,5,5,0,3,25.82,Healthcare,1,1,5,3,5,2,2,2,2,5,0,0,1,1,52.61
Psychology,Mechanical Engineer,3.815166347653797,7,2,2,1,6,1,0,3,1,4,4,2,0,0,Arts,Bachelors,36-40,2,0,0,Hybrid,Tier1_City,4,2,3,2,3,4,1,9.18,Tech,5,1,2,5,5,3,4,3,2,4,1,0,1,3,49.23
Architecture,Construction Manager,4.359366518073454,1,1,0,1,8,1,2,2,4,4,1,3,3,1,Interdisciplinary,PhD,18-24,2,0,0,Office,Tier1_City,1,1,1,1,5,0,5,37.06,Finance,4,4,2,3,4,1,3,2,2,3,1,1,3,4,57.63
Business,Principal,4.429250170571163,5,0,4,0,0,1,1,3,0,4,2,0,0,1,Commerce,Masters,36-40,13,0,0,Remote,Any,2,1,3,4,1,3,2,22.12,Other,2,4,4,1,4,2,2,4,1,4,1,1,1,3,53.61
Chemistry,Artist,2.6825394408243466,2,2,4,1,4,1,2,2,4,0,0,1,0,0,Science,Masters,31-35,9,0,0,Hybrid,Tier2_City,5,2,5,4,4,2,2,9.61,Other,5,4,3,2,0,4,4,3,3,4,1,0,5,1,61.13
Medicine,Sound Engineer,3.036924314703911,1,1,1,1,4,1,1,4,4,3,3,3,4,0,Science,Bachelors,36-40,3,1,58,Hybrid,Tier2_City,5,5,2,3,5,0,4,37.85,Healthcare,2,4,5,4,0,5,2,2,3,3,1,1,2,5,60.11
Marketing,Legal Analyst,3.5560588956027885,8,2,2,1,8,1,4,0,1,3,4,0,4,0,Commerce,Bachelors,31-35,4,1,22,Hybrid,Tier1_City,4,4,1,5,4,5,4,7.86,Other,5,1,5,5,3,0,1,1,3,2,1,0,1,1,48.82
Chemistry,Mechanical Engineer,3.8033784932116657,9,2,4,0,6,0,0,4,4,0,3,4,1,0,Science,Bachelors,25-30,5,0,0,Office,Tier1_City,1,5,3,3,3,2,2,30.02,Tech,3,3,4,3,1,0,4,4,5,1,1,0,4,5,56.3
Law,Physicist,3.99532466112764,1,1,1,0,3,0,0,0,1,2,1,2,1,0,Arts,Bachelors,31-35,0,0,0,Remote,Tier2_City,3,2,5,3,4,2,4,31.55,Tech,1,1,3,2,3,2,4,3,3,2,1,1,4,1,33.5
Medicine,Clinical Psychologist,3.923200807375474,7,2,2,1,8,0,2,1,1,3,3,3,3,1,Science,Bachelors,25-30,13,0,0,Remote,Any,3,4,2,5,4,4,1,46.73,Healthcare,4,2,1,4,5,0,2,1,4,3,0,1,1,2,64.15
Engineering,Biologist,3.1845715864391133,8,2,0,0,6,1,1,0,3,4,0,1,0,0,Science,Masters,25-30,12,0,0,Hybrid,Tier1_City,3,4,3,1,3,1,5,10.1,Tech,3,2,3,2,1,0,4,5,1,4,1,0,2,3,52.32
Biology,Marketing Specialist,3.774299541011019,2,1,1,0,9,0,1,1,4,2,2,4,1,0,Science,Masters,18-24,7,0,0,Hybrid,Tier1_City,1,5,1,3,5,5,1,33.71,Tech,1,3,1,5,0,3,1,1,4,5,1,1,4,2,70.17
Architecture,Art Director,3.626803649680701,0,1,0,1,9,1,4,4,1,1,2,3,0,1,Interdisciplinary,Bachelors,36-40,5,0,0,Hybrid,Tier2_City,5,5,4,3,3,3,3,20.9,Other,3,4,5,5,2,0,3,5,2,1,0,0,4,1,47.86
Engineering,Paralegal,4.458148995046033,7,0,3,0,3,1,0,4,3,4,4,3,2,1,Science,Bachelors,25-30,9,1,35,Flexible,Tier1_City,5,1,4,4,1,0,2,21.84,Education,2,3,2,4,1,3,1,5,4,4,0,1,3,2,65.95
Architecture,Composer,3.6500903428063673,0,1,3,0,1,1,0,1,0,2,0,2,2,1,Interdisciplinary,PhD,25-30,8,0,0,Office,Tier1_City,4,1,5,5,2,1,1,26.59,Manufacturing,5,2,2,4,1,5,4,5,4,2,1,0,4,1,52.28
Engineering,Composer,2.540810429429778,3,1,1,1,8,1,4,1,3,0,3,2,2,0,Science,Bachelors,25-30,4,0,0,Hybrid,Tier1_City,1,5,1,2,0,4,1,13.99,Other,3,3,4,5,0,0,4,5,4,1,1,0,4,1,48.09
Psychology,Biomedical Engineer,4.932900944757449,2,1,4,1,4,0,1,4,1,2,3,2,1,0,Arts,Bachelors,40+,6,0,0,Remote,Tier2_City,2,2,5,1,3,1,4,24.68,Other,1,4,3,5,4,5,2,4,5,5,1,0,1,1,60.8
Computer Science,Geneticist,4.202983901155939,4,1,4,0,8,0,4,3,2,2,2,0,3,1,Science,Bachelors,25-30,10,0,0,Hybrid,Tier2_City,2,5,0,1,3,2,4,35.28,Education,5,1,3,1,3,5,5,5,1,2,1,0,1,5,49.73
Architecture,Risk Analyst,3.171018730786913,6,1,3,1,9,0,4,3,0,0,2,3,4,0,Interdisciplinary,Masters,31-35,3,1,15,Office,Any,3,1,5,5,4,2,4,24.48,Manufacturing,2,4,1,4,2,3,5,5,3,1,0,1,2,5,50.84
Law,Risk Analyst,4.244315939985854,9,2,1,0,2,1,0,3,0,1,4,1,2,1,Arts,PhD,36-40,5,0,0,Hybrid,Tier2_City,5,4,4,4,1,3,3,5.0,Tech,2,1,4,4,5,0,3,5,4,4,1,0,2,4,55.11
Business,Doctor,4.8358910213294095,1,1,4,1,3,0,0,2,3,1,2,3,1,0,Commerce,Bachelors,25-30,5,1,29,Remote,Tier2_City,5,2,5,4,4,5,1,15.12,Manufacturing,4,2,3,5,1,5,2,3,2,5,1,1,4,5,56.61
Physics,Art Director,4.622186830328513,2,0,2,0,3,0,4,0,4,4,2,1,2,1,Science,Masters,25-30,12,0,0,Remote,Tier1_City,1,1,4,5,5,0,5,19.52,Education,5,5,4,3,4,4,1,2,1,4,0,0,2,3,68.6
Chemistry,Aerospace Engineer,3.894509826222919,4,2,3,1,5,0,2,2,4,0,2,0,3,1,Science,Masters,31-35,3,0,0,Remote,Tier3_City,1,2,4,4,3,0,4,19.67,Finance,2,3,1,1,0,1,2,1,1,3,1,1,2,1,42.7
Chemistry,Chemical Engineer,3.00342033157382,3,1,0,0,8,0,2,4,3,2,2,1,1,0,Science,Bachelors,36-40,5,1,55,Hybrid,Tier2_City,4,2,0,1,3,4,3,6.81,Finance,3,5,5,3,1,3,2,1,4,5,1,0,5,1,58.47
Computer Science,Accountant,4.572605720723201,8,2,4,1,6,0,0,2,0,1,4,1,2,0,Science,Bachelors,31-35,7,0,0,Office,Tier1_City,1,4,2,1,4,3,3,24.13,Manufacturing,2,4,4,5,4,4,1,2,1,1,1,0,3,5,40.51
Medicine,Web Developer,4.607024335523786,6,0,1,1,9,1,1,0,2,2,1,1,2,1,Science,Bachelors,18-24,10,0,0,Flexible,Tier2_City,4,1,2,2,3,0,4,35.52,Finance,2,1,2,1,5,1,2,4,1,3,0,0,3,5,46.21
Psychology,Manager,4.370254263154019,7,2,4,0,4,1,1,1,0,3,0,3,3,0,Arts,PhD,36-40,4,1,25,Hybrid,Tier1_City,3,5,0,5,5,5,2,5.29,Healthcare,2,4,5,1,3,1,4,5,1,3,1,1,5,3,45.38
Marketing,Investment Banker,4.196812852089529,5,2,1,0,1,1,0,1,0,1,0,3,3,0,Commerce,Bachelors,25-30,1,0,0,Office,Tier2_City,3,2,5,3,2,2,1,38.29,Finance,4,4,3,5,0,4,3,3,1,4,1,0,5,1,34.19
Education,Psychologist,3.915677093245864,6,2,2,0,7,1,4,1,3,0,4,2,4,0,Arts,Masters,25-30,8,0,0,Flexible,Tier2_City,5,2,0,3,0,3,4,47.89,Manufacturing,1,2,1,2,4,2,5,1,2,1,0,0,2,2,51.99
Business,Biologist,3.682325778859179,7,1,4,1,8,0,4,1,1,1,2,1,1,1,Commerce,Bachelors,36-40,10,0,0,Office,Tier2_City,5,4,1,2,0,1,5,3.44,Tech,2,4,1,2,4,2,1,2,2,2,0,0,4,5,46.96
Business,Pharmacist,4.603391938968102,2,0,4,1,1,0,3,1,4,4,4,4,4,1,Commerce,Masters,18-24,3,0,0,Office,Any,5,1,1,2,0,3,1,12.1,Education,1,3,2,4,1,5,5,5,2,3,1,0,5,2,59.21
Art,Market Research Analyst,2.8539892967879945,0,0,0,0,3,1,0,4,0,0,1,0,3,0,Arts,Bachelors,31-35,3,0,0,Flexible,Any,2,2,5,4,2,3,3,28.54,Finance,5,2,4,5,5,3,4,1,3,5,1,1,2,3,42.91
Architecture,Interior Designer,3.3523175594311114,2,1,0,0,3,0,4,3,0,4,3,0,0,0,Interdisciplinary,Masters,25-30,10,1,12,Hybrid,Tier3_City,4,2,1,2,3,5,5,13.25,Manufacturing,1,5,2,5,5,2,5,1,2,5,1,0,1,5,70.83
Engineering,Acoustics Specialist,3.34717553568373,0,2,0,1,9,0,2,4,0,3,4,1,3,1,Science,Masters,36-40,6,0,0,Remote,Any,3,3,2,2,4,5,1,38.94,Education,5,4,4,3,3,3,4,1,3,2,0,1,3,3,59.97
Engineering,Clinical Psychologist,3.531660631883536,0,1,4,1,6,1,0,0,3,4,2,2,3,1,Science,Masters,18-24,9,0,0,Flexible,Tier1_City,4,3,5,3,1,0,5,17.67,Healthcare,4,5,2,5,5,4,5,5,4,3,1,1,5,3,57.87
Marketing,Mechanical Engineer,2.8121786754487528,5,2,1,1,9,0,3,0,4,0,0,1,3,0,Commerce,Masters,25-30,13,0,0,Hybrid,Tier1_City,2,2,3,4,3,4,3,16.8,Tech,5,3,2,2,0,2,3,4,1,2,0,1,5,5,52.24
Law,Ecologist,2.834291269946741,5,0,0,0,2,1,0,0,1,3,2,4,2,1,Arts,Bachelors,36-40,9,0,0,Office,Tier1_City,2,4,4,2,2,4,4,3.04,Other,5,3,1,5,0,2,4,2,2,5,0,0,5,2,53.51
Chemistry,Financial Analyst,4.687339523352485,1,1,3,1,3,0,4,0,2,4,4,2,4,1,Science,Masters,18-24,5,0,0,Office,Tier1_City,3,5,1,2,5,5,5,15.7,Education,3,3,4,3,3,0,1,2,4,5,0,1,3,1,71.81
Finance,Ecologist,2.575704908870456,7,0,4,0,1,1,3,0,3,4,1,4,2,0,Commerce,Bachelors,18-24,13,0,0,Hybrid,Tier1_City,3,3,4,4,2,0,4,13.23,Other,4,5,2,4,2,5,1,1,1,1,1,1,5,1,51.43
Business,Illustrator,3.1766408077055246,1,0,0,1,3,1,0,3,2,3,1,4,3,0,Commerce,Bachelors,40+,3,1,58,Hybrid,Any,5,3,0,5,0,0,3,19.13,Education,2,5,3,1,1,0,2,4,4,3,0,1,2,1,43.37
Business,Dentist,3.711641743203364,5,2,2,0,6,0,1,3,4,2,0,2,3,0,Commerce,Bachelors,25-30,5,0,0,Hybrid,Tier2_City,2,1,2,4,3,0,3,9.94,Manufacturing,4,1,1,4,4,1,2,4,5,4,1,0,3,2,60.08
Chemistry,Clinical Psychologist,3.9299164200572654,4,1,3,0,5,1,1,2,4,2,0,4,1,0,Science,Bachelors,40+,2,0,0,Remote,Tier2_City,5,5,1,3,0,5,5,30.95,Healthcare,3,2,1,3,1,0,3,5,1,5,0,1,3,4,42.32
Physics,Astronomer,4.0704304181242446,1,0,0,0,2,0,4,0,0,4,1,3,3,1,Science,Bachelors,18-24,6,0,0,Remote,Tier1_City,3,3,5,5,1,4,5,14.22,Finance,5,4,1,5,3,5,5,2,1,4,0,1,4,2,51.72
Art,Astronomer,4.809649954867227,9,2,0,0,8,0,4,2,0,3,1,1,3,1,Arts,PhD,25-30,5,0,0,Hybrid,Tier2_City,2,5,5,1,5,0,3,42.09,Healthcare,4,2,1,2,4,4,5,1,3,1,0,1,5,2,55.34
Engineering,Conductor,3.699704606534713,6,0,3,0,4,1,0,0,3,0,1,1,0,0,Science,Bachelors,31-35,2,1,31,Remote,Tier3_City,2,5,3,4,0,5,5,16.37,Tech,3,3,2,5,2,3,4,1,1,3,1,0,2,1,30.0
Psychology,Quantum Physicist,3.649255680242799,9,0,2,1,8,1,4,2,0,2,1,1,3,1,Arts,Masters,31-35,0,0,0,Hybrid,Tier1_City,1,1,5,3,1,1,5,12.91,Other,2,4,2,1,5,3,3,4,4,2,1,1,5,3,39.86
Chemistry,Cybersecurity Analyst,4.589472280514287,0,2,0,1,5,1,4,1,2,2,4,0,1,0,Science,Bachelors,25-30,11,0,0,Remote,Any,2,2,2,5,2,1,5,5.67,Finance,5,1,1,2,3,5,4,3,5,3,1,0,2,1,60.38
Computer Science,Sound Engineer,2.9135671611290217,1,0,3,1,7,1,3,3,1,3,1,4,2,0,Science,Bachelors,25-30,9,0,0,Office,Tier1_City,5,2,0,4,0,2,5,37.78,Other,4,2,2,4,1,0,1,5,5,5,1,0,1,2,63.65
Law,Graphic Designer,3.994813784451853,1,2,3,1,6,0,4,2,0,0,3,2,0,0,Arts,Bachelors,36-40,4,0,0,Flexible,Any,1,3,5,2,0,1,1,26.89,Healthcare,4,3,2,3,4,5,1,4,2,4,0,0,5,2,44.32
Psychology,Financial Controller,4.913997758440093,5,0,2,0,9,1,1,1,4,1,3,2,0,1,Arts,PhD,18-24,9,1,33,Hybrid,Tier1_City,2,1,5,4,4,3,3,8.35,Tech,5,4,4,4,0,0,5,5,2,4,0,0,3,4,69.27
Education,Mechanical Engineer,2.6832652527457848,8,1,2,1,2,1,1,0,1,0,4,0,3,0,Arts,Masters,25-30,1,0,0,Hybrid,Tier2_City,1,3,5,1,5,2,3,13.4,Education,4,4,3,1,4,3,2,4,4,2,0,0,4,4,41.72
Marketing,Surgeon,4.113715789856697,4,0,0,0,3,0,2,2,4,1,2,0,4,0,Commerce,PhD,18-24,6,0,0,Flexible,Any,2,3,4,4,5,1,2,49.94,Education,5,3,4,1,4,1,2,4,2,4,1,0,5,3,59.71
Law,Art Therapist,4.788900455814744,9,1,1,0,8,1,3,4,1,2,3,0,1,1,Arts,PhD,25-30,12,0,0,Remote,Tier2_City,4,2,2,5,2,3,4,40.88,Other,3,5,5,5,3,5,1,4,5,3,1,1,3,4,74.88
Computer Science,Ecologist,2.8578073267109567,9,2,0,1,6,1,1,2,0,2,3,3,1,1,Science,Bachelors,25-30,6,0,0,Hybrid,Tier2_City,5,1,4,5,4,1,2,19.44,Other,5,2,4,5,2,5,4,3,5,3,0,1,3,4,58.59
Physics,Artist,2.7573580694612234,6,1,1,0,1,1,0,3,3,1,2,4,1,1,Science,Bachelors,25-30,3,0,0,Remote,Tier2_City,5,5,5,4,1,5,5,28.5,Education,2,4,3,5,4,2,5,2,3,3,1,1,4,3,51.3
Psychology,Clinical Psychologist,2.802675737828938,3,1,0,0,3,1,3,1,0,0,3,2,4,1,Arts,Masters,25-30,5,1,7,Hybrid,Tier1_City,1,2,1,5,1,3,5,22.55,Other,5,5,3,1,5,1,4,1,1,3,0,0,1,5,42.26
Medicine,Interior Designer,3.0577524041848108,3,2,0,0,5,0,3,4,3,2,1,1,3,1,Science,Bachelors,18-24,0,0,0,Remote,Tier1_City,4,3,5,2,2,0,1,4.71,Education,4,1,4,2,4,4,2,5,1,2,1,1,1,5,36.08
Art,Brand Manager,4.037411530904206,1,0,2,0,1,0,4,2,2,0,1,0,3,0,Arts,Bachelors,18-24,1,1,39,Remote,Tier1_City,1,3,5,4,5,5,1,39.6,Other,5,4,4,4,2,4,3,4,2,4,1,0,3,2,43.72
Business,Risk Analyst,2.899803141392286,2,2,0,1,1,1,1,3,1,3,4,1,1,0,Commerce,Bachelors,31-35,14,0,0,Remote,Tier1_City,1,4,0,2,1,3,1,36.7,Finance,5,4,5,4,2,2,2,1,4,2,0,1,1,5,57.8
Architecture,Urban Planner,4.875077163461695,2,1,1,1,2,1,1,3,4,4,2,3,2,1,Interdisciplinary,Masters,25-30,5,1,35,Hybrid,Any,3,1,3,2,2,5,1,22.21,Other,5,1,1,3,5,2,4,4,1,4,1,1,5,2,59.58
Architecture,Fluid Mechanics Engineer,4.073875799968832,2,2,3,1,0,1,1,2,2,3,4,0,3,0,Interdisciplinary,Masters,36-40,1,0,0,Hybrid,Any,1,5,2,3,1,0,1,42.76,Education,2,1,3,3,4,1,2,2,1,5,1,0,2,2,45.27
Business,Principal,4.360401645147056,7,1,0,1,2,1,2,2,1,3,3,1,1,0,Commerce,Bachelors,31-35,11,0,0,Hybrid,Tier1_City,2,5,5,4,3,3,1,28.13,Finance,2,4,1,2,0,3,2,2,5,3,0,1,1,4,61.17
Physics,Mechanical Engineer,4.229701698767208,4,0,4,1,6,0,0,0,3,0,3,4,1,0,Science,Bachelors,18-24,11,1,51,Hybrid,Tier3_City,3,3,4,5,0,3,1,6.06,Finance,4,3,5,5,0,2,2,2,2,2,1,0,2,4,49.94
Biology,Industrial-Organizational Psychologist,4.866987102409705,3,2,3,1,2,1,3,2,2,3,4,2,0,0,Science,Masters,31-35,10,0,0,Remote,Tier1_City,3,4,0,2,5,5,1,15.19,Healthcare,4,1,2,5,0,1,2,4,4,3,1,0,2,5,73.72
Law,Music Teacher,3.574621386378647,6,1,4,0,9,0,4,2,4,3,2,0,0,0,Arts,Masters,18-24,3,0,0,Office,Tier1_City,1,4,0,3,3,1,1,24.7,Education,5,5,2,2,3,5,5,1,3,4,0,1,3,3,55.27
Finance,School Psychologist,3.539861001081245,9,0,1,1,5,1,3,0,2,4,1,2,3,0,Commerce,Bachelors,31-35,3,1,55,Hybrid,Tier3_City,3,1,1,4,2,3,3,7.86,Manufacturing,1,1,1,4,3,1,1,2,4,4,1,1,1,3,51.89
Physics,Astronomer,4.803930294736531,1,0,0,0,9,1,3,3,0,1,4,0,4,1,Science,Masters,40+,9,0,0,Remote,Tier1_City,5,3,2,4,2,1,1,29.84,Other,3,4,4,5,0,3,2,5,2,3,0,1,2,2,59.22
Engineering,Financial Analyst,4.23839868017712,6,0,2,0,8,1,4,3,3,4,4,2,1,1,Science,High School,25-30,8,0,0,Remote,Tier1_City,3,3,1,1,3,3,4,8.67,Education,5,4,3,4,0,5,2,3,4,5,0,0,1,3,67.63
Finance,Urban Planner,3.290918995387006,2,1,4,1,3,1,3,3,1,2,4,4,0,1,Commerce,Bachelors,31-35,14,1,11,Office,Tier3_City,3,3,1,1,0,4,1,12.42,Manufacturing,3,2,1,1,0,5,5,3,1,2,1,1,3,4,51.86
Marketing,Physical Chemist,3.4222895043346666,4,2,0,0,5,1,1,0,3,1,3,3,3,0,Commerce,Masters,18-24,9,1,39,Office,Any,2,1,1,2,0,2,5,45.02,Education,2,5,4,3,2,1,5,3,4,5,0,1,5,2,59.84
Physics,AI Researcher,4.433180596076668,2,1,0,1,2,0,2,1,1,2,3,1,1,0,Science,Masters,25-30,6,1,36,Hybrid,Tier2_City,5,5,0,1,4,1,5,49.99,Finance,4,2,5,5,1,4,3,3,2,4,0,0,3,3,54.47
Finance,Artist,4.4854293578756295,3,0,2,1,9,0,0,2,2,1,4,2,2,1,Commerce,Bachelors,36-40,13,0,0,Hybrid,Tier1_City,3,2,4,2,1,1,1,28.86,Education,1,1,4,3,3,3,5,3,4,5,1,1,2,2,58.17
Law,Chemical Engineer,2.6289794843526684,6,1,0,1,2,1,4,2,3,1,4,1,0,0,Arts,Masters,18-24,6,0,0,Hybrid,Tier1_City,2,4,4,5,4,0,1,32.12,Education,4,2,5,2,3,0,3,3,2,2,1,0,3,1,57.06
Medicine,Brand Manager,3.227210127241864,7,0,1,1,1,0,0,0,2,4,4,0,3,0,Science,Masters,25-30,11,1,55,Hybrid,Tier2_City,5,5,3,2,0,4,5,40.48,Education,2,4,1,1,3,1,3,4,1,1,1,1,1,1,44.8
Physics,Analytical Chemist,2.710551311604719,9,0,0,1,2,0,3,3,4,4,4,3,2,0,Science,Masters,25-30,10,0,0,Flexible,Tier3_City,3,2,5,1,3,0,4,35.72,Education,5,3,2,5,1,2,2,1,5,1,1,0,5,2,78.52
Computer Science,Risk Analyst,3.0261551828850743,2,2,0,1,9,0,4,0,0,1,4,0,0,0,Science,Masters,31-35,0,1,57,Hybrid,Any,1,5,3,5,1,4,2,11.58,Healthcare,2,1,3,5,4,2,4,5,4,1,1,0,5,1,44.41
Computer Science,Market Research Analyst,4.667097363723954,6,1,2,0,8,0,2,3,2,4,0,3,4,0,Science,Masters,25-30,10,0,0,Remote,Any,3,5,4,1,3,4,3,22.35,Other,1,4,1,4,3,3,2,1,1,3,0,0,5,3,60.58
Psychology,Industrial-Organizational Psychologist,4.977960022045126,8,1,2,1,9,0,0,2,4,1,0,1,2,1,Arts,Bachelors,36-40,4,0,0,Remote,Any,5,5,1,2,4,5,5,28.15,Healthcare,5,1,2,3,4,2,1,5,5,4,0,0,5,4,49.31
Art,AI Researcher,3.462712988666123,1,2,1,1,4,1,3,1,0,2,2,4,4,1,Arts,Bachelors,18-24,2,0,0,Remote,Tier2_City,3,5,0,3,2,5,1,19.91,Finance,5,2,5,1,2,5,3,2,1,3,0,0,5,4,38.94
Finance,Biotechnologist,3.889574343276555,5,1,0,0,0,0,0,3,4,3,3,2,4,1,Commerce,Bachelors,25-30,2,1,25,Office,Tier2_City,5,3,1,4,3,5,3,11.28,Finance,1,2,3,4,0,2,4,5,5,1,0,0,4,1,49.04
Physics,Conductor,4.5687316269346745,0,0,0,0,4,0,1,1,3,2,0,2,4,0,Science,Bachelors,31-35,5,0,0,Remote,Tier2_City,1,5,1,1,4,3,1,37.6,Manufacturing,4,1,4,1,0,0,5,4,5,2,1,0,3,2,48.75
Business,Electrical Engineer,2.7603181249683413,1,2,1,0,8,0,4,1,0,2,0,0,3,1,Commerce,Masters,18-24,3,1,15,Hybrid,Tier2_City,3,2,1,2,4,0,2,12.35,Finance,5,1,1,1,2,2,5,2,3,4,1,0,1,4,45.44
Medicine,Quantum Physicist,4.12552873130648,4,0,0,0,9,1,3,0,3,0,2,3,4,1,Science,Bachelors,31-35,7,1,31,Office,Tier1_City,5,2,2,5,4,2,2,15.24,Healthcare,4,2,4,2,0,3,5,3,5,3,1,1,5,3,54.24
Engineering,Urban Planner,3.839620300044316,2,1,2,0,5,1,4,3,2,0,3,2,3,1,Science,Bachelors,18-24,13,1,24,Hybrid,Tier2_City,2,4,2,1,2,4,5,16.47,Finance,3,1,3,2,2,3,4,4,5,5,1,1,2,1,67.73
Chemistry,Financial Analyst,3.881804848684143,8,0,3,1,9,0,0,4,4,3,1,1,1,1,Science,High School,18-24,3,1,34,Office,Tier1_City,3,1,1,1,2,4,3,10.6,Manufacturing,1,2,1,4,0,4,5,4,1,5,0,1,4,4,45.32
Marketing,Geneticist,4.507865737098898,2,1,4,0,8,0,3,1,4,1,0,0,1,1,Commerce,Bachelors,18-24,7,1,18,Hybrid,Any,1,2,3,4,2,1,3,42.93,Manufacturing,3,1,1,4,2,1,5,1,2,2,1,1,5,3,44.05
Art,Nurse,3.724866308597078,7,1,4,0,1,1,0,1,4,3,3,1,4,1,Arts,Bachelors,36-40,13,1,59,Hybrid,Tier1_City,2,2,3,2,1,3,2,31.7,Healthcare,5,3,4,4,2,1,3,1,5,3,1,0,3,2,60.72
Chemistry,Fluid Mechanics Engineer,4.910977326002721,6,1,3,0,8,0,2,2,1,4,1,4,3,0,Science,Masters,25-30,11,0,0,Flexible,Tier3_City,3,2,4,3,2,2,1,42.23,Finance,1,1,4,1,0,1,5,2,5,4,1,1,2,1,65.07
Art,Graphic Designer,4.80110490039076,6,0,3,1,5,0,3,1,3,2,4,4,2,0,Arts,High School,31-35,14,0,0,Office,Tier1_City,5,2,0,5,2,5,5,26.21,Other,5,1,2,5,4,3,4,4,2,1,0,0,5,5,57.08
Marketing,Game Developer,4.3616980495595445,6,1,1,0,0,0,1,0,1,0,0,1,1,1,Commerce,Masters,25-30,11,0,0,Hybrid,Tier3_City,4,1,2,2,2,4,4,27.42,Manufacturing,1,4,4,2,3,2,5,2,5,1,1,1,2,5,46.67
Engineering,Doctor,3.943927264135201,6,0,3,1,9,0,1,3,4,4,4,0,4,0,Science,PhD,25-30,3,0,0,Office,Tier1_City,2,1,5,5,3,1,2,31.96,Finance,4,3,5,5,3,5,2,3,4,4,0,1,3,3,69.53
Art,Musician,4.552484519461236,2,1,2,1,3,0,2,1,2,0,3,4,2,1,Arts,Bachelors,25-30,2,0,0,Office,Tier3_City,5,5,1,1,2,0,2,20.43,Finance,2,2,2,3,1,1,3,1,4,2,1,0,4,1,47.72
Architecture,Special Education Teacher,3.360850498870967,4,0,3,0,9,1,2,3,4,1,4,1,3,0,Interdisciplinary,Bachelors,36-40,4,0,0,Office,Tier1_City,2,2,5,4,1,4,5,26.34,Other,2,2,4,2,5,2,1,4,1,5,1,1,5,3,50.05
Chemistry,Illustrator,3.867932879560559,3,2,2,0,5,0,3,1,1,3,4,1,0,1,Science,Bachelors,31-35,11,1,53,Hybrid,Tier2_City,3,2,2,4,4,1,1,28.71,Healthcare,1,5,1,3,5,2,2,3,3,2,1,0,5,2,60.54
Education,Chemist,2.9043579275907176,1,1,2,0,8,0,4,3,0,1,1,1,3,1,Arts,Masters,31-35,12,0,0,Hybrid,Tier1_City,1,4,5,3,3,0,3,47.82,Healthcare,3,3,4,3,1,4,1,4,4,2,0,1,1,2,56.63
Biology,Graphic Designer,4.743805202362114,6,2,2,1,1,0,0,1,4,0,0,1,3,1,Science,Masters,18-24,4,0,0,Hybrid,Tier2_City,1,4,4,4,0,3,2,44.5,Finance,1,3,3,4,0,1,4,3,4,4,0,0,3,4,45.63
Art,Analytical Chemist,2.6674510030312955,5,1,1,1,2,1,4,4,4,1,1,4,4,1,Arts,Bachelors,25-30,9,1,45,Office,Tier3_City,2,4,3,1,2,5,5,9.07,Education,4,1,2,1,3,3,1,5,5,3,1,0,1,4,65.47
Computer Science,Marketing Specialist,2.6473253752105133,3,0,0,0,1,1,1,1,1,2,1,1,4,1,Science,Bachelors,25-30,9,0,0,Remote,Tier3_City,4,4,3,3,4,0,5,4.94,Education,3,4,1,5,5,5,1,3,5,3,0,0,4,4,58.07
Physics,Clinical Psychologist,4.333944423629059,8,1,4,1,3,1,3,4,1,4,1,1,3,0,Science,Masters,36-40,0,0,0,Office,Tier1_City,3,5,0,2,4,4,5,34.98,Tech,1,2,4,3,1,3,5,5,4,1,1,1,1,4,45.27
Marketing,Music Therapist,4.508499693992955,5,0,1,1,5,1,1,4,0,0,2,3,3,1,Commerce,Bachelors,25-30,14,1,18,Hybrid,Tier2_City,5,3,0,4,3,2,3,5.31,Tech,1,2,3,4,3,4,3,1,4,5,1,1,1,5,61.35
Biology,Nurse,4.719535198003263,7,1,4,1,8,0,4,3,3,3,0,0,4,1,Science,High School,25-30,7,0,0,Hybrid,Any,3,4,4,3,0,0,2,5.84,Tech,5,4,2,1,2,1,1,5,5,5,1,1,5,4,54.02
Music,Digital Marketing Specialist,3.5844080834836145,3,0,4,1,7,1,4,3,1,0,3,4,4,1,Arts,Masters,25-30,7,0,0,Hybrid,Tier2_City,4,4,0,1,5,2,5,10.49,Healthcare,4,4,2,2,4,2,4,2,2,1,0,0,2,5,57.41
Medicine,Physical Chemist,4.865842009931224,8,0,3,1,3,1,2,2,4,1,2,3,4,0,Science,Masters,18-24,7,0,0,Hybrid,Tier1_City,5,1,4,5,1,2,3,19.53,Finance,4,3,2,3,2,1,4,3,4,5,0,1,1,2,66.8
Law,Analytical Chemist,4.288886392520972,8,2,3,0,9,0,3,4,0,2,0,4,2,1,Arts,Masters,18-24,13,0,0,Office,Tier1_City,4,2,5,5,5,0,1,23.44,Other,2,4,1,4,1,3,4,1,3,5,1,0,5,3,66.18
Finance,Education Administrator,4.910657270065226,6,1,1,1,5,0,1,4,2,4,2,1,3,0,Commerce,Masters,36-40,9,1,44,Hybrid,Tier2_City,3,5,5,1,4,3,4,27.41,Other,5,4,4,4,1,3,5,4,2,3,0,0,2,4,65.22
Architecture,Civil Engineer,4.879833608064597,4,2,1,1,2,1,1,4,2,0,3,1,1,0,Interdisciplinary,Masters,25-30,3,0,0,Remote,Tier1_City,3,2,2,1,5,0,2,49.64,Manufacturing,3,1,1,4,0,5,2,3,3,5,0,1,1,4,57.96
Music,Physical Chemist,4.623004369422162,9,2,2,0,0,0,0,0,4,1,2,3,0,1,Arts,Bachelors,36-40,12,1,32,Remote,Tier2_City,2,3,1,5,4,1,3,21.11,Finance,2,3,5,2,4,3,5,3,3,1,0,1,1,1,53.08
Education,Psychologist,4.76501457762029,1,2,4,1,4,1,0,4,4,4,3,2,2,1,Arts,Masters,36-40,13,0,0,Office,Tier2_City,4,5,3,3,5,5,4,14.41,Finance,4,5,4,1,5,5,5,5,1,4,0,1,1,2,65.8
Engineering,Digital Marketing Specialist,4.117765921490636,2,1,2,0,7,1,2,1,0,1,1,4,0,0,Science,PhD,25-30,8,0,0,Flexible,Tier1_City,1,3,1,5,4,2,4,30.04,Tech,1,5,5,5,4,2,1,5,5,2,1,0,3,2,65.15
Music,Animator,3.613679295241617,3,2,0,0,8,0,1,0,2,3,3,2,2,1,Arts,Masters,25-30,9,1,56,Remote,Tier2_City,4,2,5,1,4,5,3,13.11,Finance,5,2,4,5,3,5,3,3,3,2,1,0,1,1,58.99
Finance,Software Developer,2.960289077355408,4,0,0,0,3,0,4,4,1,0,0,0,2,1,Commerce,Bachelors,18-24,2,1,25,Hybrid,Tier3_City,4,1,2,4,3,4,3,47.21,Other,4,4,2,3,0,3,4,3,4,1,0,1,1,1,41.48
Architecture,Sound Engineer,4.87108178548295,9,1,2,1,7,1,0,2,0,4,2,4,3,0,Interdisciplinary,Bachelors,36-40,6,0,0,Remote,Tier1_City,5,4,5,2,0,2,3,15.18,Tech,4,1,1,1,4,1,3,2,4,4,0,0,3,2,51.26
Architecture,Electrical Engineer,3.856732246380061,1,0,2,0,3,0,3,0,1,1,3,3,1,0,Interdisciplinary,Bachelors,25-30,5,0,0,Flexible,Tier1_City,5,2,0,4,4,4,5,49.53,Finance,5,4,5,3,1,2,2,4,2,2,0,1,3,5,47.77
Engineering,Composer,3.77000708282138,1,0,0,1,8,1,0,2,2,4,3,4,2,0,Science,Bachelors,25-30,8,1,7,Remote,Tier3_City,2,5,3,4,1,1,1,22.68,Manufacturing,4,2,2,5,2,5,3,2,4,1,1,1,4,5,57.89
Chemistry,Artist,2.722207969780336,5,2,2,1,7,1,2,2,3,1,0,1,3,0,Science,Bachelors,25-30,11,0,0,Remote,Tier1_City,1,4,0,1,1,1,5,41.2,Education,2,4,2,2,2,1,3,2,4,4,0,1,5,5,52.71
Music,Chemist,3.345953849269072,2,2,0,1,9,0,3,4,3,3,2,1,2,0,Arts,Masters,25-30,13,0,0,Remote,Tier3_City,3,5,1,5,2,5,4,33.47,Education,5,5,5,1,5,0,2,4,1,2,1,1,2,5,56.26
Law,Organic Chemist,3.259803034377751,9,2,1,0,9,1,2,0,4,0,4,3,4,0,Arts,Masters,25-30,12,1,33,Office,Any,1,3,5,3,4,1,4,46.87,Healthcare,4,3,4,1,4,0,2,1,3,1,0,0,2,2,60.02
Physics,Principal,3.15105259432617,1,2,3,1,7,1,0,4,0,4,3,1,2,1,Science,Bachelors,25-30,3,0,0,Flexible,Any,1,5,0,4,4,0,4,32.4,Manufacturing,4,4,5,3,2,2,4,4,5,1,0,0,5,1,46.29
Engineering,Artist,4.852860776536697,6,2,0,1,5,1,2,0,1,4,1,2,1,0,Science,Masters,31-35,3,0,0,Hybrid,Tier2_City,1,1,4,5,4,2,3,30.32,Other,5,5,1,3,1,3,4,1,2,5,1,1,1,3,53.08
Business,Architectural Technologist,3.2710197104495395,4,2,1,1,4,1,3,4,0,4,0,4,2,0,Commerce,Bachelors,36-40,5,0,0,Remote,Tier2_City,2,3,1,3,5,4,2,33.68,Finance,1,5,3,2,3,3,2,3,1,2,1,0,2,4,46.35
Engineering,Sound Engineer,3.3342537511258907,4,0,2,0,2,1,3,3,1,3,2,1,2,0,Science,Bachelors,25-30,7,1,19,Hybrid,Any,2,2,0,4,4,5,5,39.96,Manufacturing,3,2,4,1,1,2,2,2,3,3,1,0,2,1,54.75
Engineering,Investment Banker,4.13688156219585,4,1,0,0,7,1,2,4,1,1,2,1,0,0,Science,Bachelors,25-30,2,0,0,Remote,Tier1_City,1,4,1,3,4,5,2,45.25,Finance,5,3,2,5,4,1,5,3,3,3,1,1,3,1,45.8
Architecture,Entrepreneur,3.9778525370462914,2,1,4,1,0,1,4,3,3,2,3,0,1,0,Interdisciplinary,Bachelors,36-40,10,1,25,Remote,Tier1_City,3,4,0,5,1,1,1,15.54,Manufacturing,1,2,5,5,5,0,4,2,4,1,0,1,4,5,59.43
Art,Psychologist,3.3168519659682723,6,0,4,1,5,1,3,2,2,0,1,4,2,1,Arts,Bachelors,18-24,7,0,0,Flexible,Tier1_City,3,1,0,2,0,1,1,12.44,Manufacturing,4,1,3,4,1,5,4,5,4,4,0,1,4,2,53.66
Engineering,Art Therapist,3.058168834577157,4,2,0,0,2,0,2,2,3,2,0,1,2,1,Science,Bachelors,36-40,13,0,0,Flexible,Any,3,5,5,5,0,4,5,4.61,Education,2,3,5,5,1,5,5,2,2,4,1,0,4,1,52.82
Education,Sound Engineer,2.815417748523134,2,1,0,1,4,1,3,0,0,2,4,3,1,0,Arts,Bachelors,18-24,7,0,0,Flexible,Tier2_City,2,2,5,1,2,2,4,20.39,Manufacturing,4,1,3,4,2,5,5,2,5,1,1,0,3,4,55.85
Marketing,Digital Marketing Specialist,3.250700190924753,2,0,0,0,1,1,4,1,1,4,1,0,2,1,Commerce,Masters,31-35,13,0,0,Hybrid,Tier2_City,5,5,5,3,1,2,1,42.77,Healthcare,4,3,4,4,5,3,4,2,4,5,1,0,1,5,68.48
Computer Science,Physician Assistant,2.78102379912788,3,2,2,0,2,1,0,0,0,4,3,1,2,1,Science,High School,25-30,13,0,0,Remote,Tier2_City,3,5,1,2,4,5,2,6.28,Finance,1,5,5,3,3,5,5,1,5,1,1,0,3,4,49.12
Architecture,Geneticist,3.687908849690964,4,1,1,0,1,1,2,2,0,4,2,0,3,0,Interdisciplinary,Masters,25-30,6,0,0,Office,Tier2_City,5,1,2,3,0,4,2,28.31,Tech,5,1,5,5,5,3,4,5,4,3,1,0,2,1,51.15
Law,Counselor,2.9640773002067817,8,0,3,0,7,1,1,4,1,4,2,3,4,0,Arts,Masters,36-40,6,1,19,Remote,Tier1_City,1,3,1,3,3,5,3,35.66,Manufacturing,3,3,3,4,0,5,1,1,5,5,0,0,2,4,69.44
Business,Cybersecurity Analyst,3.919613939803012,4,0,4,1,2,1,3,2,4,2,0,2,2,1,Commerce,Masters,18-24,4,1,42,Remote,Tier2_City,3,3,3,4,3,3,4,42.33,Tech,3,3,1,5,4,0,4,4,4,4,0,0,5,1,58.14
Medicine,Biologist,3.134608878060907,6,2,0,1,6,1,0,0,1,1,1,4,0,1,Science,PhD,25-30,1,0,0,Remote,Tier2_City,1,1,3,1,3,2,3,30.42,Education,5,1,2,5,4,5,5,4,4,3,1,1,4,3,46.56
Chemistry,Civil Engineer,4.180739861469525,7,2,2,1,5,1,0,1,4,3,0,0,0,1,Science,High School,25-30,11,1,55,Flexible,Tier2_City,1,1,2,3,4,4,5,11.76,Tech,5,3,3,5,1,2,2,5,4,4,0,1,2,4,58.13
Education,Teacher,4.532948504459229,6,0,1,0,5,0,0,3,3,0,4,4,2,1,Arts,Bachelors,36-40,13,0,0,Office,Tier3_City,4,1,0,5,4,4,1,48.33,Healthcare,2,2,5,2,2,2,3,4,4,4,1,0,3,4,63.21
Music,Credit Analyst,2.8285399539002074,3,1,1,1,5,1,4,2,4,2,3,3,0,0,Arts,Masters,18-24,14,0,0,Remote,Tier2_City,1,5,1,5,2,5,3,7.45,Healthcare,5,2,3,4,2,2,3,3,5,3,0,0,3,5,75.75
Chemistry,Physical Chemist,3.5728211957400684,9,1,2,0,0,1,4,0,2,4,3,0,3,1,Science,Bachelors,36-40,1,0,0,Remote,Any,1,5,5,4,2,1,3,39.14,Education,2,1,3,5,4,3,3,1,1,3,1,0,5,3,46.43
Chemistry,Electrical Engineer,4.7152584810996,6,1,4,0,6,1,2,1,3,4,2,2,4,1,Science,Masters,25-30,12,0,0,Office,Tier2_City,2,2,0,1,2,4,5,7.07,Other,5,5,5,3,5,1,3,2,2,4,1,1,5,1,64.94
Education,Manager,4.236665996802458,7,1,1,0,4,1,2,2,4,0,3,4,4,0,Arts,Masters,18-24,11,0,0,Office,Tier2_City,1,1,0,1,5,5,2,9.74,Healthcare,2,4,5,2,0,4,2,3,1,2,0,0,5,4,63.38
Medicine,Legal Analyst,4.337284910443251,9,2,4,1,6,1,3,2,2,2,4,4,1,0,Science,Masters,31-35,9,0,0,Office,Tier3_City,3,5,3,5,3,0,2,45.22,Finance,5,1,1,4,0,2,3,2,5,5,0,1,5,4,75.25
Architecture,Nurse,2.6163836982509707,3,1,4,1,8,1,3,0,1,0,2,2,4,0,Interdisciplinary,PhD,18-24,11,0,0,Remote,Tier3_City,2,3,5,2,4,1,5,38.39,Other,5,1,1,1,3,4,1,4,2,2,1,1,5,3,57.53
Finance,School Counselor,4.671246684638344,1,0,2,1,3,0,0,3,4,0,2,1,3,1,Commerce,PhD,25-30,7,0,0,Hybrid,Tier2_City,4,1,5,4,3,1,2,20.18,Healthcare,3,1,1,4,1,1,5,1,4,2,1,0,5,5,58.33
Architecture,Composer,4.980458333385295,3,0,0,0,5,1,2,3,3,0,1,3,2,0,Interdisciplinary,Masters,18-24,10,1,12,Hybrid,Tier1_City,4,3,1,4,2,2,5,33.02,Other,4,1,5,2,4,3,4,4,1,2,0,1,5,1,53.8
Architecture,Credit Analyst,4.802437837421181,7,1,3,0,8,0,3,3,2,3,2,2,3,1,Interdisciplinary,Bachelors,25-30,5,1,52,Flexible,Tier1_City,1,4,4,5,4,3,2,24.49,Manufacturing,4,2,4,3,5,4,2,1,2,4,1,1,5,3,55.53
Finance,Mechanical Engineer,3.584460411402537,1,0,3,0,8,1,3,0,1,2,0,3,3,1,Commerce,Masters,31-35,7,0,0,Remote,Tier1_City,5,2,5,5,1,2,5,6.13,Healthcare,2,1,1,2,0,5,3,2,1,2,1,0,5,3,43.6
Marketing,Financial Advisor,4.103633020666261,6,2,1,0,9,1,1,1,4,3,1,3,4,0,Commerce,High School,25-30,2,1,13,Hybrid,Tier1_City,4,4,5,2,0,0,2,36.89,Other,1,5,2,5,0,5,3,2,5,4,0,0,5,1,50.37
Marketing,Principal,3.888763350991572,2,0,0,0,3,0,3,4,3,4,4,3,1,1,Commerce,Bachelors,25-30,0,0,0,Remote,Tier2_City,4,2,3,2,0,5,3,38.87,Finance,3,4,4,2,2,2,3,2,2,5,0,1,4,1,53.44
Chemistry,Risk Analyst,4.562762421858157,0,0,2,0,4,1,2,3,0,2,1,2,1,1,Science,Masters,25-30,12,1,39,Hybrid,Tier3_City,4,1,5,1,2,1,3,44.47,Education,5,4,1,1,3,4,5,5,4,1,0,0,2,2,55.01
Art,Special Education Teacher,2.870928021157151,1,2,1,1,6,0,0,3,3,1,4,3,1,0,Arts,Bachelors,18-24,5,0,0,Remote,Tier2_City,3,2,0,4,3,1,2,28.41,Healthcare,3,5,2,1,4,0,2,4,3,4,0,1,5,3,55.89
Education,Art Director,4.451816400755432,2,1,4,0,5,0,2,0,0,2,0,3,3,0,Arts,Bachelors,25-30,1,0,0,Office,Tier1_City,5,5,0,4,1,4,5,34.64,Finance,1,1,5,5,3,1,1,5,4,4,0,1,3,5,42.8
Art,Financial Advisor,4.329234351551107,4,0,2,0,0,1,1,1,2,4,4,1,4,1,Arts,Bachelors,40+,11,0,0,Remote,Tier1_City,1,3,4,5,4,3,3,23.59,Manufacturing,3,4,2,5,0,0,4,3,3,2,1,1,3,1,63.16
Art,Biochemist,2.866915838588147,5,2,1,1,5,0,2,3,4,3,1,2,2,0,Arts,Masters,36-40,14,0,0,Hybrid,Tier2_City,1,5,0,1,3,3,1,17.99,Tech,1,2,1,1,3,5,1,5,4,2,1,1,2,5,62.14
Biology,Microbiologist,4.651639089082616,7,2,4,0,5,0,2,1,3,0,1,3,2,1,Science,Bachelors,18-24,8,0,0,Hybrid,Tier3_City,2,1,2,4,2,4,2,22.35,Tech,1,4,3,3,0,1,1,2,5,3,0,0,3,2,57.11
Marketing,Financial Advisor,2.521394701975208,3,0,0,0,1,1,1,2,4,1,4,1,2,0,Commerce,Masters,18-24,4,0,0,Flexible,Any,3,4,4,1,3,0,1,45.85,Education,1,5,3,2,5,5,3,1,2,4,1,0,5,1,53.93
Architecture,Digital Marketing Specialist,3.664816995148291,1,2,3,0,6,0,3,1,0,1,4,2,1,0,Interdisciplinary,Bachelors,36-40,4,0,0,Office,Any,5,3,5,1,2,3,1,10.72,Education,1,4,2,1,2,1,2,4,1,4,1,0,5,2,45.0
Chemistry,Biologist,2.9907541501778496,6,0,3,1,3,0,3,3,2,3,3,0,0,1,Science,Masters,25-30,12,0,0,Remote,Any,2,1,0,5,5,1,4,14.68,Tech,1,5,5,5,5,3,3,4,4,4,1,0,5,1,72.42
Engineering,Judge,3.5497086950645853,7,1,1,0,7,1,4,2,3,1,0,2,3,1,Science,Masters,25-30,9,1,42,Remote,Tier2_City,5,5,3,1,0,0,1,31.49,Tech,5,1,4,5,1,1,4,4,3,1,0,1,2,5,56.27
Physics,Surgeon,4.678392536759714,5,0,2,0,8,0,3,4,3,3,3,0,3,0,Science,Bachelors,31-35,7,0,0,Hybrid,Tier3_City,4,5,3,2,0,2,1,8.47,Education,3,4,3,3,4,1,2,3,2,3,1,1,2,3,52.43
Computer Science,School Psychologist,3.942276042137017,5,2,2,1,2,0,4,2,2,0,2,0,2,0,Science,Bachelors,25-30,5,1,14,Hybrid,Tier1_City,5,2,2,2,3,2,4,44.92,Tech,4,5,4,4,1,2,1,4,1,2,1,0,4,5,43.91
Engineering,Animator,3.151565318023195,9,1,1,1,2,1,0,0,3,3,0,2,1,1,Science,Bachelors,25-30,2,0,0,Remote,Tier1_City,2,2,4,3,1,0,4,5.22,Healthcare,4,2,5,5,3,0,3,3,3,3,0,1,5,3,38.44
Architecture,Principal,3.5287776772127413,5,1,0,1,3,1,2,2,2,4,2,3,0,1,Interdisciplinary,PhD,40+,8,0,0,Office,Tier1_City,3,4,4,5,4,1,4,38.5,Other,5,2,3,3,0,4,1,2,3,1,1,1,1,2,63.16
Law,Financial Controller,4.93986165433601,2,0,0,1,6,0,4,3,3,4,3,3,2,0,Arts,Masters,31-35,9,0,0,Remote,Tier1_City,3,2,0,3,2,2,5,20.57,Finance,2,3,5,1,1,3,4,1,2,1,0,1,3,3,64.64
Education,Principal,3.162405681512791,8,1,1,1,3,1,2,3,4,3,1,2,2,0,Arts,PhD,18-24,3,1,7,Flexible,Tier1_City,4,2,0,2,4,5,4,5.4,Other,1,4,1,4,2,1,5,2,5,2,0,1,4,3,61.88
Music,Surgeon,4.629393516839956,1,0,2,1,6,1,1,0,3,1,0,3,4,1,Arts,Bachelors,18-24,9,0,0,Remote,Any,1,2,1,3,0,1,5,42.62,Education,3,1,4,1,5,2,4,5,5,4,1,0,5,4,53.48
Law,Judge,3.646480687937143,9,1,4,0,1,1,0,0,0,1,4,1,3,1,Arts,Masters,18-24,3,0,0,Remote,Tier2_City,2,4,5,5,1,4,2,33.1,Finance,1,3,1,3,3,1,2,4,5,4,0,0,3,2,48.79
Education,Art Therapist,4.216716119136947,5,2,4,1,3,1,2,4,1,3,3,1,1,1,Arts,Masters,31-35,11,0,0,Hybrid,Tier3_City,1,1,2,5,1,3,5,3.42,Manufacturing,1,4,5,1,3,3,5,5,2,2,1,0,1,3,58.42
Business,Artist,4.828856659653555,9,2,0,1,9,0,0,3,1,4,2,4,4,0,Commerce,Masters,25-30,12,0,0,Hybrid,Any,4,3,4,1,4,0,2,15.57,Manufacturing,4,2,5,2,1,0,1,3,3,2,0,1,1,3,58.53
Psychology,Physical Chemist,4.071719906605911,9,2,1,1,1,0,3,3,0,3,2,3,4,1,Arts,PhD,18-24,1,0,0,Remote,Any,5,1,0,4,0,3,4,19.55,Healthcare,1,1,2,3,3,5,5,2,2,2,1,1,5,2,44.11
Finance,Software Developer,3.941197814846341,3,2,3,1,5,1,2,4,4,0,3,3,0,1,Commerce,Bachelors,36-40,2,0,0,Office,Any,5,1,5,1,4,4,4,18.16,Manufacturing,3,2,2,4,4,4,3,4,5,4,0,1,5,1,61.07
Law,Urban Planner,3.066976178482305,1,1,1,1,4,0,2,3,0,0,2,3,2,1,Arts,Bachelors,18-24,3,1,25,Hybrid,Tier3_City,4,1,4,5,3,2,2,26.42,Education,3,4,3,5,1,2,1,3,4,5,1,1,5,3,49.48
Education,Musician,4.096106357769229,7,0,0,1,1,0,2,2,2,0,1,0,2,1,Arts,Masters,18-24,6,1,14,Remote,Tier2_City,3,5,5,2,1,5,3,27.76,Healthcare,4,1,1,1,1,3,5,2,2,2,0,0,3,5,40.56
Law,Geneticist,4.774854137171819,9,2,1,0,2,0,2,3,2,2,0,0,0,0,Arts,Masters,18-24,12,1,28,Flexible,Tier2_City,2,3,2,2,1,1,5,21.65,Other,5,1,1,3,5,3,4,2,4,1,1,0,3,5,55.58
Physics,School Counselor,4.513866732721659,4,0,4,1,5,1,4,2,1,1,3,4,0,1,Science,Masters,18-24,2,0,0,Flexible,Tier3_City,4,3,3,1,3,1,1,18.59,Healthcare,4,3,5,1,2,1,5,3,5,4,0,1,4,4,56.88
Computer Science,Judge,4.005274251234962,4,0,3,1,2,0,0,4,3,0,1,4,1,1,Science,Bachelors,25-30,7,0,0,Hybrid,Any,4,5,2,5,0,4,4,26.71,Education,4,1,2,3,3,2,2,1,2,3,0,0,2,1,46.27
Law,Pharmacist,2.6335164814373164,3,2,4,0,7,0,2,4,1,3,4,0,2,1,Arts,Bachelors,36-40,7,0,0,Office,Any,2,5,4,2,1,0,5,4.58,Tech,1,4,4,3,2,4,1,2,2,2,1,0,1,2,50.92
Law,Ecologist,2.901716950258053,2,0,4,1,8,0,2,3,4,4,2,4,2,0,Arts,Bachelors,36-40,9,1,53,Remote,Tier3_City,3,2,0,5,5,3,5,33.32,Finance,2,5,5,4,3,5,5,4,4,2,0,0,5,2,71.99
Medicine,Microbiologist,2.5000928640688933,2,0,2,0,0,1,4,0,3,3,0,1,2,1,Science,Bachelors,25-30,10,0,0,Remote,Tier2_City,3,5,4,2,5,5,4,31.48,Education,5,5,1,1,1,3,1,5,1,3,1,1,2,1,50.79
Art,Digital Marketing Specialist,2.899680796511931,5,0,0,1,3,1,1,1,1,2,2,2,3,1,Arts,Masters,25-30,1,0,0,Hybrid,Any,2,4,1,5,5,2,2,16.12,Tech,5,1,1,1,3,4,4,3,4,3,1,1,1,4,48.43
Biology,Risk Analyst,3.1528017711873986,6,0,2,1,6,1,0,2,2,4,0,4,1,1,Science,Masters,25-30,3,1,47,Flexible,Any,1,5,5,3,2,0,4,11.44,Tech,5,5,5,3,2,0,2,1,5,1,1,1,2,2,49.41
Computer Science,Biochemist,4.663622513807585,5,2,3,0,7,0,1,2,4,4,1,3,2,0,Science,Bachelors,18-24,7,0,0,Hybrid,Tier2_City,5,2,2,5,2,5,5,6.43,Manufacturing,1,4,5,2,1,1,1,2,4,4,1,0,2,1,60.8
Law,Pharmacist,3.1470851764347274,5,1,0,1,2,1,0,3,4,4,0,4,3,1,Arts,Bachelors,18-24,0,0,0,Remote,Tier2_City,2,5,1,5,0,5,3,30.61,Other,4,3,5,5,5,4,2,5,1,4,0,0,2,3,40.98
Education,Judge,3.376175903542236,2,1,2,0,2,0,3,4,0,4,4,1,4,1,Arts,Bachelors,36-40,0,0,0,Hybrid,Tier3_City,3,4,4,1,3,4,2,29.74,Healthcare,1,2,1,5,3,3,4,1,5,4,0,0,3,3,57.01
Physics,Physical Chemist,4.019622710324295,7,1,2,1,1,1,2,0,0,3,0,4,0,1,Science,Bachelors,18-24,13,0,0,Remote,Tier2_City,1,5,4,3,4,4,4,28.07,Healthcare,3,2,4,2,2,3,1,3,2,1,0,0,4,1,44.51
Chemistry,Industrial-Organizational Psychologist,3.7815890890004,3,1,2,0,0,0,0,0,3,1,2,4,1,1,Science,Masters,18-24,13,1,16,Remote,Tier3_City,4,1,5,4,0,1,1,49.32,Manufacturing,2,4,1,4,5,3,4,2,2,1,1,1,3,5,50.75
Engineering,Legal Consultant,2.981561337797292,7,0,4,1,3,1,4,2,2,4,2,1,2,1,Science,PhD,25-30,3,0,0,Hybrid,Tier1_City,4,3,1,1,4,2,4,27.98,Manufacturing,2,3,5,2,3,3,4,2,1,5,1,1,2,5,59.14
Engineering,Analytical Chemist,4.393326903092733,9,1,4,1,2,0,0,4,1,3,3,3,2,0,Science,Bachelors,25-30,10,0,0,Hybrid,Tier2_City,4,4,0,4,0,0,5,36.92,Healthcare,1,4,2,2,5,2,2,3,5,2,1,0,3,2,59.18
Art,Biologist,3.384191635045785,6,1,1,1,4,0,1,3,0,0,2,0,2,0,Arts,Masters,18-24,1,0,0,Remote,Tier2_City,5,4,0,2,2,1,5,8.31,Education,4,1,4,4,2,5,4,5,5,3,1,1,5,4,42.71
Engineering,Conductor,4.819270072853842,9,2,0,0,8,1,1,1,3,1,3,1,0,1,Science,Masters,18-24,0,0,0,Remote,Tier2_City,3,4,2,4,5,2,1,17.05,Education,5,3,3,3,4,1,4,5,2,3,0,1,5,2,42.11
Psychology,Advertising Manager,3.745487067801172,1,1,1,1,0,1,4,0,2,0,3,3,4,0,Arts,Masters,25-30,7,0,0,Hybrid,Tier1_City,1,1,5,5,3,3,2,15.95,Education,3,5,1,1,2,2,5,4,4,3,1,0,5,1,61.17
Business,Mechanical Engineer,3.5195758240708224,9,0,1,1,9,1,3,0,4,4,2,0,3,0,Commerce,Bachelors,31-35,1,0,0,Office,Tier1_City,3,1,1,4,2,3,5,30.07,Education,3,1,4,5,0,5,1,2,4,1,0,0,5,5,43.87
Finance,Digital Marketing Specialist,2.979327882833394,8,1,2,1,6,1,4,2,1,1,1,2,4,0,Commerce,PhD,18-24,3,0,0,Hybrid,Any,5,3,2,1,3,1,2,18.55,Manufacturing,2,5,4,5,3,5,4,3,5,2,1,1,2,4,57.05
Biology,Manager,4.662629277540425,3,2,4,0,5,1,0,3,4,0,3,0,3,1,Science,Bachelors,25-30,2,0,0,Office,Tier1_City,5,2,2,1,4,0,2,33.13,Finance,4,1,5,5,0,2,3,2,1,1,1,0,1,4,39.04
Art,Architect,4.816718244883329,9,0,4,1,0,0,3,1,3,4,1,1,1,0,Arts,Bachelors,25-30,14,1,40,Remote,Tier1_City,2,3,3,4,0,2,4,35.43,Finance,5,1,4,2,4,1,3,4,1,5,1,0,4,2,57.99
Business,Illustrator,3.6686201563085614,3,0,3,1,5,1,3,2,0,2,2,0,3,1,Commerce,Bachelors,36-40,1,0,0,Remote,Tier3_City,3,4,5,1,1,3,2,4.58,Healthcare,2,1,1,3,2,5,5,4,2,3,1,0,1,4,33.91
Education,Biomedical Engineer,3.0749735684145083,8,0,4,1,1,0,1,1,0,1,3,0,1,1,Arts,Bachelors,25-30,7,1,6,Office,Tier2_City,4,4,2,1,1,3,5,33.07,Finance,4,1,2,3,5,3,4,1,3,4,1,0,4,3,46.23
Biology,Inorganic Chemist,4.699926162970849,9,2,4,1,5,0,3,2,0,4,2,2,0,1,Science,Bachelors,18-24,2,0,0,Hybrid,Tier3_City,2,4,5,4,3,0,5,8.49,Education,5,3,4,2,1,0,5,2,1,2,0,0,1,3,39.42
Architecture,Biochemist,3.206684199053834,6,1,1,0,2,1,4,4,0,1,1,0,2,1,Interdisciplinary,Bachelors,25-30,14,0,0,Hybrid,Tier2_City,3,3,5,3,5,1,3,24.86,Manufacturing,1,3,1,4,1,2,3,3,3,5,0,0,5,3,63.81
Art,Construction Manager,2.843779529917348,4,2,2,0,5,0,0,4,0,2,4,1,2,0,Arts,Bachelors,31-35,8,1,32,Flexible,Tier3_City,2,2,2,3,5,4,2,37.15,Education,4,1,5,4,5,4,1,1,4,4,0,0,5,1,62.14
Biology,Game Developer,2.8984749679042325,4,0,2,1,8,0,2,2,0,1,1,1,4,1,Science,Masters,18-24,9,0,0,Hybrid,Tier2_City,2,2,3,2,3,5,3,36.06,Tech,3,4,4,3,2,5,4,3,2,4,1,0,3,1,51.02
Biology,Financial Advisor,4.125066056495795,3,2,4,1,5,0,4,2,2,3,0,1,0,0,Science,Masters,25-30,4,0,0,Remote,Any,1,3,2,1,2,2,4,17.09,Manufacturing,4,1,3,2,4,2,5,4,4,2,1,1,3,5,51.43
Chemistry,Chemist,3.806274959590702,7,2,0,1,7,1,4,4,4,4,2,0,3,1,Science,Bachelors,18-24,8,0,0,Flexible,Tier1_City,2,4,2,4,1,3,3,15.8,Tech,4,1,3,5,5,1,1,5,1,3,1,1,2,3,60.31
Finance,Market Research Analyst,3.212152647959437,0,1,2,0,1,0,0,4,2,2,0,2,0,0,Commerce,Masters,18-24,2,0,0,Remote,Tier1_City,5,3,5,1,2,5,2,23.69,Tech,4,4,2,1,2,2,5,5,4,2,1,0,4,4,43.05
Marketing,Microbiologist,4.993699639207092,4,2,3,0,4,1,3,2,4,2,3,1,3,1,Commerce,Masters,25-30,11,0,0,Office,Any,4,3,2,5,4,5,5,11.87,Healthcare,5,4,5,3,5,4,1,3,5,4,0,1,4,4,76.3
Finance,Clinical Psychologist,3.614915345133013,9,2,2,1,5,1,0,1,0,1,4,2,2,0,Commerce,Masters,25-30,4,0,0,Hybrid,Tier3_City,1,5,1,1,1,4,4,48.81,Tech,5,1,1,5,1,2,1,3,4,4,1,1,2,3,49.69
Business,Teacher,3.622680126989234,0,0,0,0,4,1,4,4,1,3,3,0,1,1,Commerce,Bachelors,36-40,13,0,0,Hybrid,Tier3_City,2,5,3,1,4,5,2,19.21,Finance,1,2,4,3,1,0,5,5,3,2,1,1,5,2,60.38
Physics,Music Teacher,4.868672570197967,0,2,3,0,8,0,1,0,4,0,3,0,4,0,Science,Masters,31-35,9,0,0,Hybrid,Tier1_City,1,1,0,3,0,0,4,46.38,Finance,1,2,1,1,1,2,3,1,3,3,1,0,3,4,52.39
Education,Biotechnologist,4.28654945860831,7,2,0,0,8,1,0,2,1,1,3,3,4,1,Arts,PhD,25-30,5,1,35,Hybrid,Tier2_City,4,1,2,4,2,1,1,45.69,Tech,5,4,3,4,2,4,5,5,4,4,0,1,2,3,58.7
Business,Graphic Designer,4.47538827829492,2,0,2,0,3,0,3,1,2,0,1,3,4,1,Commerce,Masters,25-30,8,0,0,Office,Tier1_City,4,3,1,1,3,2,2,20.15,Healthcare,5,1,5,3,4,5,2,4,1,2,1,0,5,2,50.86
Architecture,Biologist,4.360966024327043,9,0,4,0,8,1,0,4,0,1,0,0,3,0,Interdisciplinary,Bachelors,25-30,7,0,0,Flexible,Tier1_City,1,5,1,3,1,0,1,14.94,Tech,2,5,1,2,4,3,4,2,3,4,1,0,1,1,42.91
Physics,Conductor,4.865785496908755,2,0,3,1,4,1,0,0,4,4,3,1,2,1,Science,Bachelors,18-24,1,0,0,Remote,Tier2_City,3,4,1,2,2,1,3,39.23,Manufacturing,4,5,4,4,4,0,3,3,2,1,1,0,2,4,38.15
Law,Geneticist,3.368751254782679,3,1,1,0,5,0,3,4,2,3,2,2,3,0,Arts,Masters,36-40,1,0,0,Office,Any,4,1,3,3,3,0,2,13.78,Manufacturing,4,1,5,4,5,5,3,1,5,1,1,1,2,1,53.57
Biology,Financial Analyst,2.673967308091973,1,1,0,1,5,0,0,3,1,2,3,4,4,1,Science,Bachelors,40+,12,0,0,Remote,Tier1_City,5,4,3,3,0,3,1,27.5,Manufacturing,3,1,4,5,1,3,5,4,1,3,0,1,5,2,52.9
Physics,Physicist,3.4593843286246466,7,1,0,1,6,1,3,2,4,4,2,3,0,1,Science,Bachelors,18-24,4,0,0,Remote,Tier1_City,5,4,4,3,1,3,5,8.2,Manufacturing,5,1,4,2,3,2,4,2,2,2,0,1,1,5,47.9
Engineering,Software Developer,4.328733411311719,6,0,2,0,8,0,4,1,1,1,2,4,3,0,Science,Bachelors,18-24,4,0,0,Flexible,Tier1_City,2,1,2,1,4,4,3,21.14,Tech,5,5,5,3,5,4,2,1,1,4,0,0,3,5,51.58
Finance,Cybersecurity Analyst,3.550561883531361,8,1,1,1,9,1,4,1,2,2,3,4,3,0,Commerce,Masters,18-24,4,1,12,Hybrid,Tier3_City,3,3,0,1,0,0,2,6.67,Education,1,5,5,3,2,5,5,3,3,2,0,0,2,3,53.33
Art,Construction Manager,4.646658362494131,6,1,2,1,1,0,1,4,3,3,2,0,3,1,Arts,Masters,31-35,3,1,49,Remote,Tier2_City,3,5,0,2,5,5,2,16.32,Education,1,4,4,2,1,1,4,1,1,4,1,0,2,2,51.0
Education,School Counselor,3.7860561784491296,0,2,1,1,7,0,1,2,2,0,1,2,4,0,Arts,Bachelors,31-35,7,0,0,Hybrid,Tier1_City,2,1,4,5,3,3,5,34.27,Other,4,3,3,4,4,0,5,4,2,5,0,1,2,3,52.38
Music,Financial Analyst,3.112402614755199,6,2,3,0,8,1,0,2,2,2,1,0,4,0,Arts,PhD,36-40,10,1,59,Remote,Tier3_City,4,2,0,5,1,1,5,49.59,Manufacturing,4,4,4,3,2,5,4,5,1,1,0,0,3,2,46.23
Marketing,Market Research Analyst,4.701386226971325,2,0,1,1,6,0,2,1,4,3,2,1,2,0,Commerce,Bachelors,31-35,4,1,56,Hybrid,Tier1_City,1,2,2,5,1,4,1,14.98,Other,5,4,5,3,5,4,3,3,3,2,0,1,3,5,44.98
Medicine,Illustrator,3.088255265209262,1,0,0,0,3,1,1,1,3,2,1,4,3,0,Science,Masters,25-30,0,0,0,Hybrid,Tier1_City,3,4,0,2,0,5,1,25.25,Other,4,2,2,3,4,5,5,2,4,3,0,0,1,2,47.79
Chemistry,Fluid Mechanics Engineer,4.977363732036034,2,0,2,0,9,1,4,4,0,1,2,1,0,0,Science,Masters,31-35,9,1,53,Flexible,Tier1_City,3,2,2,5,1,2,1,24.06,Healthcare,5,4,1,1,0,1,2,3,2,3,0,1,1,4,56.8
Art,AI Researcher,4.254055639556566,1,1,2,1,8,1,2,3,1,0,3,3,2,1,Arts,Masters,31-35,13,0,0,Remote,Tier1_City,4,4,3,5,3,0,4,11.66,Healthcare,3,4,4,2,1,0,4,4,4,4,1,0,4,5,66.52
Physics,Cybersecurity Analyst,4.385819063094695,3,2,1,0,4,0,1,0,0,1,0,1,0,0,Science,PhD,25-30,4,0,0,Remote,Tier1_City,1,5,3,3,0,3,3,31.67,Tech,3,4,1,1,4,0,2,2,3,1,0,0,4,2,32.07
Music,Financial Controller,2.927425595230162,9,0,3,1,5,1,4,0,4,0,0,3,0,1,Arts,Bachelors,25-30,0,0,0,Remote,Tier1_City,5,1,2,1,4,5,2,37.06,Education,2,4,4,1,0,2,2,4,2,5,0,1,3,2,45.55
Finance,Physician Assistant,2.8550817946794025,9,2,3,0,2,1,4,0,3,3,4,0,4,0,Commerce,Masters,31-35,3,1,45,Remote,Tier2_City,3,1,5,1,0,1,3,9.92,Tech,1,3,4,5,4,1,5,3,4,4,0,1,2,5,61.44
Engineering,Marketing Specialist,4.488677402467879,9,0,1,1,6,1,0,1,3,4,0,3,1,0,Science,Bachelors,25-30,0,0,0,Flexible,Tier1_City,4,5,2,3,0,0,5,38.58,Finance,2,2,2,3,1,5,4,1,2,1,0,0,3,1,33.62
Business,Physicist,3.685111123270036,6,0,0,1,8,0,2,4,2,1,3,2,2,1,Commerce,Masters,31-35,5,0,0,Flexible,Tier1_City,3,4,3,3,4,1,3,35.91,Manufacturing,3,5,5,1,3,0,1,4,5,3,1,0,4,1,59.57
Business,Acoustics Specialist,3.51208639697691,0,1,2,0,7,1,1,0,2,2,2,2,4,1,Commerce,Masters,31-35,5,0,0,Office,Tier1_City,5,3,2,3,5,4,3,12.28,Finance,4,1,3,2,4,0,2,5,4,2,0,0,4,3,48.64
Art,Biologist,4.856427994511545,4,2,1,0,2,1,4,2,3,4,4,3,4,0,Arts,Masters,31-35,0,0,0,Hybrid,Tier1_City,2,2,4,1,3,3,1,33.5,Finance,1,5,5,5,4,2,4,5,4,3,1,0,5,3,62.13
Education,Doctor,3.326756293047049,8,2,2,1,0,1,4,4,2,2,4,4,4,1,Arts,Bachelors,31-35,11,0,0,Office,Tier1_City,4,5,3,5,5,3,5,21.5,Other,1,2,1,5,5,5,3,3,5,5,0,0,4,4,78.69
Computer Science,Nuclear Physicist,4.880376086902743,1,1,4,1,3,1,0,2,2,2,3,4,3,0,Science,Masters,25-30,7,1,7,Remote,Tier1_City,1,2,0,3,5,4,3,35.01,Healthcare,2,4,1,4,0,2,2,2,3,4,0,0,1,5,63.2
Education,Conductor,2.834778584104697,9,1,4,1,1,0,0,3,4,2,1,1,1,1,Arts,Bachelors,31-35,13,0,0,Remote,Any,2,3,3,2,5,1,2,26.32,Education,1,5,4,4,1,3,2,1,5,3,0,1,5,2,60.4
Education,Credit Analyst,2.688542725688782,0,0,2,1,8,1,0,0,0,1,0,3,0,1,Arts,Bachelors,25-30,3,0,0,Hybrid,Tier2_City,1,4,0,3,2,0,1,5.26,Other,3,4,5,5,4,3,2,2,2,2,1,0,5,1,32.36
Business,Biotechnologist,2.697069248298038,0,1,4,0,2,1,3,4,3,2,3,1,3,0,Commerce,Masters,18-24,1,1,24,Office,Tier3_City,5,2,0,4,5,1,3,39.99,Other,4,3,2,2,5,3,3,4,2,3,0,1,2,1,53.2
Biology,Zoologist,3.288133866888592,2,1,0,0,7,1,3,3,4,2,2,3,2,0,Science,Bachelors,18-24,12,0,0,Hybrid,Tier3_City,1,4,4,3,2,0,5,29.11,Manufacturing,2,3,3,1,5,3,3,3,2,5,0,0,4,3,63.56
Computer Science,Manager,4.938795435170702,9,2,4,1,7,0,3,2,1,4,0,1,3,0,Science,Masters,25-30,13,0,0,Hybrid,Tier2_City,3,3,3,1,4,5,2,37.07,Tech,4,2,5,4,2,1,5,1,3,1,1,1,4,3,56.47
Finance,Microbiologist,4.251216022362191,7,2,4,0,4,1,4,3,2,4,4,3,0,1,Commerce,Bachelors,25-30,0,0,0,Remote,Tier3_City,5,4,3,3,3,4,5,8.93,Manufacturing,2,5,4,1,5,1,1,3,5,2,1,0,5,2,56.64
Music,Dentist,3.877786259990259,7,0,1,0,7,1,2,1,1,1,2,3,0,0,Arts,Bachelors,40+,10,1,52,Hybrid,Tier2_City,2,3,4,4,5,2,5,36.9,Tech,5,3,1,2,1,4,5,3,1,4,1,0,3,3,54.15
Computer Science,Fluid Mechanics Engineer,2.939816511052861,9,2,4,1,5,0,1,2,1,0,3,3,1,1,Science,Masters,25-30,2,0,0,Flexible,Tier2_City,3,1,3,2,1,0,5,22.44,Tech,1,2,5,1,0,4,1,3,4,4,1,0,1,4,45.56
Biology,Advertising Manager,4.57972145489185,5,1,3,0,2,1,1,3,2,1,0,1,4,0,Science,Bachelors,25-30,6,0,0,Hybrid,Any,3,2,0,5,4,3,4,40.57,Education,5,2,1,5,0,5,2,2,5,3,0,0,4,5,53.84
Biology,Data Scientist,2.510411277493142,9,0,4,0,9,0,3,1,3,1,2,4,4,0,Science,Bachelors,18-24,9,0,0,Hybrid,Tier1_City,5,2,5,3,2,5,2,31.16,Finance,1,2,4,4,0,3,4,4,2,1,0,1,3,2,54.43
Architecture,Human Resources Specialist,3.9281412596300624,5,0,1,0,4,1,3,1,2,0,2,4,1,0,Interdisciplinary,Masters,18-24,10,1,55,Hybrid,Tier1_City,1,3,5,4,3,3,5,19.68,Tech,5,5,1,2,1,3,2,4,5,3,0,1,4,4,64.08
Art,Paralegal,4.837089504310182,8,0,0,0,8,1,4,0,0,2,0,0,4,1,Arts,Bachelors,31-35,9,0,0,Office,Tier1_City,1,3,2,4,0,5,4,12.49,Education,4,5,4,5,5,1,3,2,5,4,0,0,3,3,56.1
Psychology,Civil Engineer,4.855695535567991,9,0,0,1,4,0,1,3,0,4,0,4,1,0,Arts,Masters,18-24,7,0,0,Hybrid,Tier3_City,2,5,5,2,3,3,1,41.35,Finance,3,2,3,2,1,3,1,5,3,2,1,1,1,5,53.83
Law,Chemist,4.574071443971197,3,0,2,0,1,1,1,2,1,4,4,3,3,0,Arts,Bachelors,31-35,4,0,0,Hybrid,Tier2_City,5,3,5,1,3,1,4,29.33,Other,2,1,2,4,4,5,2,1,4,3,0,1,1,1,56.9
Computer Science,Legal Analyst,4.5788579718820674,4,1,4,1,1,0,3,2,0,1,2,3,1,1,Science,Masters,31-35,6,0,0,Hybrid,Any,2,3,4,3,5,1,1,49.41,Other,1,5,1,1,0,3,1,1,3,5,1,0,1,1,55.66
Psychology,Data Scientist,2.9206713270241207,1,1,3,1,8,0,3,3,0,3,0,3,0,0,Arts,Masters,25-30,1,0,0,Remote,Tier2_City,4,4,5,4,5,1,4,20.55,Finance,2,5,5,2,5,1,5,2,3,5,0,1,1,1,49.84
Psychology,Astronomer,4.32709814317268,3,2,2,1,6,0,4,0,4,2,1,4,1,0,Arts,Masters,36-40,11,0,0,Flexible,Tier2_City,5,4,4,2,2,5,5,35.23,Manufacturing,3,1,3,4,0,0,3,3,2,1,1,1,2,3,61.21
Computer Science,Marketing Specialist,3.970810725044678,2,2,2,1,6,0,2,2,2,2,1,4,1,1,Science,Bachelors,25-30,11,1,15,Flexible,Tier2_City,4,2,2,5,2,5,4,32.27,Manufacturing,5,5,2,5,5,1,3,3,3,1,0,0,5,3,58.32
Computer Science,Legal Secretary,4.661714876140335,8,1,3,0,5,1,3,4,1,0,4,3,4,1,Science,Masters,25-30,14,1,41,Hybrid,Tier2_City,2,4,0,4,5,3,4,32.97,Manufacturing,4,5,5,4,5,5,4,4,4,1,0,0,4,4,67.14
Art,Construction Manager,3.024540534106736,4,0,2,1,9,1,0,0,0,4,4,3,3,0,Arts,Masters,36-40,3,0,0,Remote,Tier3_City,4,4,2,2,5,0,5,37.64,Healthcare,2,3,5,1,1,3,2,2,2,5,1,0,4,4,49.01
Computer Science,Curriculum Developer,4.40231016761842,0,1,0,1,8,0,3,2,3,3,4,4,1,0,Science,Masters,36-40,5,0,0,Office,Tier1_City,4,2,3,1,1,5,1,9.54,Finance,5,1,4,4,1,1,3,5,3,2,1,1,3,2,61.89
Biology,Aerospace Engineer,2.888751790466595,0,2,3,0,8,1,2,2,4,1,4,1,2,0,Science,Bachelors,18-24,11,0,0,Hybrid,Tier2_City,3,1,2,1,1,3,5,28.83,Healthcare,1,3,2,5,2,4,4,5,2,2,0,0,2,3,60.82
Music,Education Administrator,4.309325594714413,2,2,1,0,2,1,4,0,2,1,4,1,1,0,Arts,Masters,18-24,11,1,48,Remote,Tier1_City,3,5,4,4,4,0,2,26.93,Manufacturing,2,1,5,5,0,0,3,1,5,4,1,1,4,1,72.84
Physics,Legal Analyst,4.132420433993593,7,1,0,1,8,1,1,1,2,3,2,2,2,1,Science,Masters,18-24,11,0,0,Remote,Tier2_City,2,4,1,4,5,1,4,19.1,Education,2,1,5,2,5,0,5,1,4,2,0,1,1,1,63.14
Education,Market Research Analyst,3.688724180639509,1,2,3,0,0,0,0,4,1,2,1,3,0,0,Arts,Bachelors,25-30,11,0,0,Flexible,Tier2_City,2,1,3,3,0,5,2,23.5,Manufacturing,1,1,5,5,1,0,2,3,1,5,1,1,4,5,56.24
Chemistry,Clinical Psychologist,4.699641336370533,2,1,2,0,5,1,2,0,3,0,0,4,3,1,Science,Bachelors,40+,13,1,47,Office,Any,1,5,5,2,1,2,5,27.38,Tech,3,5,3,3,1,5,2,3,1,1,1,0,3,4,42.07
Marketing,Industrial-Organizational Psychologist,3.927827752596987,1,2,2,1,6,0,2,1,1,1,1,0,2,0,Commerce,Masters,25-30,11,1,17,Office,Any,4,2,5,4,2,1,5,18.08,Education,5,2,2,5,4,1,1,2,1,4,0,1,4,3,52.64
Biology,Astronomer,2.754617463186805,5,2,2,0,7,1,4,4,1,4,1,4,1,1,Science,High School,25-30,11,0,0,Hybrid,Tier2_City,1,4,5,3,3,4,3,16.78,Education,2,4,4,1,0,4,4,3,5,5,0,0,3,2,65.17
Medicine,Web Developer,3.325034827162892,7,1,1,1,5,1,0,3,0,1,2,4,1,0,Science,PhD,36-40,4,0,0,Office,Tier1_City,1,4,2,3,4,0,2,37.7,Finance,5,2,3,5,2,2,5,3,3,1,1,0,1,2,49.17
Art,Clinical Psychologist,4.994473073392409,3,2,4,1,6,1,4,4,4,2,0,1,0,0,Arts,Masters,25-30,5,0,0,Hybrid,Tier3_City,5,3,2,4,1,2,3,6.15,Healthcare,4,5,3,2,1,4,1,4,5,5,1,1,3,1,63.26
Architecture,Legal Analyst,3.9209694339266408,9,2,2,0,6,0,0,1,3,0,3,2,4,0,Interdisciplinary,Masters,25-30,11,0,0,Hybrid,Tier1_City,1,4,0,1,3,1,2,17.71,Tech,5,5,3,5,4,4,5,2,1,5,0,0,4,4,57.41
Biology,Aerospace Engineer,2.782497890003063,8,0,0,0,4,0,4,1,2,0,2,4,3,1,Science,Bachelors,36-40,1,1,21,Office,Tier2_City,1,4,3,2,3,5,3,33.72,Education,5,4,4,4,5,3,1,1,3,5,0,1,4,5,49.34
Physics,Clinical Psychologist,4.11992274196975,9,2,4,1,6,0,1,2,3,2,0,0,2,0,Science,Bachelors,36-40,6,0,0,Flexible,Tier1_City,4,1,0,2,1,2,3,12.81,Healthcare,1,5,4,4,4,4,1,2,5,4,0,1,3,1,49.51
Finance,Organic Chemist,4.5682883690591805,8,0,3,1,8,1,3,4,1,4,2,4,3,1,Commerce,PhD,36-40,7,0,0,Flexible,Tier1_City,1,1,4,1,0,3,2,29.9,Healthcare,5,1,3,4,3,1,2,5,3,5,0,0,2,4,71.8
Finance,Analytical Chemist,4.595295258266095,4,0,0,0,8,1,0,2,4,4,1,2,3,0,Commerce,Bachelors,25-30,12,1,23,Office,Tier2_City,4,4,4,4,0,0,5,17.2,Tech,3,3,3,3,5,0,5,3,1,5,1,1,3,2,53.52
Law,Forensic Psychologist,4.946648596355109,6,2,1,1,2,0,4,0,0,1,2,0,2,0,Arts,Masters,31-35,13,0,0,Office,Tier1_City,4,5,0,2,4,4,1,42.64,Tech,5,3,1,2,5,5,4,1,4,3,1,1,4,1,59.16
Art,Education Administrator,3.888538684922605,5,1,0,1,9,1,1,0,4,2,2,3,4,0,Arts,Bachelors,18-24,10,0,0,Office,Any,1,2,3,4,0,3,5,19.45,Manufacturing,4,1,4,4,5,4,4,2,1,3,0,0,1,3,52.77
Business,Astronomer,4.8107751312855545,8,2,2,0,9,1,3,4,1,0,2,3,0,1,Commerce,Bachelors,25-30,8,0,0,Flexible,Tier2_City,4,1,0,4,4,2,1,13.79,Manufacturing,5,2,5,4,0,4,1,1,1,1,0,0,3,5,53.15
Business,Composer,3.7035161006256976,6,2,2,1,8,0,1,0,4,4,2,3,3,0,Commerce,High School,40+,5,1,48,Hybrid,Tier2_City,2,5,5,3,2,1,2,27.91,Education,1,3,2,4,4,2,1,3,2,5,0,0,1,3,49.13
Engineering,Human Resources Specialist,4.7373734929976,5,0,0,1,6,0,0,3,3,2,1,0,3,1,Science,Bachelors,25-30,6,0,0,Remote,Tier1_City,2,4,0,1,1,0,4,9.38,Education,4,1,2,2,2,2,5,1,3,5,0,0,4,4,50.22
Art,Geneticist,2.9255179571432817,3,2,1,0,7,1,0,1,3,0,0,0,3,1,Arts,PhD,31-35,12,0,0,Office,Tier1_City,4,3,3,4,3,5,5,40.48,Education,1,2,2,4,0,5,2,1,2,5,0,1,4,4,57.07
Marketing,Clinical Psychologist,3.24822820704096,6,0,3,1,9,1,3,1,0,4,2,0,1,0,Commerce,Bachelors,25-30,11,0,0,Flexible,Tier3_City,2,1,4,5,4,4,3,34.96,Manufacturing,3,3,3,3,2,3,2,1,5,5,0,1,5,2,61.34
Biology,Quantum Physicist,4.360864801265128,9,1,1,1,1,0,1,2,0,2,0,0,0,0,Science,Bachelors,18-24,12,1,14,Hybrid,Tier3_City,5,1,1,1,0,1,5,39.21,Education,3,1,4,4,5,5,5,5,5,5,1,0,4,4,55.17
Chemistry,Nuclear Physicist,4.415619340977001,8,2,3,1,4,0,4,3,3,3,3,3,2,1,Science,Bachelors,31-35,0,0,0,Office,Tier2_City,3,3,0,2,4,4,2,21.75,Education,1,3,1,1,4,2,5,4,1,3,0,1,3,4,48.53
Art,Organic Chemist,2.7071429785487666,0,2,2,1,8,0,3,1,2,3,4,1,1,0,Arts,Bachelors,18-24,8,0,0,Remote,Tier2_City,2,4,5,3,5,5,4,42.25,Manufacturing,3,3,1,3,0,5,2,2,2,1,1,0,3,4,54.28
Education,Data Scientist,4.180178711697037,0,2,2,1,5,1,0,4,4,4,2,2,1,0,Arts,Bachelors,31-35,5,1,44,Flexible,Tier2_City,1,1,5,2,4,0,4,26.2,Manufacturing,1,3,2,1,4,3,1,1,2,1,0,1,5,2,49.38
Art,Brand Manager,4.100064424196082,5,0,2,1,0,1,1,2,1,3,1,0,2,0,Arts,Masters,18-24,11,1,17,Office,Tier3_City,2,4,0,2,0,2,5,7.45,Education,2,4,5,4,4,1,2,5,4,3,1,1,3,4,54.83
Business,Lawyer,2.6562366431442883,0,1,1,1,1,0,1,2,2,1,2,2,0,1,Commerce,Bachelors,36-40,3,1,26,Hybrid,Tier3_City,5,5,2,1,5,4,5,13.53,Education,5,2,5,4,4,0,3,1,4,3,1,1,2,5,49.39
Education,Surgeon,4.593949085888674,8,2,3,0,4,1,3,2,3,2,2,0,3,1,Arts,Bachelors,25-30,9,0,0,Office,Tier2_City,5,1,3,2,5,0,5,36.42,Healthcare,2,3,5,2,5,2,3,1,1,3,0,1,4,4,53.26
Music,Mechanical Engineer,4.710322730027718,3,1,2,1,4,0,4,0,4,4,4,0,1,0,Arts,Bachelors,18-24,8,1,16,Office,Any,5,4,2,4,0,4,2,45.13,Finance,3,1,5,1,1,1,5,4,5,5,0,0,4,4,64.16
Medicine,Music Therapist,3.2415857279903424,5,1,4,1,0,0,0,3,4,0,2,3,4,0,Science,PhD,18-24,11,0,0,Flexible,Tier2_City,2,5,4,2,5,1,1,7.47,Manufacturing,1,4,1,1,5,0,3,5,4,5,1,1,5,4,71.19
Psychology,Clinical Psychologist,2.9020681178415244,4,1,2,1,3,1,4,3,0,0,2,3,0,0,Arts,Bachelors,36-40,0,0,0,Flexible,Tier1_City,3,1,2,3,1,4,1,43.62,Finance,1,5,1,5,1,1,4,4,2,2,1,1,4,2,38.59
Art,Interior Designer,4.773778355610171,3,0,3,0,7,0,2,1,4,2,4,2,2,0,Arts,Bachelors,31-35,1,0,0,Remote,Tier2_City,1,2,3,3,3,1,3,40.56,Manufacturing,1,5,4,5,2,1,3,5,2,3,1,1,2,1,47.51
Music,Psychologist,4.179518982288629,1,0,2,1,4,0,2,4,4,1,1,3,1,0,Arts,Masters,31-35,2,0,0,Remote,Tier2_City,3,4,0,5,1,1,2,19.76,Other,1,2,1,5,1,1,2,2,1,4,1,0,4,2,50.59
Psychology,Mechanical Engineer,4.956886586899332,3,2,2,1,4,1,3,4,2,2,1,0,2,1,Arts,Masters,25-30,0,0,0,Office,Tier1_City,2,5,0,3,1,0,4,35.4,Healthcare,5,1,4,5,2,1,3,2,3,4,0,0,3,4,46.65
Business,Biotechnologist,4.306054992144096,5,2,3,0,0,1,1,4,0,1,4,2,1,0,Commerce,Bachelors,25-30,1,0,0,Flexible,Tier2_City,3,2,1,2,0,3,3,11.79,Finance,4,4,4,1,1,2,1,4,3,5,0,1,4,5,42.0
Computer Science,Interior Designer,4.9116109552818745,6,2,4,1,5,0,1,4,3,3,4,1,1,0,Science,Bachelors,18-24,1,1,25,Hybrid,Tier2_City,4,4,4,3,0,5,4,41.23,Healthcare,2,1,3,2,5,4,5,2,5,1,1,0,2,5,46.39
Business,Architect,3.786022325171751,2,2,4,1,5,0,3,1,1,3,2,0,2,0,Commerce,Masters,25-30,6,0,0,Remote,Tier3_City,1,1,0,1,3,4,4,33.89,Tech,3,4,1,5,4,1,1,1,1,4,1,1,3,5,53.65
Music,School Psychologist,4.454727266249526,1,2,1,0,5,1,2,1,0,0,3,2,3,1,Arts,Bachelors,18-24,9,0,0,Hybrid,Any,4,4,2,3,4,2,5,23.62,Finance,1,4,5,1,1,5,3,2,4,2,1,1,3,2,52.07
Biology,Entrepreneur,2.877416151209106,7,2,1,0,5,1,3,2,3,2,4,2,1,0,Science,Masters,40+,12,0,0,Hybrid,Tier3_City,4,5,1,4,1,1,4,43.63,Finance,2,5,2,2,3,0,1,2,5,2,0,0,2,4,67.34
Physics,Curriculum Developer,3.73106605244113,5,1,0,0,1,0,2,2,0,2,3,4,2,0,Science,Masters,31-35,5,1,42,Office,Tier1_City,3,1,1,1,5,3,4,9.54,Other,4,2,4,2,5,2,4,2,4,1,0,0,5,5,52.26
Education,Marketing Manager,3.5857365235247443,7,0,0,0,6,1,3,2,4,4,4,0,2,1,Arts,Bachelors,25-30,11,0,0,Remote,Tier2_City,4,1,4,5,3,1,2,42.75,Finance,2,2,2,5,4,2,1,1,1,5,1,1,5,4,68.1
Chemistry,Financial Controller,4.652525493035279,9,0,1,0,0,1,4,1,4,4,3,4,3,0,Science,Bachelors,18-24,8,0,0,Remote,Tier2_City,1,1,1,4,1,3,5,4.12,Tech,3,1,5,1,3,1,4,5,5,1,0,1,4,5,65.81
Marketing,Artist,2.612924444088323,0,0,2,1,7,0,2,4,4,0,2,3,3,1,Commerce,Bachelors,31-35,13,0,0,Flexible,Tier1_City,4,3,5,2,4,3,5,38.4,Tech,1,4,4,3,4,1,2,2,5,4,0,1,1,4,71.74
Law,Mechanical Engineer,4.65477165089892,7,2,2,1,0,1,1,0,4,4,1,0,2,1,Arts,Masters,18-24,4,1,57,Remote,Tier1_City,2,5,3,2,5,2,3,29.95,Healthcare,3,4,4,1,5,0,1,2,4,2,0,1,3,4,51.49
Engineering,Sound Engineer,3.3492748735029902,8,2,2,1,9,1,1,3,2,3,0,0,4,1,Science,Bachelors,18-24,8,0,0,Office,Tier1_City,1,2,2,2,1,3,5,35.75,Tech,1,3,1,2,5,4,3,3,3,5,1,1,2,1,50.41
Education,Microbiologist,3.028505357687363,9,0,1,1,2,0,4,4,2,0,0,3,1,1,Arts,Bachelors,18-24,13,0,0,Hybrid,Tier1_City,2,1,1,4,2,2,1,22.38,Manufacturing,4,2,3,4,1,2,2,3,3,2,1,1,2,1,55.93
Marketing,Organic Chemist,3.827681568025717,0,2,2,1,3,0,3,4,2,1,0,3,2,1,Commerce,Masters,25-30,12,0,0,Office,Tier3_City,2,5,0,4,3,0,2,43.63,Education,3,4,2,5,0,1,5,5,4,1,1,1,3,3,62.32
Physics,Financial Analyst,2.70185636635956,1,1,4,0,9,0,0,3,0,0,4,1,2,1,Science,PhD,31-35,11,1,45,Remote,Tier1_City,5,3,2,4,0,1,3,17.72,Finance,2,1,5,2,2,3,5,2,2,3,0,1,2,2,54.67
Finance,Clinical Psychologist,2.5166157319275047,8,2,1,1,0,0,3,3,3,2,3,1,0,1,Commerce,Bachelors,25-30,9,0,0,Remote,Tier1_City,5,3,4,1,1,2,1,15.92,Healthcare,4,5,3,3,4,3,3,2,2,2,1,1,5,1,57.81
Finance,Web Developer,4.219442821476791,5,2,2,1,1,1,2,3,4,1,2,3,3,1,Commerce,PhD,18-24,13,0,0,Hybrid,Tier1_City,2,1,1,1,5,5,4,17.18,Healthcare,3,5,3,3,0,1,4,5,5,4,0,1,5,3,80.76
Medicine,Chemical Engineer,4.09187918550268,9,1,0,1,7,1,3,3,3,4,4,1,0,1,Science,Bachelors,25-30,13,0,0,Flexible,Tier3_City,4,5,2,2,5,1,1,39.4,Healthcare,1,2,1,3,0,3,1,5,4,5,1,0,3,2,76.79
Art,Urban Planner,2.773940041535921,3,0,4,0,3,0,1,2,4,2,3,3,2,1,Arts,Bachelors,31-35,8,1,48,Hybrid,Tier1_City,2,3,0,3,3,5,3,26.28,Healthcare,4,2,4,3,1,0,5,3,3,1,0,0,5,3,56.37
Psychology,Doctor,3.554167143974896,6,0,1,0,1,0,2,2,3,1,2,0,1,0,Arts,Bachelors,18-24,1,0,0,Remote,Tier1_City,2,1,1,2,3,4,5,28.24,Finance,1,3,5,1,4,4,1,1,1,2,1,1,3,3,31.81
Education,Accountant,4.633573343511507,5,1,3,1,6,1,3,2,4,1,0,3,0,1,Arts,Bachelors,18-24,14,0,0,Office,Tier1_City,5,4,4,5,5,5,2,42.09,Healthcare,5,2,3,2,0,3,2,5,2,2,0,1,4,2,57.48
Marketing,Marketing Manager,3.434382784362136,6,0,4,1,7,1,3,4,2,1,3,0,3,0,Commerce,Bachelors,36-40,11,0,0,Remote,Tier1_City,3,4,4,1,5,0,3,42.17,Finance,2,4,3,3,2,0,1,3,1,2,0,1,1,5,57.58
Computer Science,Marketing Specialist,2.5573990620891243,4,2,3,0,0,1,1,2,2,0,0,3,1,1,Science,High School,40+,8,0,0,Flexible,Tier1_City,3,4,4,4,5,4,1,10.6,Healthcare,1,4,2,2,3,3,5,4,3,3,1,0,2,5,48.06
Art,Chemist,3.188548646726819,4,1,3,1,8,1,2,1,3,3,0,3,2,1,Arts,PhD,40+,2,0,0,Remote,Tier3_City,3,2,5,1,1,4,1,28.84,Healthcare,3,4,5,2,1,5,4,1,4,4,0,1,2,3,53.69
Architecture,Legal Secretary,4.393559577484719,0,2,3,0,2,1,2,4,3,1,1,1,0,0,Interdisciplinary,Masters,36-40,10,0,0,Hybrid,Tier1_City,2,5,1,4,5,3,3,8.92,Education,5,4,5,4,5,0,5,3,2,2,0,0,2,4,57.91
Biology,Investment Banker,4.76020513166579,4,0,4,0,6,0,2,1,2,2,2,3,3,1,Science,Masters,18-24,2,1,30,Remote,Tier1_City,2,4,1,5,0,5,3,43.82,Manufacturing,4,3,3,1,1,0,3,5,5,1,1,1,2,4,42.7
Chemistry,Cybersecurity Analyst,4.729396777645674,7,1,1,1,4,1,0,3,2,4,3,2,2,1,Science,Bachelors,18-24,11,0,0,Hybrid,Tier1_City,4,3,1,5,5,3,3,42.34,Tech,3,2,4,4,1,1,5,4,1,5,0,0,1,3,62.36
Psychology,Physicist,3.879278162209014,9,1,4,1,4,0,2,2,0,2,2,0,1,1,Arts,Bachelors,25-30,10,1,50,Hybrid,Any,5,2,0,1,0,5,5,42.92,Tech,4,2,5,5,2,2,1,4,2,4,0,0,2,1,52.28
Music,Teacher,4.385796774683391,8,0,1,1,6,0,0,3,2,3,2,2,0,0,Arts,Bachelors,25-30,13,0,0,Hybrid,Tier1_City,2,4,5,4,1,4,3,36.13,Tech,5,2,5,5,5,0,1,5,3,3,0,1,3,1,57.21
Law,Interior Designer,3.4167685617027788,9,1,2,0,3,1,3,0,0,4,0,4,2,0,Arts,Masters,40+,14,1,40,Remote,Any,1,1,4,5,3,3,4,24.94,Manufacturing,3,3,2,5,1,3,4,5,2,5,0,1,2,4,64.15
Architecture,Software Developer,3.582377981472768,2,1,2,0,1,1,4,4,0,3,1,4,2,0,Interdisciplinary,PhD,31-35,8,0,0,Flexible,Tier3_City,1,3,2,2,0,1,2,22.02,Finance,1,3,2,4,2,1,5,4,2,3,0,1,1,1,63.51
Law,Chemist,3.399985073450562,3,0,1,1,4,1,4,4,1,1,3,0,0,1,Arts,Bachelors,31-35,14,0,0,Office,Tier2_City,5,2,5,2,1,5,2,21.58,Tech,3,4,2,2,5,2,2,1,4,4,0,1,1,3,63.72
Architecture,Biotechnologist,2.581816133818893,8,0,1,0,0,0,2,3,1,3,2,2,3,1,Interdisciplinary,Bachelors,18-24,6,0,0,Hybrid,Tier3_City,1,2,2,4,5,5,4,6.11,Tech,2,3,4,5,0,4,2,4,4,2,1,0,5,1,58.56
Marketing,Graphic Designer,3.5312560356543408,6,1,1,1,4,1,2,3,0,2,4,1,1,0,Commerce,Bachelors,36-40,14,1,56,Hybrid,Tier2_City,1,3,1,1,1,3,1,47.6,Tech,1,3,4,5,4,0,2,5,5,4,0,1,2,4,65.89
Physics,Fluid Mechanics Engineer,3.878551298573211,9,1,1,0,5,1,3,2,0,1,1,3,4,1,Science,Bachelors,36-40,13,1,17,Office,Tier2_City,5,4,4,5,5,5,1,24.16,Finance,2,1,5,4,0,0,3,1,4,5,1,0,3,5,64.84
Law,Nuclear Physicist,3.2329157373128625,8,1,1,0,1,1,4,0,1,4,0,3,3,0,Arts,Bachelors,18-24,10,0,0,Remote,Tier2_City,2,1,4,1,1,4,1,46.72,Manufacturing,3,4,4,2,4,2,2,3,3,1,1,0,5,4,48.08
Marketing,Doctor,3.6228884707364286,2,1,3,1,5,0,2,2,4,1,4,4,2,0,Commerce,Masters,36-40,14,0,0,Flexible,Tier2_City,2,1,1,2,3,3,1,44.33,Manufacturing,3,4,2,5,1,1,3,2,5,2,1,1,1,5,76.55
Finance,Quantum Physicist,3.244835433108279,6,0,2,1,5,1,0,3,1,3,3,1,0,0,Commerce,Masters,25-30,7,0,0,Remote,Tier1_City,4,1,0,5,0,3,5,41.94,Other,4,1,4,1,0,4,2,2,1,2,1,1,4,4,41.59
Engineering,Fluid Mechanics Engineer,3.923568303607407,0,1,0,0,8,0,4,2,1,2,0,2,0,1,Science,Bachelors,18-24,6,0,0,Office,Tier2_City,2,2,2,1,3,2,4,30.65,Other,3,2,5,5,2,2,4,2,5,4,0,0,4,1,57.47
Finance,Aerospace Engineer,4.347510490063903,2,0,4,1,2,0,3,2,0,2,1,1,2,0,Commerce,High School,31-35,8,0,0,Hybrid,Tier3_City,1,4,2,3,2,2,2,7.77,Finance,1,1,3,4,1,4,5,3,4,5,1,1,1,1,54.51
Art,Dentist,3.1054941314914792,5,1,4,0,3,0,0,2,2,3,2,3,4,0,Arts,PhD,31-35,7,0,0,Hybrid,Tier1_City,1,3,3,4,5,4,4,18.22,Education,2,1,1,4,0,2,3,3,5,4,0,0,1,4,68.04
Law,Biotechnologist,2.590066126331388,4,0,4,1,5,0,1,2,3,3,0,4,0,0,Arts,Bachelors,18-24,13,0,0,Flexible,Any,4,5,1,4,0,1,2,31.37,Healthcare,5,1,4,1,0,5,1,4,5,1,1,0,2,5,54.2
Medicine,Social Media Manager,3.042096027397836,9,0,4,1,1,0,3,0,0,2,2,0,3,1,Science,Bachelors,25-30,3,1,35,Remote,Tier1_City,5,1,2,3,3,5,1,3.63,Finance,2,3,3,2,2,1,3,3,2,5,1,0,2,3,44.2
Computer Science,Principal,3.850776672399934,1,0,4,0,5,0,0,3,3,2,3,0,0,0,Science,Bachelors,40+,1,1,13,Office,Any,1,3,2,2,0,0,5,5.0,Healthcare,4,1,5,1,2,3,5,3,2,4,1,0,2,1,40.15
Law,Fluid Mechanics Engineer,4.719442543422943,7,1,1,1,9,0,1,4,1,0,0,0,1,1,Arts,High School,31-35,13,0,0,Hybrid,Tier2_City,2,3,0,5,2,5,3,34.85,Manufacturing,5,5,3,5,0,2,3,5,2,1,1,1,1,4,40.46
Marketing,Geneticist,2.885143814830658,7,0,4,0,1,0,1,0,2,0,4,4,3,0,Commerce,Bachelors,31-35,12,1,10,Remote,Tier2_City,2,1,5,4,4,0,3,44.75,Healthcare,5,1,3,4,5,3,3,3,5,1,1,1,3,3,59.26
Art,Judge,4.837437922747123,5,1,2,0,6,1,2,1,1,3,0,2,4,0,Arts,Masters,18-24,10,0,0,Hybrid,Any,2,5,1,3,5,4,1,43.19,Other,3,2,3,2,2,2,5,5,4,4,0,0,1,4,60.02
Computer Science,Financial Analyst,4.075345160360156,5,2,0,0,7,1,1,3,2,4,1,2,0,0,Science,Bachelors,18-24,4,1,47,Office,Tier3_City,1,2,1,3,5,1,1,10.9,Tech,4,2,2,5,3,0,2,4,3,3,1,0,2,1,53.98
Physics,Special Education Teacher,2.9036245966265795,3,0,0,0,9,0,4,1,4,1,3,1,1,1,Science,Bachelors,25-30,1,0,0,Hybrid,Tier1_City,3,2,5,2,1,1,4,45.83,Healthcare,4,2,4,1,5,1,5,2,3,5,1,0,1,2,50.24
Business,Cybersecurity Analyst,4.996319123572646,1,0,1,1,3,0,4,0,0,4,0,0,1,1,Commerce,Masters,18-24,3,1,19,Hybrid,Tier3_City,1,4,5,2,5,1,5,35.73,Other,3,1,3,5,5,0,4,1,1,1,0,1,3,5,42.07
Medicine,Physicist,4.040635819668776,9,2,0,1,6,0,1,4,4,3,0,0,3,1,Science,Bachelors,18-24,13,0,0,Hybrid,Tier1_City,1,2,5,1,5,2,5,36.67,Healthcare,1,4,5,1,3,4,2,2,3,2,1,1,1,5,54.01
Business,Teacher,4.589660869051876,1,0,2,0,8,1,3,1,1,4,3,2,1,0,Commerce,Masters,18-24,11,0,0,Hybrid,Tier2_City,3,3,2,4,3,4,4,17.29,Manufacturing,3,2,1,3,2,3,3,4,4,1,1,0,2,1,64.85
Law,Accountant,4.587296104797043,4,0,2,1,1,1,3,1,3,1,3,1,1,1,Arts,Masters,25-30,1,0,0,Flexible,Any,3,2,2,1,5,0,5,36.65,Education,4,1,1,3,0,4,5,1,3,4,1,0,1,5,53.72
Biology,Acoustics Specialist,4.693269424705855,5,1,0,0,2,1,2,1,0,1,3,2,0,0,Science,High School,25-30,4,0,0,Remote,Tier1_City,2,4,4,3,5,1,5,36.36,Healthcare,5,2,1,4,2,5,4,2,5,4,0,0,3,4,47.67
Engineering,Art Therapist,4.095901302688066,0,0,1,1,4,1,2,3,0,4,4,3,4,1,Science,Masters,36-40,5,0,0,Hybrid,Tier1_City,2,3,3,5,2,4,3,30.95,Manufacturing,1,3,2,2,2,3,4,4,5,3,1,0,4,3,59.14
Physics,Biochemist,3.1572944393551947,8,2,2,0,7,1,4,1,2,4,1,3,0,0,Science,Bachelors,18-24,10,0,0,Hybrid,Tier2_City,2,3,5,5,2,5,5,19.79,Tech,4,3,4,4,4,3,1,4,2,2,1,0,3,3,60.32
Education,Ecologist,3.324626398208133,5,0,1,0,4,0,2,2,2,0,4,4,3,1,Arts,PhD,25-30,0,1,22,Remote,Tier1_City,1,5,2,2,0,0,1,41.12,Healthcare,4,1,1,5,3,1,4,5,1,5,1,1,4,3,51.68
Art,Astronomer,4.928451890279519,9,0,2,1,7,0,3,4,2,4,1,4,1,1,Arts,Bachelors,18-24,14,0,0,Flexible,Tier1_City,5,1,1,5,0,2,3,47.06,Healthcare,3,2,2,3,1,4,1,3,3,3,0,1,5,4,62.87
Law,Musician,2.547565098271048,5,0,0,0,3,0,4,3,2,1,0,0,2,1,Arts,PhD,25-30,11,0,0,Remote,Tier2_City,4,1,4,5,5,3,1,43.88,Tech,2,2,5,4,1,0,4,5,5,1,0,0,3,4,65.8
Engineering,Social Media Manager,3.0744837448745583,2,1,1,1,8,1,2,3,0,3,1,3,3,0,Science,Masters,18-24,7,0,0,Remote,Tier2_City,5,1,0,5,5,0,1,14.42,Other,4,5,5,1,1,0,5,5,3,5,0,0,3,2,60.09
Chemistry,Composer,4.017223376667922,2,2,0,0,2,1,2,1,1,4,2,2,2,1,Science,Bachelors,40+,1,0,0,Office,Tier2_City,3,4,1,3,1,5,4,23.95,Other,2,2,2,2,2,3,3,2,2,5,1,0,1,5,44.33
Marketing,Astronomer,4.328533819509249,2,0,4,1,7,1,0,4,4,2,0,0,3,1,Commerce,Bachelors,31-35,13,0,0,Remote,Tier2_City,1,2,4,5,0,0,5,19.09,Other,1,4,4,3,1,3,2,4,1,1,1,1,1,3,45.24
Law,Investment Banker,4.946000654779362,9,1,2,1,8,1,1,0,1,3,4,2,3,0,Arts,PhD,25-30,4,1,47,Office,Any,1,1,5,5,3,0,5,36.25,Finance,5,3,5,2,4,3,4,3,2,2,0,1,2,1,53.07
Medicine,Zoologist,4.757438667960246,9,2,1,1,3,0,3,0,2,4,2,1,1,1,Science,Masters,18-24,10,0,0,Office,Any,4,2,1,5,5,3,5,42.08,Education,2,2,4,2,2,4,4,4,3,3,1,1,1,4,64.38
Finance,Electrical Engineer,4.51614583280336,5,0,2,0,1,1,0,4,1,3,1,1,4,1,Commerce,Bachelors,25-30,7,0,0,Remote,Tier3_City,5,1,5,1,3,1,5,13.14,Tech,2,4,2,3,0,4,1,1,3,2,0,1,3,1,46.22
Engineering,Brand Manager,3.609470799073448,5,2,4,0,7,1,4,4,0,0,1,1,4,1,Science,Masters,31-35,4,0,0,Remote,Tier1_City,3,5,1,3,5,5,3,47.52,Other,2,1,5,1,0,2,3,2,2,1,1,0,1,4,44.73
Engineering,Physicist,4.769585550978272,2,1,0,1,7,1,1,4,2,0,2,0,4,0,Science,Bachelors,18-24,2,0,0,Remote,Tier1_City,4,2,1,2,3,3,2,34.83,Tech,2,3,5,1,2,0,5,5,4,5,1,1,5,1,46.33
Computer Science,Social Media Manager,3.1363828074577627,6,0,0,1,3,1,1,4,0,1,3,3,3,0,Science,High School,25-30,5,0,0,Remote,Any,1,4,2,1,4,0,1,13.27,Tech,2,1,3,1,5,3,5,3,2,3,1,1,1,5,43.13
Law,Biologist,4.21934742871062,2,1,0,0,0,0,0,2,1,3,3,2,2,0,Arts,Bachelors,36-40,0,0,0,Remote,Tier2_City,4,4,2,4,3,5,2,20.44,Finance,1,2,5,2,3,4,3,3,5,1,0,0,4,3,36.97
Engineering,Human Resources Specialist,2.5935969868541005,5,1,1,1,6,1,3,3,0,0,2,0,3,0,Science,Bachelors,31-35,0,1,43,Flexible,Any,2,2,3,3,0,2,2,7.92,Tech,4,1,1,1,3,2,5,3,4,2,0,0,1,5,34.43
Physics,AI Researcher,2.94558622361683,5,2,4,0,1,0,2,0,2,4,2,4,0,1,Science,Masters,36-40,7,0,0,Office,Tier2_City,5,4,0,3,5,0,2,31.06,Finance,5,3,3,5,0,3,2,1,4,1,1,0,3,1,64.35
Physics,Urban Planner,4.381353266144491,9,0,0,0,1,1,0,2,3,0,4,0,4,0,Science,Bachelors,36-40,6,0,0,Remote,Any,3,3,0,4,0,2,3,10.95,Education,4,1,2,5,1,0,5,5,3,1,0,1,5,4,42.32
Music,Urban Planner,4.465426934073514,3,0,4,1,5,0,0,0,0,4,4,1,3,1,Arts,Masters,36-40,9,0,0,Flexible,Tier1_City,2,4,2,4,3,4,2,35.58,Finance,1,1,1,1,4,5,2,3,2,3,0,1,1,4,49.07
Education,Web Developer,3.2900890242393306,8,0,1,0,9,0,2,1,3,4,2,4,3,1,Arts,High School,25-30,9,1,12,Remote,Tier2_City,5,5,1,4,2,2,3,37.65,Education,1,1,1,1,2,4,4,4,2,5,1,1,5,1,55.24
Education,Chemist,3.4125260048750645,1,2,2,1,9,1,2,4,1,0,3,4,1,1,Arts,Bachelors,25-30,10,1,42,Office,Tier3_City,2,5,1,2,2,0,4,25.53,Education,2,4,4,3,4,3,5,3,5,5,0,1,4,4,70.48
Computer Science,Curriculum Developer,2.949390120937499,9,1,0,0,8,1,0,2,2,1,3,3,3,1,Science,Bachelors,31-35,10,0,0,Remote,Any,4,2,5,5,2,3,4,7.41,Education,1,4,3,3,4,1,5,3,3,4,1,0,3,4,58.17
Architecture,Special Education Teacher,3.1665338167075765,2,1,3,0,7,0,2,4,4,4,0,1,2,1,Interdisciplinary,Bachelors,31-35,2,1,43,Remote,Tier2_City,3,4,4,3,5,0,4,31.71,Manufacturing,1,2,4,4,5,1,2,3,5,4,0,1,5,3,58.0
Chemistry,Art Therapist,3.1932766612621446,3,0,1,0,6,1,1,1,2,0,2,3,2,1,Science,Bachelors,40+,7,0,0,Office,Tier1_City,4,2,5,5,1,0,3,20.49,Education,2,1,3,2,4,0,4,1,4,5,0,0,5,3,50.96
Education,School Counselor,4.475686171488989,7,0,0,1,1,0,2,0,4,1,3,3,2,1,Arts,Bachelors,18-24,10,0,0,Hybrid,Any,4,1,5,5,4,4,3,47.63,Finance,1,4,3,2,2,2,4,5,3,5,1,1,1,5,67.43
Marketing,Zoologist,3.608637281138001,5,1,1,0,4,1,0,3,4,1,2,3,1,0,Commerce,Masters,25-30,14,1,45,Hybrid,Tier2_City,5,3,4,4,3,1,1,27.12,Manufacturing,1,3,1,3,1,2,1,4,3,1,0,0,5,2,57.13
Medicine,Pharmacist,4.811073647498056,3,2,1,0,1,1,4,3,1,2,3,1,2,0,Science,Bachelors,25-30,7,1,34,Hybrid,Tier1_City,3,2,4,2,1,0,2,6.4,Tech,1,3,5,5,5,5,4,2,3,4,1,1,4,4,56.98
Art,Mechanical Engineer,4.380067670132482,0,1,1,0,2,0,2,0,2,1,4,0,2,0,Arts,Bachelors,25-30,13,1,44,Remote,Tier2_City,3,2,5,1,2,4,5,32.89,Tech,3,1,4,4,2,1,3,3,2,4,1,0,3,2,54.69
Biology,Ecologist,3.8022381598420143,7,0,2,1,3,0,0,4,2,1,2,2,2,0,Science,Bachelors,18-24,13,1,22,Office,Tier2_City,4,2,0,2,3,3,5,39.63,Healthcare,4,2,4,3,5,5,1,5,3,3,0,0,4,4,55.13
Medicine,AI Researcher,3.007312235797988,7,2,3,0,3,0,4,3,2,4,1,0,4,1,Science,Masters,31-35,0,1,56,Office,Tier2_City,3,2,0,5,1,4,2,10.54,Education,3,4,1,4,0,0,4,1,5,4,0,0,1,2,52.66
Chemistry,Entrepreneur,4.723928057774975,3,1,0,1,4,1,0,1,1,0,3,3,4,1,Science,PhD,18-24,9,0,0,Remote,Any,1,5,4,2,0,4,5,24.11,Healthcare,4,4,5,2,1,1,2,4,5,5,0,1,4,3,63.52
Finance,Forensic Psychologist,3.095225235115503,9,2,3,0,9,1,4,2,3,0,1,1,0,1,Commerce,Bachelors,31-35,6,0,0,Hybrid,Tier2_City,3,3,4,4,2,2,5,37.93,Education,2,4,3,2,0,3,3,5,5,1,0,0,3,1,52.46
Medicine,Organic Chemist,4.6867175240500245,7,1,1,0,9,0,4,3,3,3,0,3,1,1,Science,Bachelors,31-35,1,0,0,Hybrid,Tier2_City,4,1,4,1,1,1,5,3.96,Education,2,2,3,2,4,4,1,3,4,4,0,1,1,5,49.37
Marketing,Ecologist,2.9438415734234544,4,1,1,0,1,1,2,3,3,2,2,2,1,1,Commerce,Bachelors,25-30,11,1,30,Hybrid,Tier1_City,1,3,0,4,5,1,3,4.36,Other,4,5,5,5,1,2,5,5,4,3,0,1,3,5,67.53
Art,Manager,3.9160673963891934,9,2,4,0,6,1,4,0,4,4,4,1,1,1,Arts,PhD,25-30,1,0,0,Hybrid,Tier2_City,1,2,2,1,0,5,3,34.81,Finance,4,4,3,3,4,4,2,1,4,3,0,0,5,3,58.15
Music,Game Developer,3.6870444981969177,8,0,0,1,8,1,4,4,2,0,4,0,3,0,Arts,Bachelors,31-35,1,0,0,Office,Tier1_City,5,5,5,5,2,3,3,37.08,Finance,5,1,4,4,0,0,3,2,2,3,1,0,5,5,46.62
Architecture,Physicist,3.0095109031999425,2,1,4,1,7,0,2,4,2,0,4,0,0,1,Interdisciplinary,Bachelors,31-35,12,1,42,Flexible,Tier1_City,4,1,5,1,4,5,2,42.76,Tech,4,4,4,3,5,5,2,1,3,2,1,1,1,3,59.66
Psychology,Education Administrator,3.796603295586592,1,2,1,1,5,0,0,2,4,0,4,0,4,1,Arts,Bachelors,36-40,4,1,24,Hybrid,Tier1_City,3,2,5,1,2,4,4,21.78,Manufacturing,4,4,4,2,2,0,1,2,2,1,0,0,3,1,39.27
Medicine,Analytical Chemist,2.99042592151177,8,1,1,1,3,1,3,2,1,2,1,3,0,1,Science,Bachelors,36-40,6,0,0,Hybrid,Tier1_City,1,2,5,1,5,3,5,21.32,Tech,2,5,1,2,5,1,3,3,4,3,1,0,1,5,56.57
Art,Web Developer,2.5802454799178904,7,2,0,0,9,1,1,1,4,4,0,3,0,0,Arts,Bachelors,40+,3,0,0,Office,Tier1_City,4,4,1,2,4,3,1,28.96,Education,2,1,3,3,5,0,1,4,2,5,1,0,3,4,51.77
Physics,Mechanical Engineer,4.192292466411468,9,2,0,0,7,1,3,2,4,4,1,0,1,0,Science,Masters,25-30,10,0,0,Hybrid,Tier2_City,5,3,5,2,4,1,3,38.59,Other,1,1,1,1,1,4,1,1,3,5,1,0,5,5,70.98
Engineering,Financial Analyst,3.138699356747288,8,2,2,0,1,1,0,4,0,1,2,2,4,1,Science,Bachelors,36-40,11,0,0,Hybrid,Tier1_City,2,3,5,5,4,1,1,33.13,Manufacturing,1,1,3,1,4,2,4,4,5,5,0,1,1,2,59.79
Engineering,Zoologist,3.893102520233232,0,0,3,0,6,1,2,2,3,1,1,1,2,0,Science,Masters,36-40,3,0,0,Hybrid,Tier1_City,2,3,2,1,3,1,5,18.38,Healthcare,2,4,4,3,3,1,2,1,5,4,1,1,4,5,56.17
Psychology,Lawyer,4.847733023436303,4,2,2,0,1,0,4,4,3,2,1,3,2,0,Arts,Bachelors,36-40,8,1,17,Office,Any,3,4,0,3,3,0,4,19.29,Education,1,4,4,2,4,0,4,4,4,5,0,0,5,2,65.37
Architecture,Software Developer,4.358072256935617,7,1,0,1,4,0,2,4,3,0,3,2,2,0,Interdisciplinary,Bachelors,18-24,13,0,0,Hybrid,Tier2_City,2,5,0,5,4,4,1,38.86,Finance,3,3,5,4,0,3,4,2,2,1,0,1,4,4,55.67
Architecture,Dentist,4.181732611268475,9,1,4,1,2,0,0,3,3,4,1,2,4,1,Interdisciplinary,PhD,40+,9,0,0,Remote,Tier2_City,1,5,4,1,0,3,5,28.13,Tech,3,5,3,1,0,0,2,5,5,5,1,1,2,2,66.56
Medicine,Biochemist,3.434963196208907,4,0,2,0,8,1,1,4,0,4,0,4,4,0,Science,Bachelors,25-30,8,0,0,Hybrid,Tier1_City,1,5,2,1,4,4,5,7.6,Tech,1,1,2,3,5,2,3,5,2,4,0,1,1,4,53.49
Computer Science,Biomedical Engineer,3.258756030766617,9,1,4,0,3,1,1,1,4,1,3,2,2,0,Science,Masters,31-35,6,0,0,Flexible,Tier2_City,4,1,0,2,1,3,3,10.19,Healthcare,1,1,1,5,5,1,2,2,5,5,1,1,3,1,61.67
Music,Graphic Designer,2.5520166944475915,8,1,1,0,1,1,4,2,2,2,0,4,3,0,Arts,Bachelors,18-24,13,0,0,Flexible,Tier2_City,3,4,3,5,4,3,4,43.01,Tech,4,3,4,3,2,2,5,2,2,2,0,0,5,5,55.8
Education,Acoustics Specialist,4.182039853314449,7,0,1,1,2,0,1,4,0,4,2,1,4,1,Arts,Bachelors,25-30,14,1,28,Office,Tier2_City,4,4,2,1,3,5,5,49.94,Tech,4,4,5,2,1,4,3,3,5,1,0,0,5,2,55.7
Finance,Organic Chemist,2.7096481438324584,4,0,1,1,8,1,2,4,2,0,0,4,0,0,Commerce,PhD,25-30,9,1,57,Office,Tier1_City,4,5,2,1,3,3,4,18.78,Manufacturing,3,3,5,3,3,4,4,1,2,3,1,1,5,1,62.18
Medicine,Art Therapist,4.355762068586434,8,2,3,1,5,1,4,0,4,3,1,2,3,1,Science,Bachelors,25-30,14,0,0,Remote,Tier3_City,3,5,0,5,1,3,3,21.17,Education,3,3,4,1,0,0,1,4,1,5,1,1,1,1,58.08
Architecture,Legal Analyst,4.514888580790476,4,1,3,1,7,1,0,1,2,1,1,1,1,1,Interdisciplinary,Masters,18-24,3,1,20,Hybrid,Any,4,5,1,3,1,2,1,10.26,Manufacturing,4,4,3,1,1,3,1,2,3,4,0,0,4,2,38.64
Architecture,Legal Analyst,4.384219984452782,5,0,0,0,9,0,2,4,0,2,1,3,4,0,Interdisciplinary,Bachelors,36-40,7,0,0,Remote,Any,2,4,0,5,2,2,2,14.08,Manufacturing,4,2,5,3,3,3,4,4,2,1,1,1,3,5,43.03
Psychology,Conductor,2.658045649269772,6,2,3,1,8,1,0,1,2,3,3,4,0,0,Arts,Masters,18-24,9,0,0,Office,Tier1_City,5,5,2,5,0,5,2,22.96,Tech,4,5,3,4,2,1,3,1,2,5,0,0,3,3,63.05
Art,Industrial-Organizational Psychologist,3.045013588257845,3,2,4,0,2,1,3,2,2,3,3,0,2,1,Arts,High School,25-30,2,0,0,Remote,Tier2_City,4,3,3,3,0,0,2,16.37,Education,1,2,5,3,1,0,5,4,4,2,1,0,3,1,43.0
Music,Digital Marketing Specialist,3.248899755346596,3,1,1,1,5,0,3,0,0,1,4,1,4,1,Arts,Bachelors,18-24,2,0,0,Office,Tier1_City,1,5,2,5,0,1,4,35.97,Tech,2,2,1,4,4,2,3,5,2,3,1,0,2,1,37.12
Law,Biomedical Engineer,4.364349437105345,7,0,0,0,7,1,0,0,0,1,4,0,2,0,Arts,Masters,25-30,11,0,0,Office,Tier2_City,1,3,0,1,5,3,2,28.28,Other,3,5,3,1,5,0,2,3,2,4,1,0,3,2,52.29
Biology,School Psychologist,4.420675706748641,8,0,0,0,5,0,0,0,2,2,2,1,3,1,Science,PhD,25-30,6,0,0,Flexible,Tier2_City,2,2,5,5,3,4,1,41.65,Other,5,2,5,5,5,3,5,1,4,5,0,1,1,4,61.46
Engineering,Acoustics Specialist,4.799340211612873,0,1,0,1,2,0,0,2,3,0,1,4,1,1,Science,PhD,25-30,12,0,0,Office,Tier2_City,4,2,4,3,0,2,5,37.05,Tech,4,4,4,4,3,2,2,1,1,5,1,1,2,4,61.33
Chemistry,Doctor,3.421671011190816,9,1,4,0,4,0,1,4,0,4,3,3,2,0,Science,Masters,25-30,10,0,0,Hybrid,Tier2_City,4,4,1,4,2,1,4,9.02,Manufacturing,1,2,2,3,4,5,3,3,2,2,1,0,4,3,59.4
Education,Market Research Analyst,3.0111774179376214,9,1,3,1,4,0,2,0,1,1,4,1,3,1,Arts,Masters,31-35,11,0,0,Hybrid,Tier3_City,3,1,2,5,2,0,1,8.8,Other,3,2,4,2,5,2,4,1,4,4,1,0,5,3,60.3
Law,Geneticist,3.623076140873025,7,0,0,1,3,0,0,1,3,4,2,2,3,1,Arts,Bachelors,18-24,8,0,0,Hybrid,Tier3_City,4,2,3,2,0,1,4,45.1,Finance,4,2,3,2,4,5,4,3,3,1,0,0,4,5,46.48
Education,Game Developer,3.7044171160731096,1,1,0,1,2,0,3,1,3,3,1,0,3,0,Arts,Bachelors,18-24,12,0,0,Remote,Tier1_City,4,4,3,1,1,3,4,41.52,Other,1,4,4,3,5,3,2,2,5,4,0,1,2,3,61.56
Psychology,Inorganic Chemist,3.398639097010835,6,1,4,1,6,0,1,3,3,4,2,2,1,1,Arts,Bachelors,18-24,10,0,0,Remote,Tier3_City,1,4,3,1,2,1,4,24.99,Finance,3,3,4,1,3,5,5,2,3,3,1,0,2,4,58.55
Art,Inorganic Chemist,3.047195456168037,0,1,0,0,5,1,0,2,2,0,4,3,0,0,Arts,Bachelors,40+,3,0,0,Remote,Tier3_City,3,3,1,2,1,3,3,9.13,Manufacturing,3,1,2,1,4,1,2,4,1,2,1,0,5,4,36.15
Biology,Graphic Designer,4.958107163843589,7,1,0,0,3,0,2,4,1,1,3,4,1,0,Science,Bachelors,25-30,3,1,42,Flexible,Tier1_City,4,3,5,2,3,5,5,45.23,Manufacturing,5,5,4,1,3,0,5,5,3,3,1,1,4,5,51.17
Art,Game Developer,3.421604509245557,2,1,4,1,4,0,4,4,3,3,4,0,4,1,Arts,Bachelors,25-30,0,0,0,Remote,Tier1_City,2,5,2,5,5,2,2,13.84,Tech,5,5,5,3,4,5,1,5,5,5,0,1,2,2,60.82
Business,Market Research Analyst,2.852955489421442,2,2,0,1,4,1,2,3,1,3,4,3,1,0,Commerce,Bachelors,18-24,0,0,0,Office,Tier3_City,4,2,4,2,2,2,3,4.67,Education,3,4,1,2,2,3,3,1,1,2,0,1,4,1,40.19
Marketing,Legal Analyst,4.550546248861483,3,1,1,1,0,0,1,1,4,1,2,1,1,1,Commerce,Masters,25-30,12,0,0,Remote,Tier2_City,3,3,0,4,1,3,5,46.44,Other,1,1,2,5,2,0,4,1,3,4,0,1,1,2,62.8
Computer Science,Accountant,3.2354152963597644,6,0,4,1,9,0,2,4,3,0,0,4,1,0,Science,Bachelors,18-24,13,0,0,Flexible,Tier2_City,2,1,5,3,0,4,2,41.02,Tech,4,2,3,2,1,0,4,4,3,2,0,1,4,5,53.12
Marketing,Quantum Physicist,3.0071736994619025,0,2,1,0,7,0,4,1,3,0,1,1,2,1,Commerce,Bachelors,18-24,2,1,22,Hybrid,Tier2_City,2,4,2,2,3,2,3,35.59,Tech,4,5,5,1,4,1,5,5,2,1,1,1,1,2,35.12
Finance,Legal Secretary,3.5208002211110783,1,0,3,1,0,1,1,1,4,4,1,4,0,1,Commerce,Bachelors,25-30,11,0,0,Hybrid,Any,2,5,2,2,4,4,3,4.6,Healthcare,3,2,3,3,2,2,1,2,1,4,1,0,2,4,58.35
Law,Construction Manager,3.309228441352244,1,1,0,0,8,1,4,2,3,4,1,2,3,1,Arts,Masters,25-30,12,0,0,Hybrid,Any,1,3,4,4,4,3,1,27.84,Tech,4,4,2,3,2,3,4,2,3,4,1,1,4,5,71.58
Business,Biologist,3.573058524694703,2,0,4,1,7,1,2,4,2,0,0,4,1,1,Commerce,Masters,18-24,6,1,47,Office,Tier1_City,1,3,1,1,0,5,3,33.72,Education,5,4,2,5,2,2,2,3,5,3,0,1,4,5,59.18
Computer Science,Accountant,3.198987256308981,9,0,2,0,3,1,3,1,2,1,1,4,1,0,Science,Masters,31-35,12,0,0,Remote,Tier1_City,2,3,0,1,3,3,4,38.69,Tech,4,4,4,2,0,4,2,2,3,1,0,0,2,3,54.13
Computer Science,Lawyer,3.384124871500285,0,1,2,0,6,0,1,2,4,4,0,2,2,1,Science,Bachelors,40+,14,0,0,Office,Tier2_City,1,2,0,5,3,5,3,25.14,Manufacturing,2,3,2,1,4,5,4,5,2,1,0,1,1,2,52.17
Music,Counselor,3.560052015103816,2,0,4,1,2,1,2,0,1,3,3,0,2,1,Arts,Bachelors,25-30,8,1,56,Office,Tier1_City,2,3,0,4,3,2,4,47.81,Education,5,4,3,5,1,3,5,3,5,1,0,1,1,4,55.19
Music,Landscape Architect,3.8161919359196017,5,1,4,1,0,0,3,3,4,0,4,2,0,0,Arts,Bachelors,31-35,3,1,17,Remote,Tier2_City,2,4,5,3,3,4,5,14.5,Other,5,2,2,1,2,0,3,1,4,3,0,0,3,1,56.95
Medicine,School Counselor,4.35300796606308,5,2,1,0,6,0,2,4,3,3,0,0,0,0,Science,Bachelors,40+,1,0,0,Remote,Tier3_City,5,3,2,3,4,3,5,6.28,Manufacturing,3,3,1,2,3,3,1,4,2,2,0,0,4,4,43.0
Education,Quantum Physicist,3.5686060248902,4,0,1,1,1,0,4,2,2,2,3,0,3,0,Arts,Bachelors,36-40,5,0,0,Office,Tier3_City,1,1,4,4,1,2,4,18.64,Healthcare,3,2,4,5,0,2,3,5,3,5,1,0,2,1,57.53
Music,Legal Secretary,3.855579049511261,6,0,3,0,3,0,1,1,1,0,4,1,3,1,Arts,High School,25-30,5,1,44,Remote,Any,5,3,4,3,3,5,1,34.1,Healthcare,4,4,2,1,4,4,1,2,2,2,1,1,2,3,38.65
Psychology,Aerospace Engineer,4.046469287495525,4,1,3,0,9,0,3,1,4,1,4,2,1,0,Arts,Bachelors,31-35,8,0,0,Flexible,Tier1_City,2,5,1,1,1,3,1,37.65,Education,4,3,1,4,5,1,4,3,2,2,0,1,2,2,56.13
Education,Art Therapist,3.4580917830633515,7,0,1,1,3,1,4,4,4,2,3,0,1,0,Arts,PhD,18-24,14,0,0,Remote,Tier3_City,2,5,4,3,3,5,5,37.71,Other,3,1,3,3,1,3,5,2,5,4,0,1,4,4,80.88
Engineering,Advertising Manager,4.048454688916041,3,1,3,0,9,1,2,4,2,1,2,2,3,0,Science,PhD,25-30,3,0,0,Hybrid,Tier2_City,5,1,4,3,2,1,3,8.2,Finance,1,4,3,2,2,5,2,1,1,2,0,0,5,1,49.38
Biology,Digital Marketing Specialist,4.63885156998084,6,2,1,1,6,0,0,2,1,3,0,4,1,1,Science,Bachelors,25-30,7,0,0,Office,Tier1_City,3,5,0,4,5,5,5,44.6,Finance,4,3,1,3,3,1,2,2,4,4,0,1,2,3,56.34
Law,Chemical Engineer,3.6228341721742288,1,1,2,0,4,1,0,3,0,1,2,2,0,1,Arts,High School,18-24,12,0,0,Office,Tier2_City,2,2,1,4,2,1,5,16.2,Education,1,3,1,1,0,4,2,2,4,3,1,0,2,4,48.21
Education,Counselor,3.7988340410715273,8,0,1,0,6,0,4,2,2,4,4,3,1,1,Arts,Bachelors,25-30,13,0,0,Hybrid,Tier3_City,1,4,4,3,5,2,4,12.87,Education,5,3,2,5,3,5,5,4,1,5,0,0,5,1,72.8
Biology,Market Research Analyst,2.852429858196553,5,1,3,1,7,0,3,4,4,3,1,0,2,0,Science,Bachelors,18-24,12,1,57,Flexible,Tier2_City,4,4,4,2,2,3,1,31.88,Manufacturing,2,5,4,1,3,2,3,2,2,1,0,1,2,2,55.2
Art,School Counselor,3.1304151494586883,3,1,3,0,0,1,1,3,2,1,4,2,3,1,Arts,PhD,31-35,2,0,0,Office,Any,4,2,4,4,3,2,4,12.96,Healthcare,1,3,4,4,0,4,4,4,4,2,1,0,4,1,54.69
Law,Illustrator,3.328914815675177,6,2,1,0,7,1,4,3,1,4,2,4,2,1,Arts,Bachelors,25-30,1,0,0,Hybrid,Tier2_City,4,5,4,5,1,0,5,26.88,Education,4,1,5,4,3,3,5,3,5,2,0,0,5,4,53.51
Medicine,Credit Analyst,3.1619473419166746,7,2,2,1,5,0,2,1,1,0,3,0,3,1,Science,Masters,25-30,8,0,0,Hybrid,Tier2_City,5,1,0,5,5,5,2,22.13,Tech,3,4,1,2,2,0,4,1,3,4,0,1,3,4,53.56
Education,Microbiologist,4.303533775892004,9,1,3,0,5,0,1,2,0,0,2,2,2,1,Arts,Bachelors,18-24,14,1,9,Hybrid,Tier1_City,2,1,2,1,4,2,3,13.91,Manufacturing,3,4,3,3,0,2,4,4,5,1,0,1,5,5,51.07
Biology,Ecologist,2.7904413922508366,1,2,0,1,4,1,1,3,2,2,4,3,2,1,Science,PhD,18-24,5,0,0,Flexible,Tier1_City,3,4,5,3,0,2,5,16.73,Healthcare,2,4,5,1,4,5,3,2,5,1,1,0,1,1,56.5
Law,Special Education Teacher,4.238893036243992,3,1,4,0,4,1,2,3,3,3,4,2,1,1,Arts,Bachelors,25-30,10,0,0,Flexible,Tier2_City,1,1,1,2,5,1,4,23.09,Manufacturing,2,3,1,4,0,5,2,3,3,2,0,1,3,4,63.66
Biology,Civil Engineer,2.5399903267953503,6,1,0,0,0,0,3,4,1,3,3,2,0,0,Science,Masters,40+,7,0,0,Remote,Tier2_City,4,2,2,1,5,5,2,19.27,Healthcare,5,4,1,5,5,3,1,4,3,3,0,1,2,4,65.35
Business,Dentist,2.9416011041809416,7,0,0,1,3,1,0,3,1,4,0,0,0,1,Commerce,Bachelors,18-24,10,0,0,Remote,Tier2_City,4,4,5,3,4,1,2,20.93,Tech,1,1,5,1,1,2,5,4,5,5,0,0,2,3,59.14
Medicine,Teacher,4.940371602913068,1,2,1,1,3,1,1,1,3,3,1,2,1,0,Science,Masters,25-30,9,1,23,Flexible,Tier2_City,1,3,0,4,3,3,5,37.57,Healthcare,2,5,4,2,5,2,5,3,4,1,1,0,4,2,55.3
Computer Science,Doctor,3.291704858666088,1,2,2,1,8,1,2,2,2,0,0,3,3,0,Science,Bachelors,36-40,8,0,0,Remote,Tier3_City,4,2,2,5,2,2,1,10.91,Manufacturing,5,1,1,5,5,3,5,1,4,3,0,0,2,4,55.96
Marketing,Industrial-Organizational Psychologist,4.820094943615393,7,2,2,1,8,0,1,1,3,2,2,1,2,0,Commerce,Bachelors,18-24,0,0,0,Flexible,Tier1_City,5,2,5,2,2,5,2,32.5,Healthcare,5,5,5,3,2,5,4,3,5,2,0,1,1,4,40.93
Biology,Art Therapist,3.55080291590868,3,2,0,1,8,0,0,3,1,1,4,0,3,1,Science,PhD,36-40,12,1,6,Hybrid,Tier2_City,2,1,4,5,1,2,3,34.87,Manufacturing,5,4,2,2,4,0,3,1,3,1,1,0,3,1,54.09
Marketing,Human Resources Specialist,3.177701784159092,1,0,4,0,5,0,2,0,2,3,0,4,3,1,Commerce,PhD,25-30,0,0,0,Remote,Tier2_City,2,1,1,4,3,3,4,40.7,Education,4,2,2,3,5,0,5,1,5,1,0,0,4,1,50.08
Marketing,Lawyer,4.191490181039655,8,1,0,0,3,1,4,3,2,4,4,4,0,1,Commerce,Masters,25-30,10,0,0,Hybrid,Tier1_City,3,1,4,3,4,4,4,42.82,Tech,2,5,3,3,2,5,4,2,2,3,0,1,1,4,71.18
Law,Data Scientist,3.821968986961247,8,1,0,1,3,1,1,3,3,4,3,3,2,1,Arts,Masters,25-30,4,0,0,Hybrid,Any,5,3,1,4,3,3,4,10.46,Manufacturing,3,1,4,4,2,3,3,4,2,1,1,1,3,5,56.96
Psychology,Legal Consultant,4.466914959242764,9,0,3,0,8,1,0,1,1,0,2,3,0,1,Arts,Masters,25-30,8,0,0,Office,Tier3_City,3,2,2,4,3,1,5,9.5,Finance,5,1,5,3,0,2,1,3,2,3,1,1,4,2,49.22
Art,Chemist,3.333758509556588,9,1,4,1,1,0,1,1,1,1,2,2,2,1,Arts,Bachelors,25-30,6,0,0,Hybrid,Tier1_City,4,5,4,5,2,1,4,31.89,Finance,3,2,4,5,5,5,3,1,2,3,1,0,5,1,46.59
Biology,Data Scientist,4.979475684714653,8,0,2,0,8,1,4,1,3,3,0,2,0,0,Science,Bachelors,36-40,6,0,0,Hybrid,Any,2,4,0,2,4,2,4,38.58,Other,4,5,4,5,4,5,2,3,3,3,1,0,2,4,57.91
Engineering,Electrical Engineer,3.7678799521430575,9,1,3,1,7,1,3,2,1,0,2,2,0,0,Science,Bachelors,31-35,1,0,0,Flexible,Any,3,1,4,4,0,1,3,15.8,Other,1,5,5,5,0,2,1,4,2,2,0,0,2,4,35.84
Art,Entrepreneur,3.38755532156533,0,0,1,0,7,1,0,0,1,1,4,0,1,0,Arts,Masters,31-35,2,0,0,Remote,Tier3_City,3,1,3,5,5,5,1,27.71,Healthcare,4,1,1,1,1,3,1,3,2,2,1,1,1,3,40.83
Psychology,Paralegal,4.522731014017449,7,1,0,1,6,0,0,2,2,0,1,4,3,1,Arts,Bachelors,31-35,3,0,0,Hybrid,Tier2_City,5,2,0,2,2,3,5,39.3,Education,4,5,2,4,1,3,1,5,3,5,1,1,2,5,43.73
Architecture,Financial Analyst,3.157548874797583,0,1,2,0,8,1,2,4,0,4,1,1,4,1,Interdisciplinary,Bachelors,25-30,1,1,15,Hybrid,Any,4,3,1,3,4,2,5,39.07,Education,2,2,3,4,1,4,4,3,1,2,0,1,4,2,41.83
Finance,Urban Planner,3.695244282107534,7,2,4,0,1,0,1,4,0,0,3,1,2,1,Commerce,Masters,31-35,9,1,11,Remote,Tier1_City,1,1,3,3,1,3,4,33.73,Finance,5,5,1,5,0,0,1,1,4,3,0,1,3,1,55.25
Business,Digital Marketing Specialist,4.8782926555645325,3,1,1,1,2,0,0,2,2,2,1,4,0,1,Commerce,Masters,25-30,8,0,0,Remote,Tier2_City,5,3,4,1,5,3,3,6.7,Healthcare,4,5,4,1,0,2,4,2,4,1,1,1,3,4,53.11
Architecture,Conductor,4.556228820852567,7,1,3,0,0,1,1,2,2,2,2,0,1,1,Interdisciplinary,Bachelors,31-35,4,1,9,Hybrid,Tier1_City,5,3,4,5,5,2,2,5.38,Education,5,2,4,3,1,2,2,5,2,5,0,1,3,4,51.24
Chemistry,Electrical Engineer,3.968524573906193,1,2,3,0,3,0,3,1,4,1,4,0,0,1,Science,Bachelors,25-30,12,0,0,Remote,Tier2_City,4,5,4,2,2,4,4,21.26,Education,3,4,5,3,0,2,1,2,2,5,1,1,3,2,60.62
Marketing,Credit Analyst,4.336482309268378,2,2,4,0,5,1,1,0,1,2,1,0,2,0,Commerce,Bachelors,31-35,6,0,0,Hybrid,Any,1,3,4,4,1,1,4,4.25,Healthcare,1,5,2,3,3,2,5,2,2,1,0,0,3,1,31.38
Marketing,Chemical Engineer,2.992451205405472,2,2,1,0,4,1,3,0,2,2,3,0,1,1,Commerce,Bachelors,36-40,10,0,0,Hybrid,Tier3_City,5,5,5,3,2,0,5,45.49,Manufacturing,1,1,2,4,3,3,4,4,1,2,0,0,2,4,51.68
Biology,Paralegal,3.7300638611327983,9,1,2,0,0,1,0,1,3,2,0,3,3,1,Science,Bachelors,25-30,8,0,0,Office,Tier3_City,3,4,3,2,3,0,5,3.95,Finance,3,3,3,3,3,0,4,2,5,5,1,0,3,4,56.73
Engineering,Analytical Chemist,3.4422963187950955,1,0,0,0,3,0,2,2,2,4,2,4,4,0,Science,Masters,18-24,4,0,0,Hybrid,Tier1_City,3,3,0,5,4,0,4,4.39,Other,2,1,1,1,2,5,3,2,1,1,0,0,1,2,48.14
Architecture,Psychologist,3.734387516172189,6,2,3,0,6,0,2,2,4,1,1,3,0,1,Interdisciplinary,Masters,25-30,14,0,0,Hybrid,Any,3,4,5,1,1,1,5,10.77,Education,3,1,3,1,4,5,1,3,3,2,1,1,2,2,57.11
Law,Illustrator,2.831578127156459,5,1,0,0,4,1,3,4,4,4,2,2,2,0,Arts,Masters,25-30,5,0,0,Remote,Tier1_City,3,3,3,3,5,4,3,32.47,Manufacturing,3,4,4,3,5,4,1,5,4,3,1,0,3,3,69.31
Education,Inorganic Chemist,3.315966414031691,6,2,3,0,0,1,1,0,1,3,3,2,0,1,Arts,Bachelors,31-35,3,0,0,Remote,Tier1_City,1,5,0,2,2,3,2,28.45,Manufacturing,2,4,4,4,4,3,3,5,2,4,0,1,4,5,45.99
Education,Financial Controller,3.170251000455554,6,2,3,0,5,0,1,3,0,3,1,1,4,0,Arts,Masters,40+,13,1,46,Hybrid,Tier2_City,4,5,2,2,5,2,2,34.0,Manufacturing,2,1,2,2,4,2,4,3,4,3,1,0,5,3,58.34
Architecture,Dentist,4.144198442757118,1,0,2,1,2,0,0,3,2,0,2,3,2,0,Interdisciplinary,Bachelors,25-30,7,0,0,Flexible,Tier1_City,4,4,2,2,1,4,2,45.0,Manufacturing,4,5,4,5,1,5,4,1,1,5,1,0,3,5,52.59
Marketing,Data Scientist,4.144980698650857,5,2,0,1,0,0,0,0,3,1,3,1,4,1,Commerce,Bachelors,25-30,0,0,0,Remote,Tier1_City,1,2,0,5,5,0,4,24.38,Tech,5,1,1,3,3,5,3,5,2,2,0,1,3,5,34.29
Art,Marketing Manager,4.104639300784097,7,0,0,0,7,0,4,4,3,0,0,2,0,1,Arts,Masters,31-35,0,1,27,Hybrid,Any,4,2,0,5,2,5,4,5.06,Tech,1,5,1,3,5,0,2,5,4,4,0,0,2,1,52.97
Chemistry,Counselor,3.2625677412696783,6,0,2,0,0,1,0,3,4,1,1,4,2,1,Science,Bachelors,18-24,4,0,0,Office,Tier2_City,3,2,0,5,2,1,4,38.88,Other,2,2,3,5,3,0,4,5,5,2,1,1,2,3,54.18
Art,Clinical Psychologist,4.538165118151939,4,2,2,0,6,0,4,2,4,0,0,3,0,0,Arts,Bachelors,25-30,9,0,0,Office,Any,1,3,2,4,0,1,3,41.16,Healthcare,2,2,1,2,0,1,1,4,3,5,1,1,5,1,58.72
Physics,Artist,4.649939558849141,4,2,3,0,7,1,0,2,0,4,0,3,1,0,Science,Masters,36-40,8,0,0,Flexible,Tier2_City,3,2,0,2,5,2,2,5.34,Finance,4,4,4,3,2,3,2,5,2,4,1,1,1,2,57.33
Marketing,Actuary,3.332779822501046,7,2,1,0,4,0,1,2,4,1,1,1,0,1,Commerce,Bachelors,31-35,1,1,10,Remote,Tier1_City,4,4,0,3,0,5,5,14.41,Healthcare,4,3,5,3,2,5,5,1,2,3,0,0,1,2,36.81
Music,Biologist,3.9102520685720457,1,1,4,0,6,1,3,3,1,0,1,3,3,1,Arts,Masters,18-24,10,1,26,Remote,Tier1_City,5,2,3,5,0,3,5,39.22,Tech,5,3,2,2,3,5,3,5,5,5,1,0,1,5,66.24
Engineering,Doctor,3.2915478947340984,6,0,3,1,9,1,1,4,0,4,3,1,1,0,Science,High School,18-24,14,0,0,Hybrid,Any,1,4,1,5,5,4,1,20.68,Healthcare,2,4,2,5,0,0,4,1,2,5,0,1,3,4,58.04
Biology,Chemist,2.5965536186728224,8,1,1,0,4,1,1,3,1,4,3,0,0,0,Science,Masters,31-35,2,0,0,Remote,Tier1_City,2,4,4,2,1,5,1,25.21,Healthcare,2,2,2,1,3,5,4,5,4,1,0,1,2,5,42.72
Engineering,Biomedical Engineer,3.210882968068544,2,2,1,0,4,1,3,0,4,3,3,3,2,0,Science,Bachelors,31-35,7,0,0,Hybrid,Tier2_City,2,3,4,5,3,4,5,41.69,Manufacturing,4,4,5,3,1,3,3,1,2,1,0,1,3,5,52.46
Computer Science,Judge,4.388289850881865,0,0,2,0,2,1,2,0,4,1,0,3,3,1,Science,Bachelors,36-40,4,0,0,Flexible,Tier1_City,3,5,5,4,2,4,2,7.45,Education,3,2,4,3,1,0,4,3,2,4,1,1,2,1,47.64
Music,Physical Chemist,4.931571765627327,8,0,4,0,0,0,4,2,4,2,4,4,2,0,Arts,Masters,25-30,2,1,21,Office,Tier2_City,4,3,3,4,4,3,4,34.83,Tech,5,5,1,4,4,0,4,5,5,3,0,1,5,5,67.82
Business,Sound Engineer,4.386505240065642,8,0,3,1,1,1,4,0,1,1,3,2,2,0,Commerce,Bachelors,36-40,5,0,0,Remote,Tier1_City,3,3,0,5,0,3,5,13.1,Tech,2,2,4,2,5,4,1,1,2,3,0,0,1,2,44.25
Architecture,Chemical Engineer,3.820547655637492,6,0,0,1,8,1,3,1,2,4,4,4,3,0,Interdisciplinary,Bachelors,25-30,5,0,0,Remote,Tier1_City,2,1,1,2,1,3,5,5.94,Healthcare,1,2,3,3,5,1,1,4,2,2,1,0,1,3,54.24
Physics,Urban Planner,4.691717491603836,6,0,1,1,6,1,2,1,1,4,4,4,4,0,Science,Bachelors,31-35,13,0,0,Flexible,Tier3_City,1,2,3,2,5,2,1,34.14,Education,1,2,4,4,5,5,4,4,2,1,0,1,2,5,59.85
Engineering,Acoustics Specialist,3.813824348697783,2,1,1,0,2,0,2,1,1,2,2,4,2,1,Science,Bachelors,25-30,4,0,0,Hybrid,Tier1_City,3,2,1,2,1,1,2,8.71,Healthcare,4,3,4,1,4,3,4,3,5,4,0,0,4,2,49.75
Medicine,Architect,2.7893558882909075,9,2,4,0,3,0,2,2,1,1,1,3,3,0,Science,Bachelors,18-24,4,1,34,Flexible,Tier2_City,4,4,2,1,1,0,5,38.11,Finance,1,2,2,2,3,2,4,2,5,1,1,1,2,5,41.69
Chemistry,Entrepreneur,2.9155612971760574,7,2,4,1,1,0,1,2,1,1,2,3,0,0,Science,Bachelors,40+,5,1,44,Office,Tier3_City,2,5,1,5,5,3,4,12.53,Tech,4,1,4,1,4,4,4,4,4,5,1,1,2,4,54.79
Music,Electrical Engineer,2.73827123841742,9,2,1,1,7,0,1,1,4,1,3,1,0,1,Arts,PhD,18-24,1,0,0,Flexible,Tier3_City,1,2,3,2,4,1,4,5.28,Manufacturing,3,5,5,4,3,2,2,5,5,3,0,1,4,2,60.5
Law,Art Therapist,2.817219423086699,1,1,1,0,9,1,1,2,2,4,2,4,0,1,Arts,High School,25-30,5,1,28,Flexible,Tier1_City,3,2,5,4,5,3,3,7.67,Manufacturing,4,3,2,5,2,4,1,3,5,4,1,1,2,5,59.04
Finance,Music Teacher,4.8586016411448885,2,1,2,1,9,0,2,2,2,4,3,3,2,1,Commerce,Bachelors,36-40,1,0,0,Hybrid,Tier3_City,1,5,4,3,4,0,4,42.54,Manufacturing,2,1,3,2,1,0,4,1,2,3,1,0,1,4,48.96
Marketing,Mechanical Engineer,2.86951861261158,5,2,1,0,2,0,3,3,0,4,0,3,0,1,Commerce,Bachelors,31-35,2,0,0,Office,Any,5,2,2,3,5,5,5,20.44,Other,1,3,5,5,0,1,4,1,4,5,1,1,3,1,58.27
Psychology,Aerospace Engineer,2.5404550932082537,5,1,2,1,5,0,3,3,0,2,1,3,3,1,Arts,Bachelors,36-40,1,0,0,Hybrid,Tier2_City,2,1,1,2,0,3,5,17.21,Other,2,3,5,4,0,3,1,1,2,5,1,0,2,2,46.57
Education,Microbiologist,3.954866351312443,6,2,3,0,2,0,2,1,4,2,2,4,1,1,Arts,PhD,25-30,0,0,0,Remote,Tier3_City,3,2,4,3,4,1,4,26.09,Tech,1,1,3,2,2,0,5,1,4,2,1,0,4,4,55.55
Marketing,School Psychologist,3.8872278160326257,8,0,2,0,6,1,3,3,4,1,4,1,3,0,Commerce,Bachelors,25-30,11,0,0,Remote,Any,1,1,1,3,0,2,1,32.75,Tech,1,4,1,3,5,2,4,5,3,2,0,1,1,2,58.18
Medicine,Biochemist,2.7899718164405223,9,1,3,1,2,0,1,0,3,4,4,4,4,0,Science,PhD,36-40,0,0,0,Hybrid,Tier3_City,3,3,5,1,4,5,2,4.74,Manufacturing,4,4,4,4,3,1,3,4,2,4,1,1,1,2,58.6
Physics,Biomedical Engineer,4.1466770346309225,6,0,3,1,0,0,2,1,1,1,4,1,4,0,Science,Bachelors,18-24,8,0,0,Remote,Tier1_City,4,3,1,4,4,5,5,45.21,Tech,5,2,4,4,5,2,2,1,4,5,1,1,1,1,61.85
Art,Inorganic Chemist,4.435435195597571,0,0,3,1,0,0,2,0,1,0,2,0,0,0,Arts,Masters,36-40,12,0,0,Remote,Any,4,1,0,4,5,5,4,48.05,Manufacturing,1,1,1,1,1,5,5,5,3,2,0,1,5,5,50.46
Physics,Chemist,3.6004737006514045,8,2,1,0,8,1,3,4,4,3,2,2,2,0,Science,Bachelors,18-24,3,0,0,Hybrid,Tier1_City,3,4,4,1,4,0,4,22.61,Finance,1,2,3,5,3,3,5,3,3,5,0,1,3,1,62.1
Psychology,Biomedical Engineer,3.386066122147475,3,0,2,0,3,1,2,0,0,4,4,4,4,0,Arts,Masters,36-40,4,0,0,Flexible,Any,2,1,5,1,0,1,5,22.39,Finance,5,4,1,2,3,5,1,5,1,2,1,1,4,2,44.13
Chemistry,Digital Marketing Specialist,4.8379594474449865,5,2,1,1,8,0,4,0,4,4,3,0,1,1,Science,Masters,18-24,9,0,0,Hybrid,Tier1_City,3,4,2,3,5,4,3,44.29,Finance,2,1,2,2,2,2,2,3,1,1,1,1,5,1,60.89
Chemistry,Investment Banker,4.007516899236082,4,1,4,0,8,1,2,0,3,4,0,1,3,0,Science,Bachelors,25-30,13,1,40,Hybrid,Tier2_City,3,5,2,5,2,4,2,23.18,Healthcare,1,1,2,3,2,1,3,4,1,3,1,1,4,4,52.88
Engineering,Software Developer,4.501043198903908,2,1,4,1,9,0,4,0,3,3,0,3,3,0,Science,Bachelors,36-40,14,0,0,Remote,Any,3,5,2,3,0,4,5,43.24,Healthcare,4,1,2,2,4,3,2,1,3,5,0,1,3,5,60.8
Finance,Entrepreneur,4.343937224021853,3,2,4,0,8,0,4,1,0,4,2,2,2,0,Commerce,Bachelors,25-30,6,0,0,Remote,Tier1_City,3,1,1,1,2,2,4,4.33,Education,5,2,1,3,2,0,5,2,4,4,0,0,2,5,55.98
Business,Animator,3.905528282943287,4,2,0,1,4,1,2,3,2,1,1,1,0,0,Commerce,PhD,31-35,14,0,0,Office,Tier1_City,2,4,5,4,1,3,3,26.01,Education,5,3,5,2,4,0,5,3,4,4,1,1,4,5,62.5
Music,Financial Analyst,2.542040868625402,8,2,0,1,8,1,0,2,3,3,3,3,0,1,Arts,Bachelors,36-40,1,0,0,Office,Tier2_City,5,3,4,3,5,3,5,47.76,Education,1,3,2,1,5,1,2,2,5,4,1,1,5,2,50.97
Marketing,Risk Analyst,4.665697845168566,1,2,0,1,6,0,2,0,3,1,1,4,1,0,Commerce,Bachelors,31-35,11,0,0,Hybrid,Tier3_City,5,1,2,5,1,3,2,14.88,Finance,2,3,1,4,5,1,1,5,2,3,1,0,4,2,52.54
Architecture,Art Director,2.892668236464138,3,1,4,1,4,0,0,4,3,3,4,2,3,0,Interdisciplinary,Masters,36-40,10,0,0,Hybrid,Tier1_City,1,1,5,3,5,2,3,15.51,Finance,2,1,2,2,0,5,1,5,3,5,1,1,3,5,69.27
Computer Science,Legal Secretary,4.890931552076206,2,2,4,1,9,0,0,3,2,4,4,2,2,1,Science,Bachelors,25-30,9,0,0,Office,Tier2_City,2,4,2,2,5,4,4,32.62,Finance,3,4,2,4,4,1,5,2,5,4,1,1,4,1,68.26
Computer Science,School Counselor,4.335323722922068,2,2,3,1,2,1,0,1,2,4,4,1,1,0,Science,PhD,18-24,8,1,12,Remote,Tier2_City,2,5,5,3,0,5,1,46.53,Tech,3,2,4,5,4,5,3,4,3,3,1,0,2,5,59.57
Engineering,Chemical Engineer,4.823510457334699,9,2,0,1,5,0,1,0,3,1,2,3,3,0,Science,Masters,18-24,11,0,0,Hybrid,Tier1_City,2,3,1,1,2,3,2,12.34,Tech,4,2,1,4,5,2,5,1,1,1,1,1,3,2,48.4
Education,Curriculum Developer,3.5594576995252347,5,2,1,1,5,0,3,2,0,2,1,1,4,1,Arts,Masters,18-24,3,0,0,Office,Tier2_City,4,4,3,4,5,5,3,46.32,Finance,1,4,4,5,0,0,2,5,3,1,0,1,1,1,44.38
Biology,Financial Controller,2.511533030105653,2,1,4,1,0,1,3,4,4,0,3,1,0,0,Science,Masters,18-24,9,0,0,Office,Tier1_City,2,4,5,4,2,5,5,34.16,Manufacturing,2,3,3,2,1,0,4,2,1,3,1,1,5,3,62.08
Computer Science,Interior Designer,3.9743073531514073,0,1,1,1,6,0,2,0,4,0,3,0,1,1,Science,High School,25-30,9,0,0,Remote,Tier1_City,4,3,2,1,5,2,5,49.67,Education,3,5,2,1,3,0,4,2,1,2,0,1,2,1,42.89
Marketing,Acoustics Specialist,3.821931933378033,6,1,4,1,0,1,0,0,0,0,3,0,3,0,Commerce,Bachelors,18-24,12,0,0,Remote,Tier3_City,5,1,4,2,2,2,3,37.61,Healthcare,1,4,2,1,5,3,3,3,4,3,1,0,5,2,44.73
Business,Surgeon,4.229287718602075,3,2,3,0,7,1,0,1,0,1,0,2,3,1,Commerce,Bachelors,18-24,12,0,0,Office,Any,5,1,2,1,1,1,5,34.39,Education,1,3,4,4,3,4,3,2,1,5,0,0,2,1,42.99
Music,Landscape Architect,3.1509798595225864,7,2,1,1,4,0,4,2,0,2,1,1,3,0,Arts,Bachelors,18-24,0,0,0,Remote,Tier2_City,4,2,1,3,0,3,3,41.3,Manufacturing,2,1,1,1,2,1,3,2,5,2,1,0,1,4,38.01
Art,Cybersecurity Analyst,3.564860471259864,5,0,2,1,4,1,0,1,1,1,2,1,3,1,Arts,Masters,36-40,7,1,16,Office,Tier1_City,3,3,3,1,5,4,2,11.23,Other,1,4,5,5,2,3,1,3,2,5,1,1,1,2,52.46
Law,Software Developer,4.806838011640146,5,1,4,0,3,1,2,4,3,2,3,4,3,0,Arts,PhD,25-30,3,0,0,Remote,Tier2_City,5,4,3,1,3,0,5,47.46,Tech,5,3,5,1,1,4,5,3,4,4,1,1,1,5,65.02
Music,Physical Chemist,4.659026329136616,7,2,2,0,8,0,1,1,3,0,4,2,4,0,Arts,Bachelors,25-30,6,1,31,Remote,Any,3,2,4,2,2,2,2,10.78,Finance,3,2,3,1,2,1,2,5,4,1,1,1,2,2,44.92
Finance,Nuclear Physicist,3.740779228521899,4,2,4,1,7,1,3,0,3,2,2,2,3,1,Commerce,Bachelors,36-40,2,0,0,Remote,Tier2_City,1,2,5,3,2,5,4,4.21,Tech,4,5,1,1,3,4,5,4,4,2,0,1,5,1,44.1
Education,Human Resources Specialist,2.85366082004324,7,2,0,0,8,1,4,3,4,2,4,1,3,1,Arts,PhD,18-24,10,0,0,Flexible,Tier2_City,4,2,3,5,3,1,4,35.8,Tech,3,5,1,3,5,0,2,5,2,5,1,0,4,3,75.09
Biology,Architect,4.360984750580078,0,2,4,0,8,0,1,0,2,1,4,1,2,1,Science,Bachelors,40+,11,0,0,Office,Any,1,1,5,5,0,0,4,11.68,Manufacturing,1,5,4,3,5,4,4,4,3,5,1,1,5,5,56.19
Music,Biologist,2.759473877544539,2,1,2,1,0,0,2,2,1,0,1,4,1,1,Arts,Bachelors,31-35,8,0,0,Flexible,Tier2_City,4,5,2,4,2,2,4,38.66,Tech,5,3,2,4,4,1,5,1,4,2,1,0,4,1,53.05
Music,Chemical Engineer,3.3639437670387045,4,0,0,1,5,0,1,3,0,4,1,2,0,0,Arts,Bachelors,18-24,14,0,0,Hybrid,Tier3_City,1,2,5,1,0,1,5,40.37,Tech,3,3,2,2,4,3,2,3,1,1,0,1,2,1,42.78
Business,Architectural Technologist,3.903334804626844,9,1,4,0,7,0,2,4,3,1,1,0,3,1,Commerce,PhD,31-35,12,1,23,Office,Tier2_City,1,4,0,4,2,5,3,14.12,Education,2,1,1,2,2,1,2,5,3,5,0,0,2,1,68.95
Biology,Art Director,2.9789319226331616,8,0,0,1,4,1,2,3,2,2,3,4,1,0,Science,Masters,31-35,4,0,0,Flexible,Tier1_City,2,1,1,2,4,3,5,7.08,Education,5,5,5,5,3,4,4,3,4,5,1,0,3,1,65.45
Medicine,Dentist,2.995707282527175,1,0,3,0,6,1,4,4,2,3,1,1,4,1,Science,Masters,25-30,4,1,13,Hybrid,Tier1_City,5,5,2,5,2,1,5,26.54,Other,3,2,3,5,5,5,5,3,4,4,0,0,4,3,59.51
Art,Illustrator,3.050685485167966,0,2,1,0,4,0,4,2,4,2,2,4,1,0,Arts,Masters,36-40,2,1,43,Flexible,Tier2_City,4,5,5,1,4,2,2,44.84,Manufacturing,1,5,4,4,0,4,5,4,5,1,0,0,5,2,58.43
Marketing,Civil Engineer,3.733898147095098,7,0,0,1,8,1,1,3,2,2,4,0,1,0,Commerce,Bachelors,18-24,10,0,0,Flexible,Tier2_City,5,2,2,2,5,3,3,42.82,Finance,2,4,1,3,0,1,1,2,5,3,0,0,4,3,63.42
Psychology,Zoologist,4.359776228990081,8,0,4,0,5,0,2,0,4,4,4,2,0,0,Arts,Bachelors,25-30,8,0,0,Flexible,Tier2_City,2,2,1,2,0,5,1,8.5,Education,1,4,3,1,5,0,5,2,5,2,1,1,1,2,56.54
Physics,Music Teacher,4.601498782214982,1,2,0,1,0,0,4,0,0,2,3,1,2,1,Science,Masters,18-24,2,0,0,Flexible,Tier1_City,5,1,1,1,2,4,1,48.34,Other,1,2,1,3,5,1,4,3,4,1,1,0,2,5,41.72
Computer Science,Dentist,3.01118096768,2,1,1,1,3,0,1,2,0,3,3,1,4,0,Science,Bachelors,18-24,1,1,54,Office,Any,4,2,2,2,1,1,3,15.41,Tech,2,3,3,3,5,5,2,5,4,1,1,1,1,1,35.54
Marketing,Special Education Teacher,4.533770654248632,4,1,4,1,0,0,2,1,4,0,3,3,2,1,Commerce,Masters,18-24,10,1,8,Flexible,Any,2,1,3,1,1,0,1,19.42,Other,5,5,3,4,4,1,4,5,5,4,1,1,1,1,67.66
Biology,Accountant,3.3390162977244087,7,2,4,0,1,0,3,4,3,3,4,3,1,1,Science,PhD,36-40,12,0,0,Hybrid,Tier2_City,3,5,4,1,3,5,3,10.01,Other,3,4,2,3,3,4,4,4,1,2,0,0,1,1,68.92
Education,Legal Secretary,4.507966680928258,1,2,3,0,5,0,1,2,1,4,4,2,1,0,Arts,Masters,18-24,8,0,0,Office,Tier3_City,2,4,2,3,1,3,2,20.76,Healthcare,5,2,4,2,5,2,4,1,5,3,1,1,4,4,61.57
Chemistry,Architectural Technologist,4.5200801936950175,8,1,1,0,2,0,4,2,3,0,3,1,4,1,Science,Masters,25-30,11,0,0,Remote,Tier1_City,4,4,0,4,4,5,2,32.88,Education,2,1,4,3,4,4,5,5,4,4,0,1,2,1,72.42
Medicine,Architectural Technologist,4.858288315644513,6,2,2,1,5,1,0,1,2,0,0,4,0,0,Science,Masters,25-30,11,1,59,Office,Tier2_City,1,3,2,2,1,3,5,26.79,Other,3,4,2,2,3,4,3,1,4,1,0,0,5,4,51.33
Education,Biologist,4.066662210361868,7,1,0,1,5,0,4,2,3,0,0,3,1,1,Arts,Masters,36-40,8,1,29,Office,Tier2_City,5,3,5,2,1,5,1,41.89,Other,2,4,5,5,5,4,4,3,2,3,1,0,5,3,54.28
Psychology,Illustrator,4.989179286908788,8,1,0,0,9,1,2,0,3,0,2,3,0,1,Arts,Bachelors,40+,9,0,0,Office,Tier2_City,1,3,0,3,1,4,3,33.14,Healthcare,4,5,4,5,0,5,2,4,1,4,0,1,2,2,54.34
Music,Music Teacher,4.552950903148808,8,2,1,1,2,1,2,3,4,4,2,4,3,0,Arts,Bachelors,31-35,11,0,0,Office,Tier2_City,3,4,2,3,2,1,2,15.39,Finance,4,3,2,4,5,4,1,4,3,3,1,1,1,4,65.93
Architecture,Physician Assistant,4.675236980264223,2,1,1,1,9,0,0,4,3,2,1,4,4,1,Interdisciplinary,Bachelors,40+,12,0,0,Hybrid,Tier2_City,1,2,2,3,3,0,5,29.2,Tech,5,4,3,1,2,5,5,3,1,1,0,1,4,3,49.89
Education,Chemical Engineer,3.872116820934589,4,0,2,1,2,0,4,3,3,0,3,0,1,1,Arts,Masters,31-35,3,0,0,Hybrid,Tier1_City,5,1,0,5,0,4,1,6.02,Education,2,4,3,3,1,0,3,3,5,4,0,0,5,5,56.97
Physics,Physical Chemist,3.751908015482279,3,2,1,0,8,1,1,1,1,2,4,0,1,0,Science,Bachelors,40+,3,1,46,Remote,Tier1_City,1,4,4,5,3,1,1,30.3,Finance,3,5,4,1,2,5,3,1,5,5,1,1,2,2,52.65
Architecture,Architect,4.235424787676445,5,2,3,1,1,1,4,2,0,4,3,2,3,1,Interdisciplinary,Masters,31-35,12,0,0,Remote,Any,2,3,0,5,4,0,1,21.31,Manufacturing,5,3,3,2,3,3,4,5,1,3,1,0,4,4,62.53
Art,Civil Engineer,3.192729089869724,0,0,4,1,0,1,3,4,2,3,2,1,4,1,Arts,Bachelors,18-24,10,0,0,Hybrid,Tier1_City,4,3,4,1,2,5,2,7.62,Finance,4,1,4,1,4,1,2,5,2,1,1,0,2,3,53.95
Law,Web Developer,4.961761956347791,6,2,4,1,9,1,3,3,2,0,2,2,2,1,Arts,Masters,25-30,9,0,0,Hybrid,Tier1_City,1,2,4,2,5,0,2,17.45,Manufacturing,4,1,1,3,4,1,1,2,2,4,1,0,2,5,65.28
Medicine,Entrepreneur,4.776278613645895,7,0,3,1,9,0,4,0,1,3,2,0,0,1,Science,Bachelors,31-35,14,0,0,Remote,Tier2_City,4,3,0,4,2,2,1,45.21,Manufacturing,4,1,2,1,0,2,3,1,3,3,1,1,5,2,50.88
Marketing,Surgeon,3.6629737355837326,6,1,3,1,7,1,0,4,3,0,3,3,1,0,Commerce,Masters,25-30,12,0,0,Remote,Tier1_City,4,3,5,1,1,0,2,30.54,Education,5,1,5,1,5,0,5,4,5,1,1,1,4,4,58.96
Music,Inorganic Chemist,3.543198864799707,0,1,2,0,6,0,0,1,3,3,1,4,1,0,Arts,Bachelors,25-30,12,1,52,Hybrid,Tier2_City,4,1,1,2,1,1,1,45.45,Healthcare,3,3,4,1,0,5,2,1,4,3,1,0,5,2,52.9
Finance,Physicist,4.768031623826525,6,0,2,1,9,1,0,2,0,3,4,3,0,1,Commerce,Bachelors,25-30,5,0,0,Office,Tier2_City,2,2,0,2,4,4,4,22.31,Manufacturing,4,1,5,4,2,5,5,1,3,3,1,1,3,2,49.33
Physics,Microbiologist,3.604028928157372,7,1,4,0,2,0,3,4,3,3,0,3,4,0,Science,Bachelors,36-40,8,0,0,Hybrid,Tier1_City,4,5,1,3,5,4,2,49.01,Tech,5,5,2,1,5,5,4,3,1,5,1,0,2,5,61.27
Biology,Civil Engineer,3.633911168005127,8,0,3,0,9,0,0,0,0,3,2,1,0,0,Science,Masters,18-24,7,0,0,Remote,Tier1_City,1,5,5,3,2,2,3,19.92,Education,5,5,2,3,2,2,1,3,2,2,0,1,3,4,43.69
Engineering,Social Media Manager,2.6724109488461782,3,0,4,0,8,0,0,3,4,4,2,4,2,1,Science,Bachelors,31-35,9,0,0,Office,Tier1_City,4,3,5,1,5,1,2,38.57,Other,1,5,1,3,1,1,5,3,3,4,0,1,2,5,64.42
Physics,Marketing Manager,2.8579016849455963,9,0,1,1,7,1,1,0,1,3,2,1,0,1,Science,Bachelors,31-35,2,0,0,Remote,Tier2_City,2,3,5,3,0,0,1,17.35,Other,1,1,2,1,3,5,1,3,4,2,0,0,1,5,35.29
Marketing,Landscape Architect,3.150178947893121,6,2,4,0,6,1,2,1,3,1,0,3,0,1,Commerce,PhD,40+,5,0,0,Office,Tier3_City,4,1,5,2,3,2,3,7.98,Manufacturing,3,5,3,4,2,2,5,3,2,5,1,1,1,2,60.77
Law,Dentist,4.519058804486527,5,2,0,1,4,0,4,2,1,4,4,2,4,1,Arts,Masters,36-40,14,0,0,Remote,Tier1_City,1,5,2,3,2,5,5,42.15,Education,4,5,5,2,2,4,3,1,4,5,0,1,3,1,71.08
Finance,Architect,3.894279357396112,8,1,2,0,9,1,4,4,1,0,0,3,3,0,Commerce,PhD,31-35,12,0,0,Flexible,Tier2_City,2,2,1,5,5,3,3,38.84,Tech,1,2,2,1,0,4,3,3,4,4,0,0,3,1,67.08
Music,Microbiologist,3.6970216705680974,4,2,0,1,9,1,1,4,3,4,3,3,1,0,Arts,Bachelors,25-30,6,1,25,Remote,Tier3_City,3,2,3,3,0,5,3,41.57,Education,3,1,2,4,5,1,4,5,2,3,1,1,1,5,56.93
Engineering,Teacher,3.282659208848504,3,1,1,0,6,0,4,4,1,1,0,1,1,1,Science,Bachelors,18-24,14,0,0,Office,Tier1_City,3,4,2,2,0,1,2,17.09,Education,1,5,5,5,3,2,2,5,4,3,0,0,5,4,55.7
Education,Nurse,3.017816859607088,0,1,4,1,3,0,3,3,0,0,2,3,3,0,Arts,Masters,25-30,14,0,0,Hybrid,Tier2_City,1,4,2,1,3,2,3,36.07,Other,4,3,5,3,0,4,1,2,3,1,0,1,3,2,57.62
Education,Fluid Mechanics Engineer,3.946189065369116,7,0,0,0,8,1,0,4,3,3,3,4,1,1,Arts,Bachelors,31-35,5,0,0,Remote,Tier2_City,5,2,1,4,0,4,3,13.34,Manufacturing,5,5,1,5,1,0,2,5,2,3,1,0,5,5,56.27
Computer Science,Special Education Teacher,2.721159684873834,7,0,2,0,6,0,4,2,3,4,0,4,0,1,Science,Masters,36-40,2,1,8,Remote,Tier3_City,4,4,1,3,4,2,1,3.53,Finance,4,2,2,3,2,0,2,2,2,3,0,1,1,4,52.46
Computer Science,Paralegal,4.882164567853074,5,0,2,1,0,1,1,3,0,3,0,2,1,0,Science,Bachelors,31-35,13,0,0,Hybrid,Any,5,1,3,2,0,3,2,43.72,Education,1,3,3,2,5,1,2,5,2,1,1,0,1,1,41.1
Chemistry,Geneticist,3.8112685081057216,3,0,3,0,3,1,1,4,4,0,3,2,2,1,Science,Bachelors,18-24,13,0,0,Office,Tier1_City,2,3,2,4,5,1,1,27.61,Manufacturing,4,3,3,4,2,3,2,4,5,2,1,0,1,5,66.83
Law,Financial Controller,3.4921069974993704,3,2,0,0,0,1,0,3,1,0,0,3,3,0,Arts,Bachelors,25-30,13,0,0,Remote,Tier1_City,4,2,1,4,4,2,2,49.23,Other,5,4,1,2,2,3,2,2,5,5,0,0,4,3,57.76
Engineering,Art Director,3.526063787290754,3,1,3,0,0,1,2,4,1,1,3,1,3,0,Science,Bachelors,25-30,12,0,0,Office,Tier2_City,5,5,0,5,0,5,5,21.1,Tech,2,2,2,5,4,2,5,1,2,5,1,0,3,5,59.27
Computer Science,Physical Chemist,2.840847887901288,9,2,1,0,5,1,2,3,0,4,4,4,4,1,Science,High School,18-24,12,1,27,Office,Tier1_City,1,5,4,4,1,0,3,47.97,Tech,5,2,5,4,3,1,2,3,3,3,0,0,1,4,60.64
Biology,Mechanical Engineer,3.2527813269649046,8,1,1,1,7,0,1,0,0,4,0,3,4,0,Science,High School,18-24,8,1,28,Remote,Tier1_City,2,2,5,2,0,5,2,31.91,Finance,1,5,3,5,0,1,1,2,4,1,0,0,1,4,43.01
Biology,Quantum Physicist,3.06690260572548,3,2,0,0,5,0,1,2,3,3,1,4,2,1,Science,PhD,18-24,3,0,0,Remote,Any,4,4,4,2,4,1,3,27.07,Tech,5,2,2,1,0,4,3,5,3,3,0,0,4,5,54.77
Biology,Judge,4.911212176347732,1,1,0,0,1,0,4,3,1,1,4,2,1,0,Science,Bachelors,36-40,1,1,44,Flexible,Tier2_City,3,4,1,3,0,2,3,17.23,Manufacturing,3,3,1,5,0,4,2,1,5,4,1,1,1,3,56.0
Chemistry,Digital Marketing Specialist,2.64246890683964,9,1,4,0,5,0,2,2,0,2,1,0,3,1,Science,Masters,25-30,8,0,0,Hybrid,Tier2_City,4,2,3,3,0,5,4,41.79,Finance,4,3,1,2,1,0,4,5,4,1,1,1,1,1,42.71
Business,Animator,4.412666846638961,3,1,3,0,6,1,4,2,2,0,3,0,3,0,Commerce,Masters,25-30,2,0,0,Remote,Tier1_City,2,2,1,3,0,2,1,41.95,Other,2,5,5,2,4,0,1,1,5,2,0,0,5,3,48.96
Finance,Construction Manager,2.671565903176624,7,2,1,1,3,0,4,4,2,2,0,0,2,0,Commerce,Masters,40+,5,1,18,Office,Tier1_City,3,2,3,4,4,5,2,22.6,Manufacturing,2,3,1,1,1,1,5,5,4,2,0,1,2,3,55.26
Computer Science,Composer,2.623857361640555,8,0,3,1,0,1,2,3,4,4,1,4,0,0,Science,Bachelors,25-30,4,0,0,Remote,Tier1_City,1,1,2,4,0,1,5,37.18,Other,4,5,1,4,3,4,3,3,2,3,1,1,2,4,55.51
Engineering,Advertising Manager,3.377170812717666,7,0,3,1,5,0,2,2,4,3,2,3,4,1,Science,Masters,18-24,13,0,0,Hybrid,Tier3_City,4,5,0,5,3,4,4,24.02,Other,4,4,1,5,0,4,3,4,2,1,0,0,1,5,64.44
Psychology,Biochemist,3.637726824445053,3,2,1,1,8,0,4,2,2,0,3,2,1,1,Arts,Masters,25-30,12,1,53,Remote,Any,5,1,2,3,5,5,1,37.76,Finance,3,2,3,5,0,1,3,5,2,4,1,0,2,3,67.14
Engineering,Ecologist,3.2203236493264304,2,0,3,1,6,1,1,1,3,4,0,3,1,1,Science,Masters,18-24,14,0,0,Flexible,Tier2_City,5,1,0,1,3,0,5,49.73,Finance,5,2,5,5,0,0,4,5,4,5,0,0,3,5,69.84
Finance,Music Therapist,3.1043571240573784,7,0,1,1,0,0,4,4,1,1,2,2,3,0,Commerce,Masters,18-24,1,0,0,Hybrid,Tier1_City,1,3,3,5,4,5,5,15.34,Manufacturing,2,2,5,4,2,4,2,2,1,1,0,1,2,3,43.23
Chemistry,Manager,4.286536010210939,5,0,1,1,9,0,1,3,2,4,4,4,0,0,Science,PhD,18-24,0,0,0,Flexible,Tier3_City,2,1,1,1,1,1,3,32.8,Finance,1,4,5,2,2,3,5,3,2,4,0,1,3,2,56.6
Marketing,Actuary,4.731468056310712,2,2,3,0,1,0,0,3,0,1,1,4,2,1,Commerce,Masters,25-30,8,1,26,Hybrid,Any,1,5,1,4,3,5,1,20.85,Manufacturing,4,2,1,1,5,2,5,1,3,3,0,1,5,4,53.18
Architecture,Special Education Teacher,2.8263399499384083,6,0,4,1,7,0,1,4,2,0,2,2,1,0,Interdisciplinary,Bachelors,18-24,2,1,37,Hybrid,Any,2,4,1,5,5,0,4,28.77,Tech,4,4,1,4,0,5,5,2,2,2,0,0,4,3,46.05
Education,Physician Assistant,3.610484121998311,7,1,4,0,4,0,1,2,0,3,3,3,2,1,Arts,Masters,25-30,6,0,0,Flexible,Tier2_City,3,5,1,5,2,0,2,44.08,Tech,2,4,3,1,0,5,2,3,5,5,1,1,5,2,58.03
Engineering,Marketing Manager,4.152934708381226,3,2,1,1,1,1,3,2,0,2,2,3,0,1,Science,Bachelors,36-40,8,1,18,Hybrid,Tier2_City,2,2,2,2,5,1,2,19.34,Education,4,5,1,3,2,0,5,3,2,2,1,0,2,4,53.29
Medicine,Manager,4.3171863588409565,8,0,0,0,6,0,1,2,0,1,1,1,1,0,Science,Masters,25-30,8,1,34,Hybrid,Tier2_City,3,2,2,4,3,2,4,6.4,Healthcare,2,1,3,1,1,5,5,2,2,4,1,0,4,4,50.47
Computer Science,Manager,3.494304798661697,6,0,3,0,9,0,2,2,2,4,1,3,1,0,Science,Bachelors,36-40,11,0,0,Remote,Tier1_City,4,2,3,4,2,5,3,40.55,Healthcare,1,1,5,3,4,3,3,1,1,5,0,0,5,5,59.84
Computer Science,Doctor,4.375929043526621,2,1,2,1,5,0,3,3,2,0,4,1,1,1,Science,Bachelors,25-30,9,1,52,Flexible,Tier2_City,4,1,0,5,4,4,3,29.09,Tech,1,5,3,1,1,1,2,4,1,4,0,1,3,3,58.66
Education,Electrical Engineer,3.67001928148844,1,2,1,0,5,0,1,3,4,2,2,2,3,1,Arts,Masters,25-30,5,0,0,Remote,Tier3_City,1,3,0,4,5,0,5,24.12,Education,2,5,2,3,4,1,1,2,5,2,0,1,2,5,60.8
Art,Fluid Mechanics Engineer,4.220067871887174,2,1,3,1,1,1,1,0,1,3,3,4,2,0,Arts,Masters,31-35,7,0,0,Office,Tier3_City,1,4,0,5,1,0,1,11.62,Healthcare,4,5,4,5,2,2,1,5,3,1,0,0,3,3,54.58
Art,Lawyer,4.42351623926344,4,2,0,1,9,1,0,0,3,3,4,1,4,0,Arts,Bachelors,18-24,8,0,0,Hybrid,Tier2_City,4,1,1,2,2,5,5,7.36,Manufacturing,3,2,1,4,5,4,1,4,3,2,1,0,2,2,49.67
Art,Construction Manager,4.505885407183003,1,2,0,0,0,0,4,2,3,3,0,1,3,0,Arts,Bachelors,18-24,2,0,0,Remote,Tier3_City,5,2,2,5,2,2,2,16.1,Manufacturing,3,3,5,5,5,3,4,1,4,3,1,0,5,3,48.92
Engineering,Electrical Engineer,2.812393116383844,8,0,2,1,5,1,0,4,4,3,0,1,1,0,Science,Masters,31-35,5,0,0,Remote,Tier2_City,3,5,4,4,5,5,4,36.79,Finance,5,5,4,2,0,5,3,1,1,3,0,0,1,2,48.12
Medicine,Manager,3.797255482993511,6,2,4,0,3,1,3,0,3,4,2,3,4,1,Science,Bachelors,25-30,4,0,0,Flexible,Tier1_City,4,2,4,4,3,1,1,22.35,Healthcare,3,4,4,4,0,4,5,2,5,4,0,1,5,3,57.92
Finance,Musician,4.573631141478819,4,2,2,1,2,1,3,2,4,1,4,1,2,1,Commerce,Masters,31-35,6,0,0,Office,Any,5,5,1,5,2,4,4,29.8,Other,4,1,5,5,0,5,3,2,2,3,1,1,2,2,60.25
Chemistry,Financial Advisor,4.743378135960427,2,0,2,0,1,0,1,4,1,2,2,3,2,1,Science,Bachelors,36-40,6,0,0,Office,Tier2_City,2,4,4,5,4,5,1,6.86,Manufacturing,3,2,4,1,1,5,2,4,3,1,1,1,3,5,49.54
Art,Art Therapist,4.749704486708335,6,0,4,0,6,1,3,0,1,0,0,2,2,1,Arts,Masters,25-30,8,0,0,Hybrid,Tier3_City,4,2,0,5,5,0,2,8.79,Healthcare,5,3,3,4,0,5,2,4,4,1,1,1,2,3,50.09
Finance,Financial Analyst,4.354630374699638,7,2,1,1,8,0,1,3,2,1,4,1,4,1,Commerce,Masters,25-30,0,1,24,Remote,Tier1_City,5,4,0,3,4,0,2,3.53,Finance,1,1,5,1,4,3,3,5,4,5,1,1,3,5,50.58
Chemistry,Landscape Architect,3.881706005436988,4,0,3,0,6,1,4,3,1,2,4,4,1,0,Science,Bachelors,25-30,5,1,39,Office,Any,4,2,3,4,5,1,1,34.64,Tech,2,1,5,5,0,1,2,5,2,3,1,1,4,4,62.8
Computer Science,Data Scientist,3.710864306934582,3,1,0,1,2,1,0,2,2,1,2,4,4,0,Science,Bachelors,40+,4,1,54,Hybrid,Tier2_City,2,2,1,4,4,2,3,15.43,Education,3,1,3,4,2,1,3,5,4,4,1,1,5,1,51.5
Medicine,Entrepreneur,2.907168134850962,5,2,0,1,4,0,1,4,4,4,1,2,0,0,Science,Bachelors,36-40,3,0,0,Office,Tier2_City,2,5,3,3,3,5,1,48.45,Other,2,4,2,5,0,4,3,4,1,2,0,1,2,3,49.15
Architecture,Surgeon,2.575435959525964,1,0,2,0,2,0,3,3,4,0,2,0,4,1,Interdisciplinary,Masters,36-40,9,1,57,Hybrid,Any,3,3,0,5,5,3,2,17.5,Finance,2,4,2,2,1,4,3,3,5,1,1,1,1,2,60.46
Engineering,Nurse,4.053714792132986,6,2,0,1,5,0,1,3,1,4,4,1,2,0,Science,Bachelors,25-30,11,0,0,Flexible,Any,2,5,2,2,1,2,4,20.09,Finance,1,4,4,5,1,3,1,4,1,5,1,1,2,5,59.92
Computer Science,Entrepreneur,3.1007537001138665,3,1,0,1,9,0,4,0,4,1,1,4,0,1,Science,Masters,31-35,10,0,0,Remote,Tier2_City,2,1,1,5,3,0,5,25.07,Finance,5,3,5,2,2,2,5,5,5,4,0,1,1,2,70.77
Education,Microbiologist,3.2437914066757694,5,0,2,0,7,0,2,2,2,0,1,2,3,0,Arts,Bachelors,25-30,13,0,0,Remote,Tier1_City,3,4,5,5,4,5,4,18.0,Education,4,1,3,5,3,1,2,3,2,1,1,1,1,5,53.82
Architecture,Music Therapist,4.335487057827741,4,0,4,1,3,0,4,0,4,1,2,4,1,1,Interdisciplinary,Bachelors,18-24,0,0,0,Flexible,Any,4,4,3,3,5,0,2,41.42,Manufacturing,4,5,5,4,1,3,5,5,1,1,1,1,2,1,45.55
Marketing,Architect,3.47531500891536,6,2,1,0,3,1,0,4,0,1,2,0,3,0,Commerce,High School,36-40,3,1,36,Hybrid,Any,4,3,3,4,3,4,4,44.18,Healthcare,4,3,3,1,3,0,5,3,2,4,1,0,2,4,30.92
Architecture,Principal,3.7719944327284063,6,0,2,0,7,0,4,3,1,4,1,1,0,0,Interdisciplinary,Bachelors,18-24,9,0,0,Hybrid,Tier1_City,3,2,0,5,4,2,3,3.52,Tech,5,4,2,4,2,5,3,1,3,5,0,1,2,1,65.82
Music,Biologist,2.7390383238862763,5,1,1,0,1,1,2,0,3,3,2,1,1,1,Arts,Masters,40+,10,0,0,Office,Tier2_City,4,4,3,4,0,3,3,33.77,Tech,5,4,2,5,0,4,5,4,4,1,1,0,2,2,58.78
Marketing,Data Scientist,4.543440773836644,2,2,0,1,3,1,2,0,0,4,1,2,1,1,Commerce,Masters,18-24,6,1,11,Hybrid,Tier2_City,4,3,0,1,0,4,1,35.25,Other,5,4,4,5,5,1,3,1,5,4,0,0,2,3,56.05
Chemistry,Accountant,4.982570277084111,9,1,4,1,8,1,0,1,4,1,1,4,2,0,Science,Masters,36-40,3,0,0,Remote,Tier1_City,5,1,2,4,2,3,4,48.19,Education,3,2,3,5,3,2,2,2,4,4,1,1,5,4,51.75
Business,Composer,4.929629269133001,2,2,3,1,7,1,1,0,2,2,0,3,0,1,Commerce,Bachelors,25-30,0,1,58,Office,Tier1_City,3,4,3,2,1,4,4,20.41,Tech,2,1,2,3,2,2,4,1,2,5,0,0,1,5,35.43
Psychology,Art Therapist,2.9565980179198545,1,0,1,1,4,1,4,2,0,1,3,4,4,1,Arts,PhD,25-30,9,1,36,Remote,Tier2_City,3,1,0,2,0,2,2,12.18,Other,5,5,1,2,3,0,5,1,4,1,0,1,5,4,59.14
Chemistry,Architectural Technologist,3.4267259123959315,4,1,2,0,1,1,3,2,4,3,4,4,2,1,Science,Masters,18-24,0,0,0,Remote,Any,1,5,0,5,4,0,1,27.47,Other,5,1,2,1,3,4,5,2,5,3,1,0,1,3,59.04
Music,Paralegal,3.728887677899904,0,0,3,0,5,0,2,2,3,4,1,0,0,1,Arts,PhD,25-30,0,0,0,Remote,Tier1_City,5,4,2,4,3,3,1,24.04,Education,3,3,5,2,0,4,5,4,2,4,1,1,4,3,51.81
Business,Investment Banker,2.771578692194765,4,0,4,0,3,1,3,4,3,2,3,0,1,0,Commerce,Bachelors,25-30,10,0,0,Hybrid,Any,4,4,3,5,5,2,4,40.21,Education,2,2,3,5,5,3,3,5,5,4,0,0,5,2,73.53
Education,Game Developer,2.6414459629487,3,0,4,1,8,1,4,2,2,1,4,4,3,0,Arts,Bachelors,31-35,9,0,0,Remote,Any,1,2,5,3,3,3,5,45.49,Healthcare,4,3,1,5,1,0,1,4,3,1,1,1,5,1,60.98
Computer Science,Microbiologist,4.643620126411516,3,0,3,0,7,0,3,4,1,3,3,2,0,0,Science,Bachelors,18-24,4,0,0,Flexible,Any,5,1,5,2,2,2,4,7.08,Healthcare,1,4,2,2,3,5,3,5,5,5,1,0,3,5,62.72
Architecture,Chemist,3.245040318365385,3,2,3,1,5,0,0,1,0,4,3,2,0,0,Interdisciplinary,Masters,18-24,6,0,0,Hybrid,Tier1_City,4,5,2,5,3,4,4,42.79,Education,5,4,2,2,4,2,3,2,4,5,0,0,1,4,59.1
Physics,Biologist,2.706222212580381,4,0,3,0,9,0,4,2,2,2,2,1,3,1,Science,Bachelors,18-24,8,1,50,Remote,Tier2_City,5,3,2,3,0,2,4,45.72,Healthcare,5,5,3,2,0,2,3,3,1,1,1,1,2,3,43.45
Music,Chemist,2.924288090744098,5,0,4,1,4,0,2,4,1,3,2,1,4,1,Arts,Bachelors,25-30,7,1,24,Office,Tier2_City,2,5,2,5,3,4,3,46.43,Manufacturing,1,1,1,3,4,0,2,2,2,5,0,0,3,1,54.74
Chemistry,Financial Controller,4.454398041934187,1,2,2,1,1,0,1,4,3,0,4,4,3,1,Science,Bachelors,36-40,1,1,36,Office,Any,4,4,5,4,0,0,1,38.92,Finance,5,3,3,2,0,0,2,4,3,1,1,1,1,2,40.42
Chemistry,School Counselor,3.8455251723129513,0,1,1,1,9,1,4,0,0,4,3,2,3,0,Science,Masters,36-40,8,0,0,Hybrid,Tier2_City,5,1,3,4,0,4,3,37.88,Tech,5,4,2,5,0,2,4,3,1,3,1,1,4,2,53.55
Psychology,Legal Consultant,2.5771647378182365,9,0,2,0,8,0,0,4,1,0,1,1,3,0,Arts,Masters,18-24,3,0,0,Remote,Tier1_City,5,4,4,4,1,1,5,3.7,Tech,5,5,4,1,5,0,5,2,1,2,1,0,5,5,34.73
Art,Curriculum Developer,4.679553039835378,7,0,2,1,0,1,3,2,3,2,2,3,4,0,Arts,Bachelors,25-30,11,0,0,Remote,Tier1_City,1,3,5,4,2,0,2,46.25,Tech,1,5,3,4,1,0,4,4,1,5,1,1,2,1,61.02
Computer Science,Architect,4.403599928856594,4,0,0,1,4,0,4,0,1,1,4,0,1,1,Science,Bachelors,31-35,9,0,0,Flexible,Tier2_City,5,3,0,1,4,5,5,19.52,Tech,3,3,2,2,4,4,1,3,2,4,0,0,5,2,57.23
Physics,Financial Controller,2.7296655327203547,5,2,3,0,5,1,1,3,0,1,3,2,4,1,Science,Masters,25-30,14,1,8,Remote,Any,2,4,0,3,0,5,1,4.93,Manufacturing,3,1,3,2,3,0,2,4,2,4,1,0,2,5,57.22
Physics,Graphic Designer,3.3285244583785185,7,0,2,0,0,0,1,0,0,3,2,4,1,1,Science,PhD,25-30,10,1,56,Remote,Tier2_City,2,4,2,3,5,2,2,22.41,Manufacturing,1,2,2,2,0,2,3,2,1,1,1,1,1,3,52.08
Medicine,Special Education Teacher,3.937441416243608,0,1,4,1,2,0,0,3,3,0,0,4,4,1,Science,Masters,25-30,4,0,0,Hybrid,Tier2_City,5,4,2,4,2,2,5,37.44,Finance,3,5,3,1,5,1,2,1,5,1,0,1,3,4,46.17
Physics,Pharmacist,2.9290376186525804,8,0,2,0,0,1,4,3,2,3,4,4,1,0,Science,PhD,18-24,11,1,15,Remote,Tier1_City,4,1,4,1,4,1,1,23.77,Education,4,3,2,2,4,2,2,1,5,4,1,0,3,5,80.38
Computer Science,Marketing Manager,3.396486771320116,9,0,3,1,5,0,2,0,2,3,1,2,4,0,Science,Masters,18-24,10,0,0,Flexible,Any,1,2,1,4,5,2,5,38.63,Healthcare,4,4,1,2,4,5,1,2,1,5,0,1,4,1,58.81
Medicine,Civil Engineer,4.030064610862546,8,1,1,1,8,1,2,2,1,1,4,1,0,0,Science,Masters,18-24,4,0,0,Flexible,Tier2_City,4,3,0,1,3,0,2,26.94,Finance,1,2,5,2,1,5,1,5,5,1,1,1,2,3,53.53
Physics,Human Resources Specialist,3.4202047896783,1,0,4,0,9,0,3,3,2,2,1,0,0,1,Science,Bachelors,31-35,3,0,0,Hybrid,Any,5,1,1,4,2,0,2,17.07,Tech,2,2,5,1,4,4,5,4,1,1,1,1,5,4,34.45
Computer Science,School Psychologist,4.41795573087346,3,1,4,1,6,0,0,1,3,4,4,3,1,0,Science,Masters,18-24,12,0,0,Office,Tier2_City,2,3,2,2,5,4,5,12.54,Healthcare,5,1,3,4,3,0,2,2,2,1,0,0,5,1,64.05
Physics,Credit Analyst,2.608235492469539,2,2,4,0,8,0,4,3,2,2,1,0,0,0,Science,Masters,18-24,5,1,45,Hybrid,Tier2_City,3,4,0,2,2,3,3,22.79,Finance,2,3,2,5,4,2,1,1,5,2,0,0,4,2,57.89
Medicine,Forensic Psychologist,4.499923658615749,6,1,0,1,1,1,3,2,4,0,4,3,3,0,Science,Masters,25-30,0,1,48,Office,Tier2_City,1,3,0,5,2,2,5,4.68,Tech,5,1,5,1,1,5,4,4,3,4,0,0,2,1,53.36
Marketing,Human Resources Specialist,3.7286790294033008,9,0,4,0,2,1,2,0,4,2,2,1,2,1,Commerce,Bachelors,18-24,1,0,0,Hybrid,Tier1_City,4,5,2,4,3,1,5,22.86,Finance,3,5,5,2,0,3,2,5,2,1,0,0,4,4,40.05
Biology,Credit Analyst,3.852621513505298,5,1,4,0,0,1,3,2,1,2,4,1,1,0,Science,Bachelors,18-24,3,0,0,Remote,Tier1_City,2,3,1,3,3,5,5,6.23,Tech,3,5,3,3,4,1,3,1,1,3,0,1,4,4,47.51
Chemistry,Data Scientist,3.619822627138955,2,1,3,1,8,1,2,0,3,0,1,1,0,1,Science,Bachelors,36-40,3,0,0,Flexible,Tier1_City,4,5,1,5,2,0,3,44.22,Other,4,3,3,1,4,2,5,3,3,5,1,0,5,1,44.77
Chemistry,Legal Consultant,2.890785795164585,9,0,2,1,8,1,4,3,4,2,4,4,0,1,Science,Bachelors,18-24,7,1,10,Flexible,Tier2_City,5,1,3,2,5,0,4,30.05,Tech,2,4,3,2,2,0,2,5,3,3,1,1,3,4,69.26
Music,Biochemist,4.348987820690984,6,2,3,1,1,1,3,1,3,1,0,0,0,1,Arts,Bachelors,31-35,8,1,16,Flexible,Tier2_City,4,1,3,4,1,0,2,33.36,Other,1,5,4,2,3,4,5,4,2,1,0,1,3,1,40.42
Marketing,Nurse,3.80271499558808,3,2,3,0,2,1,2,1,2,3,1,0,1,0,Commerce,Masters,25-30,11,1,12,Office,Tier1_City,1,5,4,5,0,3,1,16.58,Manufacturing,5,5,1,5,5,1,5,1,3,4,1,1,1,3,57.86
Music,Legal Secretary,3.14258517502498,7,2,0,0,8,1,3,2,0,4,1,2,4,1,Arts,Bachelors,31-35,3,1,13,Hybrid,Tier2_City,3,3,4,4,3,3,2,13.61,Tech,3,4,1,1,3,5,1,4,5,5,0,0,1,4,55.48
Biology,Organic Chemist,4.281993363857844,9,1,3,1,0,0,2,2,2,0,3,0,3,0,Science,Bachelors,25-30,5,0,0,Remote,Tier2_City,3,1,1,2,1,2,2,36.27,Finance,5,2,1,1,5,5,1,1,3,2,1,1,3,4,39.95
Computer Science,Principal,3.818780583096429,2,2,4,0,1,0,4,3,0,2,2,1,2,0,Science,Bachelors,18-24,3,0,0,Remote,Tier2_City,5,3,2,5,3,5,4,34.56,Healthcare,1,3,2,5,5,3,2,1,3,2,1,1,2,3,45.62
Music,Financial Controller,4.20037528645923,0,2,2,0,7,1,3,4,4,0,1,1,0,0,Arts,Masters,36-40,3,0,0,Remote,Tier1_City,1,2,1,2,2,1,2,8.77,Manufacturing,5,2,2,3,3,3,5,3,4,4,1,1,5,3,54.11
Physics,Music Therapist,4.899156261706231,1,1,1,1,5,1,4,3,1,2,3,1,3,0,Science,Bachelors,25-30,11,0,0,Remote,Tier2_City,3,2,0,1,1,3,2,14.22,Other,4,1,1,3,5,0,4,3,3,3,1,0,4,5,59.6
Art,Financial Advisor,3.554968253379501,6,0,2,1,3,0,4,3,3,3,1,2,1,0,Arts,Bachelors,36-40,10,1,46,Hybrid,Tier1_City,2,5,3,2,5,4,3,47.49,Healthcare,1,4,3,4,4,3,1,1,3,1,0,1,1,2,64.07
Art,Chemical Engineer,3.6330438980664974,6,2,0,0,9,1,3,3,4,1,2,0,3,1,Arts,Masters,25-30,11,1,56,Office,Tier1_City,4,5,3,4,5,3,3,17.3,Other,1,3,4,4,3,1,1,3,5,3,1,0,5,1,71.19
Medicine,Aerospace Engineer,2.609575196518146,8,1,1,0,9,0,1,1,0,2,2,2,0,1,Science,Bachelors,40+,8,0,0,Hybrid,Tier2_City,5,3,5,3,4,0,3,4.21,Education,5,4,1,5,3,5,1,3,3,2,1,1,4,4,52.16
Chemistry,Dentist,3.8785437199208657,3,1,3,1,5,0,0,2,3,2,3,4,0,1,Science,PhD,31-35,13,0,0,Hybrid,Tier1_City,2,2,1,2,0,1,3,6.0,Healthcare,5,4,3,1,2,3,1,5,3,4,0,1,4,4,66.43
Law,Composer,3.1075554537115697,8,0,2,1,9,1,1,4,3,2,4,3,3,1,Arts,PhD,40+,3,0,0,Hybrid,Any,5,2,0,3,0,2,3,39.45,Education,3,2,5,2,1,0,5,3,2,3,0,0,4,3,54.12
Education,Marketing Specialist,3.198077527384959,0,1,1,0,8,0,3,2,1,3,3,4,0,1,Arts,Bachelors,25-30,12,0,0,Office,Any,1,5,1,1,3,3,1,38.59,Education,5,2,4,3,1,5,4,5,4,5,0,0,1,1,72.14
Marketing,Chemical Engineer,4.726649503568566,0,2,3,0,0,1,4,2,1,0,4,1,1,1,Commerce,Bachelors,25-30,5,0,0,Flexible,Tier2_City,5,4,5,5,0,0,4,20.95,Manufacturing,1,1,2,1,0,3,1,2,3,3,1,1,3,2,47.68
Chemistry,Art Therapist,2.7933990911755924,5,1,1,0,3,0,1,0,1,2,0,1,0,0,Science,Masters,31-35,13,0,0,Office,Tier1_City,3,3,1,5,4,4,5,10.2,Healthcare,5,3,5,4,5,4,4,5,1,3,0,1,1,1,47.37
Art,Nurse,3.993895777818605,8,0,2,1,3,0,3,4,1,3,2,1,0,1,Arts,High School,36-40,12,1,20,Remote,Tier2_City,1,3,1,3,5,4,3,26.41,Other,3,4,5,3,5,5,5,5,4,3,1,1,2,5,60.38
Engineering,Financial Analyst,2.765794585747738,7,0,3,0,9,1,3,0,1,2,3,3,0,0,Science,Bachelors,40+,8,0,0,Hybrid,Tier2_City,5,1,0,5,1,2,4,18.6,Tech,2,1,5,2,5,1,3,1,5,2,0,1,2,3,54.17
Psychology,Zoologist,4.418344409903311,7,1,2,1,8,0,1,0,4,2,2,0,4,0,Arts,Bachelors,25-30,2,0,0,Office,Tier1_City,2,5,3,2,1,2,5,20.58,Manufacturing,4,4,3,4,5,5,3,2,3,1,1,1,4,3,38.45
Biology,Acoustics Specialist,4.513730119311424,4,0,1,1,0,0,1,1,2,3,0,0,4,0,Science,PhD,31-35,6,0,0,Hybrid,Tier1_City,1,1,2,3,5,3,2,15.27,Manufacturing,1,1,1,2,2,5,3,2,2,4,1,0,3,2,55.72
Art,Biotechnologist,4.2799489973268185,5,1,0,1,5,0,2,0,0,3,0,3,2,1,Arts,High School,18-24,6,1,18,Flexible,Tier1_City,1,4,5,4,2,2,2,5.95,Tech,3,4,5,4,5,0,2,4,2,5,1,0,5,5,42.92
Biology,Psychologist,2.893605798489134,2,2,2,1,2,0,4,1,3,0,3,0,0,0,Science,Masters,25-30,0,1,10,Remote,Tier1_City,5,1,4,2,5,5,4,40.18,Healthcare,4,2,1,2,5,0,4,2,5,1,0,0,3,5,48.68
Education,Civil Engineer,2.952266007683776,4,2,1,1,6,0,4,2,2,0,2,1,2,0,Arts,Masters,18-24,10,0,0,Remote,Tier2_City,5,4,0,2,1,5,1,32.06,Other,5,5,5,3,4,4,5,4,5,2,1,0,4,4,60.67
Art,Financial Controller,4.729710954596292,6,1,3,0,3,1,1,3,1,3,3,3,4,0,Arts,Bachelors,25-30,1,1,17,Remote,Any,1,1,3,2,3,0,1,42.23,Manufacturing,5,1,3,5,5,0,2,4,1,2,1,0,2,1,45.0
Medicine,Artist,4.148507851090068,6,1,1,1,8,1,4,0,3,3,0,0,2,0,Science,Bachelors,36-40,4,0,0,Office,Tier1_City,4,5,1,4,4,0,4,26.65,Education,2,1,1,2,5,2,3,5,5,1,0,0,3,3,49.66
Engineering,Advertising Manager,4.118662878435035,3,2,3,1,3,0,0,3,0,2,4,0,3,1,Science,PhD,18-24,7,0,0,Hybrid,Tier1_City,4,4,2,1,5,0,1,49.29,Tech,5,5,2,3,0,0,3,5,5,2,1,0,2,4,61.86
Business,Acoustics Specialist,3.1643988481210528,8,2,3,1,3,0,3,2,2,4,1,3,0,1,Commerce,Bachelors,31-35,5,0,0,Remote,Tier1_City,3,3,4,5,2,5,1,48.24,Other,4,2,4,1,3,5,3,1,4,2,0,0,4,2,49.81
Physics,Quantum Physicist,2.7378265800652164,8,2,2,0,7,0,3,3,1,3,3,2,2,0,Science,Masters,25-30,13,0,0,Remote,Tier2_City,1,5,5,3,3,3,2,15.77,Finance,3,1,5,1,0,5,5,1,3,4,1,0,3,2,66.63
Computer Science,AI Researcher,4.837271147776351,4,0,0,0,4,0,3,1,2,0,1,0,2,0,Science,Bachelors,18-24,13,0,0,Hybrid,Tier1_City,4,5,4,1,5,3,1,21.19,Manufacturing,2,2,5,4,1,3,3,3,1,1,1,1,4,3,45.27
Medicine,Animator,4.62117641928416,0,2,3,1,7,0,2,2,2,1,0,4,1,1,Science,Bachelors,25-30,12,1,49,Flexible,Tier1_City,2,2,0,3,3,2,1,38.38,Other,4,4,3,5,0,0,4,4,1,2,1,1,3,2,52.36
Biology,Counselor,2.673185053634445,5,2,2,0,5,1,3,0,2,4,0,0,1,0,Science,Bachelors,25-30,12,1,11,Hybrid,Tier1_City,1,3,1,5,5,3,4,39.5,Education,3,4,4,4,0,1,3,3,1,3,0,0,1,1,52.17
Psychology,Dentist,4.7699840070111,0,0,3,1,1,0,0,1,2,4,2,0,0,1,Arts,Bachelors,18-24,6,0,0,Remote,Tier2_City,4,1,1,4,3,0,1,45.8,Healthcare,4,5,1,2,5,0,2,1,3,2,1,0,2,5,46.0
Medicine,Urban Planner,3.786138758396752,8,1,4,0,9,1,3,4,0,3,2,1,0,1,Science,Bachelors,36-40,14,0,0,Hybrid,Tier2_City,5,5,2,2,0,1,3,33.67,Healthcare,5,3,5,5,2,1,3,2,5,2,1,1,4,4,62.21
Music,Entrepreneur,3.810030614129332,1,2,2,1,8,1,2,2,1,0,2,0,0,1,Arts,Masters,40+,14,0,0,Hybrid,Any,2,1,4,2,3,0,3,25.33,Tech,4,2,2,2,3,5,2,3,5,5,1,0,5,3,59.17
Art,Forensic Psychologist,4.744994622425117,0,2,1,1,7,0,1,4,3,4,1,4,1,1,Arts,Bachelors,18-24,2,0,0,Hybrid,Tier2_City,3,5,0,4,0,5,4,20.75,Education,2,3,2,3,4,4,1,1,4,2,0,1,2,4,51.32
Art,Chemical Engineer,3.6521273841261177,4,0,4,0,4,0,2,2,3,0,4,2,3,0,Arts,Bachelors,18-24,5,0,0,Hybrid,Tier1_City,4,3,1,1,1,1,3,22.7,Tech,4,3,3,5,5,2,5,5,4,1,1,1,2,5,49.55
Engineering,Lawyer,3.387518860323431,2,0,0,0,0,1,3,4,0,1,3,0,0,0,Science,Bachelors,25-30,8,0,0,Office,Tier3_City,5,5,4,1,0,2,2,42.97,Manufacturing,1,2,5,1,4,3,4,4,1,5,1,1,4,2,50.09
Computer Science,Forensic Psychologist,3.3866656041899184,5,0,3,0,0,0,3,2,1,2,0,1,0,1,Science,Masters,31-35,2,1,26,Flexible,Tier1_City,2,1,4,3,3,4,4,49.06,Tech,5,3,3,3,2,2,3,3,3,1,0,1,2,4,39.51
Education,Music Therapist,2.552554196536707,2,1,0,0,8,1,0,3,2,3,0,3,2,1,Arts,Bachelors,25-30,13,1,35,Remote,Tier2_City,2,1,3,4,4,3,1,5.44,Finance,4,1,4,3,5,2,3,1,5,5,1,0,4,1,63.15
Law,Paralegal,4.448050727202993,9,2,1,1,2,0,2,0,2,2,3,2,2,1,Arts,Masters,18-24,12,0,0,Office,Tier1_City,3,3,2,1,4,3,3,30.27,Tech,3,4,2,2,2,4,3,3,3,5,0,0,1,2,65.6
Business,AI Researcher,4.340029063069185,3,2,3,1,4,0,0,0,3,4,2,0,0,0,Commerce,Bachelors,25-30,12,0,0,Flexible,Tier1_City,5,1,1,4,1,5,2,27.44,Tech,5,5,2,4,5,0,3,3,5,5,0,0,2,2,58.78
Education,Marketing Specialist,4.095327299613581,0,0,4,1,4,1,1,1,0,4,0,3,1,0,Arts,High School,40+,12,0,0,Hybrid,Tier2_City,4,4,3,5,3,0,4,20.68,Manufacturing,3,2,3,2,5,5,2,1,3,4,0,1,5,1,47.81
Law,Art Director,3.764650596548543,9,2,0,0,5,1,1,2,2,3,2,1,3,0,Arts,Bachelors,25-30,5,0,0,Remote,Tier1_City,1,5,2,2,0,0,4,43.02,Education,2,5,4,3,4,2,5,1,3,5,1,0,4,4,49.7
Architecture,Acoustics Specialist,3.335671920103907,5,2,3,0,1,0,4,4,0,2,2,2,0,0,Interdisciplinary,Masters,25-30,6,0,0,Office,Tier1_City,2,4,3,2,4,1,1,30.06,Other,1,4,1,5,5,3,2,4,1,4,1,1,1,2,56.96
Music,Nuclear Physicist,4.535389901532232,7,1,1,1,0,1,0,1,3,1,0,4,1,1,Arts,Bachelors,40+,4,0,0,Office,Tier1_City,4,2,1,2,5,3,5,17.72,Other,4,5,4,1,0,1,3,3,4,3,0,1,1,5,43.81
Law,Aerospace Engineer,4.476998459487188,9,2,0,1,3,0,0,4,0,4,3,0,2,1,Arts,High School,31-35,9,0,0,Remote,Tier3_City,1,2,0,4,2,5,3,23.87,Finance,5,2,3,3,3,5,2,2,2,2,0,1,3,1,46.27
Chemistry,Microbiologist,3.1927070135399185,1,0,0,0,7,1,0,4,1,4,4,0,1,1,Science,Bachelors,31-35,12,1,35,Hybrid,Tier1_City,4,5,3,4,3,2,2,19.77,Tech,4,5,3,4,4,5,3,3,3,5,1,1,4,2,66.83
Music,Artist,2.8569602752373684,7,1,2,1,2,1,0,4,3,4,2,2,4,1,Arts,Masters,25-30,7,0,0,Hybrid,Tier2_City,4,1,3,3,5,0,4,23.21,Manufacturing,4,3,4,4,0,4,1,5,2,3,1,0,4,2,64.5
Engineering,Chemist,2.596156890982174,3,2,0,1,2,0,2,2,1,1,4,2,4,0,Science,Bachelors,40+,7,1,8,Remote,Tier3_City,2,3,4,2,5,3,3,6.35,Manufacturing,5,3,3,5,0,4,2,1,1,1,0,1,4,1,49.91
Music,Graphic Designer,3.298018255399673,0,0,0,1,9,1,3,3,1,4,4,2,4,1,Arts,Bachelors,31-35,5,0,0,Office,Tier1_City,2,2,5,3,3,4,2,8.26,Other,1,4,2,4,1,2,5,5,3,2,0,1,3,2,58.14
Computer Science,Education Administrator,4.939061499975228,8,2,4,1,6,1,2,0,0,0,4,4,2,0,Science,High School,36-40,6,1,21,Office,Tier3_City,4,1,1,2,2,5,2,32.31,Manufacturing,1,3,3,5,2,5,1,5,1,3,1,1,1,5,43.49
Engineering,Advertising Manager,4.347038479036714,2,2,3,0,2,0,1,1,1,3,4,2,1,1,Science,Bachelors,31-35,2,0,0,Flexible,Tier3_City,4,3,3,3,4,1,4,35.15,Education,2,5,1,4,5,5,4,3,2,4,1,1,5,1,45.04
Physics,Music Teacher,4.375782517411389,0,0,3,1,7,0,1,2,0,3,3,3,1,0,Science,Masters,31-35,12,0,0,Hybrid,Any,3,5,5,3,2,0,3,32.92,Tech,5,1,2,2,5,0,2,3,5,5,1,1,3,3,69.33
Biology,Brand Manager,3.329292685552052,6,2,3,1,0,1,3,1,1,3,2,0,2,0,Science,Masters,25-30,6,0,0,Hybrid,Tier2_City,1,1,0,5,1,0,2,38.86,Healthcare,5,5,5,1,4,2,2,3,3,1,1,1,4,4,46.96
Medicine,Physician Assistant,2.570074700578065,0,0,1,0,7,1,2,4,1,3,4,2,1,1,Science,Bachelors,25-30,6,0,0,Hybrid,Tier1_City,5,4,3,3,0,2,4,47.35,Other,3,1,2,1,4,1,4,3,1,5,0,1,4,2,50.79
Marketing,Curriculum Developer,3.973951058469796,3,2,4,1,7,1,4,2,2,3,1,2,3,0,Commerce,Bachelors,31-35,3,0,0,Remote,Tier3_City,5,5,2,4,0,0,3,43.45,Other,3,5,2,3,5,2,5,4,2,2,1,0,4,1,46.24
Business,Musician,2.7325641645895624,7,1,4,1,2,1,2,1,4,1,0,1,2,1,Commerce,Bachelors,25-30,9,1,21,Office,Tier1_City,3,2,0,3,5,5,3,22.67,Finance,3,1,2,3,3,5,1,5,3,1,0,0,5,4,50.02
Education,Biotechnologist,3.0353356316981106,7,0,1,1,7,0,1,4,2,1,4,0,3,0,Arts,Bachelors,25-30,13,1,50,Office,Tier1_City,4,5,0,2,4,3,4,13.22,Healthcare,1,1,4,2,5,0,4,2,2,5,0,1,4,4,59.76
Medicine,Aerospace Engineer,3.444455379594358,4,0,2,0,4,0,1,3,2,2,2,2,3,1,Science,Bachelors,18-24,12,0,0,Office,Tier1_City,4,5,3,3,2,3,3,17.66,Education,2,2,5,2,5,4,5,4,5,5,1,0,3,3,64.58
Physics,Analytical Chemist,3.679200698441883,6,0,1,1,4,0,1,1,4,2,4,3,0,1,Science,Masters,36-40,3,0,0,Office,Tier3_City,3,3,3,1,5,3,5,30.62,Other,2,2,1,1,4,3,1,5,3,5,0,0,4,3,61.17
Art,Investment Banker,3.434889102231419,6,0,3,1,3,1,2,0,1,3,0,2,0,0,Arts,PhD,18-24,13,0,0,Hybrid,Tier1_City,5,2,4,2,3,4,2,43.24,Tech,4,5,2,3,0,4,5,1,1,4,0,1,1,5,58.29
Law,Art Therapist,3.1995601521718786,0,0,4,0,2,0,1,0,0,0,3,0,0,0,Arts,PhD,36-40,2,1,25,Remote,Tier2_City,2,3,1,1,5,4,2,35.98,Healthcare,2,3,4,3,0,0,5,3,1,2,0,1,1,4,35.81
Law,Musician,2.915606856955153,6,0,3,0,3,1,4,4,3,0,1,4,3,1,Arts,Masters,31-35,9,1,45,Flexible,Tier1_City,2,5,4,2,3,0,3,28.52,Healthcare,3,2,3,1,3,4,3,3,1,1,0,0,1,3,55.09
Computer Science,School Counselor,3.316301936980407,5,2,0,0,6,0,4,3,2,3,3,2,2,0,Science,Masters,18-24,6,0,0,Hybrid,Tier2_City,4,1,2,4,3,4,4,31.29,Other,5,1,5,5,0,5,2,3,1,2,1,0,4,1,56.33
Music,School Counselor,3.4392607474653074,5,2,3,0,3,1,1,2,1,2,0,1,4,0,Arts,Masters,25-30,4,0,0,Flexible,Tier2_City,1,4,1,4,1,4,1,27.83,Healthcare,4,5,1,2,0,2,1,5,3,2,1,1,3,5,38.87
Business,Paralegal,2.723602191871741,3,1,1,1,5,0,3,4,3,1,4,3,1,0,Commerce,Bachelors,25-30,2,1,34,Hybrid,Tier1_City,5,4,4,4,1,2,3,48.67,Finance,1,3,5,3,4,2,3,1,5,3,0,1,1,4,59.21
Education,Software Developer,3.978635742139777,6,0,0,0,0,1,2,1,4,1,3,1,1,1,Arts,Masters,25-30,5,0,0,Remote,Tier1_City,1,3,4,1,3,4,1,41.36,Tech,2,5,1,1,2,2,1,1,5,2,1,0,1,2,54.07
Physics,Software Developer,3.6399495834668567,1,2,0,0,8,1,2,0,0,1,1,4,4,0,Science,Bachelors,25-30,11,0,0,Flexible,Tier1_City,4,1,3,5,4,1,3,39.72,Manufacturing,5,1,1,2,4,2,3,4,1,3,0,1,2,1,45.81
Marketing,Financial Controller,4.115059694006401,5,1,3,1,7,1,4,2,4,3,3,1,3,0,Commerce,Bachelors,18-24,5,0,0,Office,Tier1_City,5,4,4,2,1,1,1,27.31,Tech,3,2,3,1,1,0,1,4,1,5,1,1,5,1,57.37
Medicine,Dentist,2.865954970245759,9,2,4,0,0,1,0,2,3,4,1,0,0,1,Science,Masters,40+,5,1,58,Office,Tier2_City,2,1,3,4,1,1,3,18.6,Other,1,2,1,5,3,1,2,5,1,5,1,0,4,1,49.29
Physics,Inorganic Chemist,3.143063583540658,3,1,0,0,3,1,1,2,1,3,4,0,3,0,Science,Bachelors,18-24,1,0,0,Remote,Any,2,3,0,2,0,0,4,3.92,Healthcare,1,4,3,4,5,2,5,4,1,1,0,0,4,5,33.11
Chemistry,Sound Engineer,2.911552474409085,6,0,3,0,9,0,4,0,2,3,2,3,2,1,Science,Bachelors,31-35,12,1,35,Flexible,Tier2_City,1,2,1,1,5,3,1,5.04,Tech,2,4,2,3,0,4,2,4,3,2,1,1,4,5,60.35
Medicine,Art Director,4.092469936182519,1,0,1,1,3,1,1,0,3,0,3,0,0,1,Science,PhD,25-30,10,0,0,Hybrid,Tier3_City,5,1,3,5,0,2,5,4.42,Manufacturing,5,5,5,2,4,0,1,3,5,3,0,0,1,2,57.18
Law,Physical Chemist,3.437627074504089,6,0,0,1,4,0,4,4,4,1,2,2,1,0,Arts,Bachelors,31-35,9,0,0,Hybrid,Any,4,1,5,1,4,0,4,49.08,Finance,3,5,1,1,4,5,2,4,4,3,1,1,3,2,63.78
Education,Risk Analyst,2.999724715168783,3,1,2,1,3,1,4,2,2,2,1,1,2,1,Arts,Bachelors,25-30,11,0,0,Flexible,Tier2_City,3,2,5,2,1,3,3,8.38,Tech,3,3,3,1,5,0,1,4,4,5,0,0,1,3,61.19
Music,Physicist,3.543655341552962,4,2,3,0,5,1,3,3,3,4,1,4,4,0,Arts,PhD,31-35,6,1,30,Office,Tier1_City,3,5,5,5,1,2,1,9.68,Tech,3,2,2,2,5,3,4,4,5,4,0,1,3,2,67.91
Music,School Counselor,2.976015020714417,3,2,3,1,9,0,2,1,4,2,4,3,3,1,Arts,Masters,31-35,12,0,0,Remote,Any,3,5,5,5,2,2,2,25.76,Finance,3,2,5,3,0,2,4,5,1,3,0,0,4,3,60.65
Medicine,Clinical Psychologist,2.9759002957378224,1,0,3,1,7,1,0,1,1,0,2,2,0,1,Science,Bachelors,31-35,6,0,0,Hybrid,Tier2_City,4,5,4,1,4,2,4,25.63,Finance,2,4,2,3,3,4,1,4,4,4,1,0,2,1,46.21
Medicine,Education Administrator,3.631195508743867,6,1,1,0,4,0,0,4,4,4,4,4,1,1,Science,Bachelors,18-24,9,0,0,Hybrid,Any,3,3,5,4,5,1,1,46.24,Other,2,1,4,1,4,1,4,2,3,1,0,1,3,4,62.08
Art,Composer,3.179899414765623,9,0,2,0,0,0,1,2,0,0,2,4,0,0,Arts,Bachelors,31-35,11,0,0,Flexible,Tier2_City,1,5,3,2,5,1,4,6.46,Healthcare,5,1,5,3,2,1,5,2,1,5,0,0,5,3,56.27
Physics,Data Scientist,3.2310629256666177,2,1,0,0,8,0,3,4,1,4,2,2,4,0,Science,Masters,25-30,3,1,34,Remote,Tier3_City,2,3,0,3,5,1,1,47.99,Healthcare,4,4,3,4,5,5,1,4,5,4,1,1,2,1,65.17
Art,School Psychologist,3.744071666518497,2,2,1,0,6,1,1,1,3,2,3,2,3,1,Arts,Masters,18-24,10,0,0,Office,Any,3,2,2,3,4,2,2,13.17,Other,2,5,1,5,0,4,3,2,5,2,1,1,3,2,67.16
Education,Musician,3.318218409745749,9,1,4,0,7,0,3,4,1,3,2,4,3,1,Arts,Bachelors,25-30,5,1,24,Office,Tier3_City,2,1,2,1,2,5,5,48.6,Finance,3,2,3,5,3,0,4,3,2,3,0,0,1,1,54.98
Architecture,Conductor,2.949804967816868,1,0,0,1,9,1,0,3,2,4,3,4,1,1,Interdisciplinary,Bachelors,25-30,3,1,20,Remote,Tier2_City,1,4,0,2,2,2,2,28.44,Manufacturing,5,2,3,4,1,4,5,5,3,5,1,1,5,1,57.8
Computer Science,Game Developer,3.548139819749508,0,2,4,1,2,0,0,4,1,1,2,3,3,0,Science,High School,25-30,3,0,0,Remote,Tier2_City,5,4,4,2,0,1,3,33.64,Healthcare,3,2,3,3,5,3,1,4,3,5,1,0,2,1,39.5
Business,Conductor,4.248116659411518,2,1,1,0,7,1,0,1,1,3,4,4,4,1,Commerce,PhD,31-35,5,1,40,Hybrid,Tier3_City,5,3,1,1,4,2,4,17.84,Manufacturing,2,1,5,1,0,0,3,2,2,2,1,0,3,4,54.36
Business,Conductor,4.609981755408819,8,1,4,1,1,0,3,0,3,4,4,1,4,0,Commerce,Bachelors,25-30,8,0,0,Office,Tier3_City,4,3,1,2,4,1,5,31.76,Finance,5,5,5,3,1,5,5,3,2,3,1,0,4,4,62.17
Medicine,Dentist,3.8348831548346207,8,2,4,1,7,0,0,0,3,1,4,2,0,0,Science,Masters,25-30,11,0,0,Hybrid,Tier1_City,2,1,3,4,2,1,4,36.41,Tech,3,1,4,2,0,3,4,3,2,5,0,1,5,3,60.1
Business,Graphic Designer,3.044404612092606,6,0,3,1,2,1,1,4,2,1,0,0,1,1,Commerce,Bachelors,18-24,12,0,0,Office,Tier2_City,4,2,2,1,3,1,1,3.49,Other,4,5,2,2,4,1,1,4,3,3,0,1,2,3,52.18
Finance,Manager,2.584339715231,2,0,0,0,6,1,0,0,2,0,3,4,4,0,Commerce,Masters,31-35,14,1,8,Hybrid,Tier2_City,3,1,0,4,3,5,3,4.61,Finance,1,4,3,3,3,5,4,3,2,2,0,0,3,3,51.47
Psychology,Education Administrator,4.959649575463882,2,0,2,1,0,0,4,0,2,0,0,4,0,1,Arts,PhD,25-30,6,0,0,Office,Tier1_City,4,3,4,2,0,3,3,49.36,Finance,1,5,4,4,2,2,3,3,3,3,1,1,3,4,55.45
Music,Architectural Technologist,3.953871320222308,3,0,0,1,9,1,2,3,1,0,3,2,3,0,Arts,Masters,25-30,1,0,0,Remote,Tier1_City,1,1,0,1,3,2,4,24.51,Education,3,1,4,2,1,3,1,4,2,3,0,0,2,3,42.89
Architecture,Nuclear Physicist,2.6556556719,3,0,2,1,2,0,3,3,1,3,3,4,0,0,Interdisciplinary,Bachelors,31-35,13,1,6,Remote,Tier1_City,4,3,2,2,3,0,3,46.98,Finance,1,2,5,5,1,4,5,2,4,5,1,1,5,2,73.92
Chemistry,Analytical Chemist,2.644874422798244,4,2,4,1,2,0,2,1,3,3,3,2,4,0,Science,Masters,25-30,5,1,40,Office,Any,3,4,0,1,3,1,4,37.31,Healthcare,4,1,2,1,0,2,4,1,5,4,1,0,1,3,59.66
Art,Human Resources Specialist,4.557500606179275,5,0,1,0,2,1,2,1,1,1,3,0,0,1,Arts,Masters,25-30,13,0,0,Office,Tier1_City,3,1,0,2,1,5,1,20.53,Tech,4,4,4,4,1,1,2,5,3,5,1,1,2,5,60.21
Psychology,Art Director,3.525021298319374,6,1,3,0,9,0,4,3,1,2,3,1,2,1,Arts,Bachelors,25-30,4,0,0,Hybrid,Tier2_City,1,2,0,4,0,0,1,10.09,Manufacturing,3,2,1,2,0,4,5,4,1,2,0,0,1,1,42.42
Chemistry,Education Administrator,3.809529072412632,8,2,0,1,6,0,2,0,3,4,2,3,3,0,Science,Masters,31-35,5,0,0,Hybrid,Tier3_City,2,4,3,4,2,3,4,48.97,Education,4,1,4,1,0,3,4,2,1,2,0,1,3,4,49.54
Architecture,Software Developer,3.580056302017192,0,1,2,1,1,0,2,2,4,4,4,1,4,1,Interdisciplinary,Masters,31-35,12,0,0,Hybrid,Tier1_City,5,2,4,2,3,2,2,30.47,Other,1,2,5,5,1,4,2,3,2,1,1,1,3,1,66.68
Law,AI Researcher,2.826289347761983,0,2,4,1,9,0,2,1,0,2,1,0,4,0,Arts,Masters,25-30,7,0,0,Remote,Tier1_City,1,2,1,1,5,5,2,12.04,Healthcare,3,4,3,2,1,2,3,1,2,2,0,1,5,2,46.95
Business,Special Education Teacher,4.348684822333262,8,1,0,0,8,1,1,2,4,4,4,1,0,0,Commerce,Masters,18-24,7,0,0,Office,Any,5,3,4,3,1,1,1,35.04,Tech,1,5,5,2,4,4,1,3,3,1,0,1,1,4,59.04
Psychology,Surgeon,3.511922749547145,3,0,1,1,2,0,2,1,1,1,2,1,4,1,Arts,Bachelors,18-24,14,0,0,Hybrid,Tier3_City,1,2,2,4,3,1,5,7.33,Manufacturing,4,5,5,1,4,3,3,1,4,2,0,0,2,2,51.02
Music,Advertising Manager,4.554054572623,7,2,3,1,3,0,1,0,0,3,2,1,3,1,Arts,Bachelors,31-35,2,1,34,Hybrid,Tier1_City,1,5,1,4,1,1,2,43.8,Tech,4,3,2,1,5,0,3,1,1,5,0,1,3,5,33.9
Computer Science,Civil Engineer,4.462798070663935,0,1,3,0,6,1,1,3,3,0,1,3,1,1,Science,Bachelors,36-40,8,0,0,Hybrid,Tier3_City,4,2,5,3,0,5,4,7.24,Healthcare,5,2,1,3,4,5,1,2,3,3,1,0,4,4,50.33
Chemistry,Dentist,3.035985347872199,5,1,3,0,9,1,2,4,2,2,4,4,2,0,Science,PhD,25-30,5,0,0,Office,Tier3_City,4,1,3,2,5,0,1,14.1,Other,2,4,1,2,3,1,5,4,1,4,0,0,2,3,66.49
Finance,Urban Planner,3.551933720095492,1,1,1,1,3,1,2,3,2,0,4,3,0,0,Commerce,Masters,18-24,6,0,0,Hybrid,Tier3_City,4,3,1,1,5,3,3,7.3,Other,2,1,2,5,2,1,4,2,5,2,0,0,5,1,63.51
Music,Physicist,3.369960387741637,9,0,1,0,4,1,4,3,4,2,4,3,3,1,Arts,Masters,31-35,8,0,0,Hybrid,Tier1_City,1,3,1,2,5,2,3,7.88,Tech,3,1,2,1,4,2,3,4,2,3,1,0,4,1,67.4
Engineering,Illustrator,4.793046372750578,5,0,0,1,0,0,0,4,3,2,4,3,3,0,Science,Bachelors,36-40,14,0,0,Hybrid,Tier2_City,4,5,1,5,3,3,2,27.62,Finance,1,3,4,4,4,4,5,2,3,1,0,1,3,1,57.95
Chemistry,Art Therapist,2.684533257373665,1,0,0,0,6,0,4,2,3,1,4,3,1,0,Science,Bachelors,36-40,13,0,0,Office,Tier2_City,1,3,0,4,1,1,5,35.29,Tech,2,1,1,2,0,4,2,1,2,5,1,1,3,2,64.74
Biology,Biochemist,3.7324998296121104,5,2,2,0,3,1,2,2,4,0,1,3,3,0,Science,Masters,31-35,12,0,0,Hybrid,Tier1_City,4,3,2,5,5,3,2,40.06,Finance,3,4,5,4,2,3,3,2,3,2,1,1,2,4,60.63
Law,Music Teacher,3.830604628692783,4,0,4,0,6,0,3,1,0,4,0,2,1,0,Arts,Bachelors,36-40,6,0,0,Remote,Tier1_City,5,4,5,4,4,0,5,35.67,Other,4,4,4,2,1,1,5,5,2,4,0,0,5,1,45.94
Physics,Financial Analyst,4.093736373012563,6,1,1,0,0,1,3,2,0,3,0,4,1,0,Science,Bachelors,18-24,9,0,0,Flexible,Tier1_City,2,4,3,4,4,4,2,20.08,Healthcare,2,5,1,1,3,1,5,4,2,5,1,0,3,2,58.53
Chemistry,Legal Secretary,4.956243086212563,1,2,2,0,8,1,0,4,0,3,0,0,4,1,Science,Masters,18-24,8,0,0,Hybrid,Tier2_City,4,4,5,5,1,4,3,29.19,Education,1,2,3,3,1,2,4,4,3,4,0,1,3,5,50.6
Computer Science,Curriculum Developer,2.8883476973020112,8,2,2,1,4,0,2,3,4,4,2,2,1,0,Science,High School,18-24,0,0,0,Remote,Tier1_City,3,5,2,5,3,2,5,46.6,Finance,5,2,5,2,0,1,3,2,5,2,0,1,4,3,50.05
Engineering,Aerospace Engineer,4.860228292965659,0,1,2,1,8,1,0,0,2,3,2,1,2,1,Science,Bachelors,31-35,12,0,0,Office,Tier1_City,2,3,0,2,3,2,3,21.22,Other,5,1,5,1,3,3,1,1,1,1,1,0,3,4,41.37
Marketing,Animator,2.851526167260576,5,2,1,1,4,1,1,2,3,2,0,1,3,1,Commerce,Bachelors,18-24,0,0,0,Office,Tier3_City,3,3,3,5,0,3,4,14.86,Tech,2,2,4,1,4,3,4,1,3,5,0,0,3,3,36.59
Marketing,Interior Designer,3.8135260586611968,4,0,4,1,4,0,4,4,4,3,3,4,1,0,Commerce,Bachelors,25-30,2,0,0,Hybrid,Tier2_City,2,3,5,2,0,2,4,27.41,Other,5,3,1,1,2,5,1,3,5,5,1,1,5,4,65.72
Biology,School Counselor,2.9051478225959,1,2,3,0,5,0,1,3,2,1,2,2,4,0,Science,PhD,25-30,12,1,25,Hybrid,Tier1_City,4,2,0,2,5,5,1,16.97,Tech,3,2,2,4,2,5,1,2,4,3,0,1,5,1,69.3
Architecture,Financial Controller,2.6488384563510583,6,1,1,1,5,1,0,0,0,2,2,2,3,0,Interdisciplinary,Bachelors,25-30,8,0,0,Remote,Tier3_City,5,3,3,2,2,0,3,15.31,Tech,1,1,3,1,4,1,5,3,2,3,1,1,1,5,41.23
Art,Paralegal,2.5783137465268497,4,2,2,1,1,0,0,3,4,2,2,1,1,1,Arts,Bachelors,36-40,0,1,47,Hybrid,Tier2_City,4,3,3,4,0,1,3,39.6,Other,4,2,5,4,1,2,1,1,2,4,1,0,4,3,41.36
Chemistry,Landscape Architect,3.763856544473827,6,1,4,0,5,0,2,2,2,3,4,2,3,0,Science,Bachelors,18-24,0,1,43,Remote,Tier2_City,1,1,4,4,3,1,1,44.87,Healthcare,1,4,2,5,1,3,1,3,1,5,0,1,4,4,51.45
Biology,Landscape Architect,3.486179734759828,3,1,2,1,6,0,1,3,3,3,4,1,1,1,Science,Masters,25-30,4,1,38,Hybrid,Tier1_City,3,1,0,5,2,3,4,26.61,Manufacturing,4,4,2,3,4,5,4,4,1,1,0,0,5,5,49.38
Law,Physical Chemist,4.490580916252741,6,2,3,0,1,0,4,0,2,1,3,4,4,1,Arts,Bachelors,31-35,7,0,0,Hybrid,Tier1_City,2,3,2,4,0,1,4,39.65,Tech,5,5,2,1,4,2,3,4,2,2,0,0,5,2,46.38
Music,Marketing Manager,4.085386980299955,0,1,2,1,6,1,4,1,0,3,3,0,1,1,Arts,Masters,18-24,1,1,10,Hybrid,Tier2_City,5,2,5,5,1,3,5,11.79,Tech,3,5,2,5,2,4,4,5,2,3,1,0,3,3,46.63
Business,Risk Analyst,3.821130879529491,4,2,3,1,3,0,1,0,1,0,4,3,1,0,Commerce,High School,31-35,3,1,11,Hybrid,Any,3,2,0,4,4,2,5,28.74,Finance,4,5,4,1,1,1,5,4,3,4,1,0,4,1,41.26
Medicine,Composer,3.5312420379113787,5,2,2,1,7,1,0,3,0,4,3,3,2,1,Science,High School,36-40,14,0,0,Hybrid,Tier1_City,5,5,5,1,0,2,4,32.9,Education,5,5,5,5,5,4,3,5,1,4,0,0,2,1,48.96
Art,Biotechnologist,3.822759010117645,4,2,3,1,7,1,0,3,3,3,4,4,0,0,Arts,Bachelors,36-40,5,0,0,Hybrid,Tier2_City,3,5,0,1,0,5,2,26.06,Other,4,2,2,1,3,4,4,1,3,2,1,1,2,2,49.07
Law,Industrial-Organizational Psychologist,2.984155503737336,2,2,3,1,8,1,1,1,0,1,4,2,4,1,Arts,Masters,36-40,14,1,24,Remote,Tier1_City,4,3,0,5,1,5,3,8.49,Tech,2,1,2,3,3,1,3,5,3,5,0,0,4,2,61.17
Medicine,Acoustics Specialist,3.060721920855643,2,1,4,1,9,1,2,2,0,3,1,0,2,1,Science,Masters,25-30,0,0,0,Remote,Tier1_City,1,4,4,4,3,0,5,37.5,Healthcare,1,2,1,1,0,4,2,2,2,5,0,0,1,3,43.07
Architecture,Education Administrator,4.995818026621206,5,1,0,0,7,0,4,1,1,3,1,1,1,0,Interdisciplinary,Bachelors,25-30,14,0,0,Remote,Tier1_City,3,2,4,4,5,1,2,42.44,Manufacturing,3,1,5,4,0,1,4,2,1,5,0,1,4,2,59.59
Physics,Industrial-Organizational Psychologist,3.348844065102335,6,1,0,0,8,1,1,0,4,0,4,4,3,1,Science,Bachelors,18-24,3,1,39,Office,Any,5,4,4,2,1,5,5,32.86,Manufacturing,5,1,3,1,0,5,3,4,5,4,0,0,4,3,53.28
Biology,Lawyer,3.465167865375862,9,0,2,1,9,0,4,1,3,3,2,2,4,0,Science,PhD,25-30,3,0,0,Office,Tier1_City,4,5,4,3,5,0,1,10.95,Manufacturing,3,1,2,2,1,2,1,5,1,1,1,1,2,5,50.29
Law,Animator,3.559086585138324,8,1,4,1,1,1,3,1,0,4,2,1,2,1,Arts,Bachelors,18-24,8,0,0,Office,Tier1_City,2,2,0,5,0,4,3,6.5,Healthcare,1,1,4,4,3,4,2,2,3,3,1,0,2,4,51.42
Music,Principal,2.551977696510397,7,2,2,1,6,0,2,0,3,0,2,0,2,0,Arts,Masters,25-30,8,0,0,Hybrid,Tier3_City,2,4,2,3,3,5,5,17.18,Manufacturing,4,4,2,5,1,4,1,5,3,5,0,1,1,2,58.95
Computer Science,Financial Analyst,4.128289413233196,3,1,3,1,1,1,3,2,2,0,4,0,0,0,Science,Bachelors,36-40,5,0,0,Hybrid,Tier1_City,4,3,1,3,2,0,4,4.74,Other,4,1,2,1,4,3,2,1,2,1,0,1,1,5,44.47
Computer Science,Legal Secretary,4.396405323101493,1,2,2,0,2,0,1,4,1,3,1,4,3,0,Science,PhD,25-30,7,1,49,Office,Tier1_City,2,4,0,5,0,3,1,42.44,Manufacturing,3,2,2,1,2,4,5,3,4,2,0,1,4,2,60.23
Music,Mechanical Engineer,4.691086041715181,3,1,3,1,0,0,0,1,2,0,2,2,2,0,Arts,Masters,25-30,11,0,0,Hybrid,Tier1_City,5,5,5,4,1,3,1,36.04,Finance,4,1,5,1,5,0,3,2,1,2,1,0,2,5,44.51
Marketing,Urban Planner,4.92676118114602,3,0,2,1,6,0,4,0,2,1,0,0,4,1,Commerce,PhD,25-30,9,1,57,Remote,Any,1,2,2,5,2,0,4,29.49,Manufacturing,4,4,5,2,0,5,2,5,5,2,1,1,5,5,55.72
Education,Astronomer,4.4105173237900805,6,2,2,0,8,0,0,0,3,3,3,1,3,0,Arts,Masters,25-30,3,0,0,Flexible,Tier1_City,4,2,1,3,4,2,1,44.81,Finance,4,2,2,3,4,4,3,2,1,4,0,1,3,3,47.81
Music,Financial Controller,3.976135976255508,1,2,0,1,6,1,4,4,0,4,2,1,2,0,Arts,Bachelors,40+,9,0,0,Remote,Any,1,2,1,4,2,4,3,8.17,Finance,2,3,4,3,4,4,5,2,1,5,1,0,1,1,60.32
Physics,Construction Manager,4.770299765908821,6,2,1,1,5,1,1,3,3,2,4,0,0,0,Science,PhD,25-30,7,0,0,Hybrid,Tier1_City,1,3,4,1,1,0,5,36.58,Finance,5,2,3,4,5,3,2,1,3,2,1,0,5,5,61.52
Education,Civil Engineer,3.7630065471512046,7,1,4,0,5,1,4,1,4,0,2,4,4,1,Arts,Bachelors,31-35,14,0,0,Hybrid,Tier1_City,4,2,1,5,2,5,1,9.89,Healthcare,5,4,1,4,2,0,3,2,2,4,1,0,1,3,61.52
Biology,Biochemist,3.933927941584852,6,1,2,0,0,0,3,2,4,1,0,1,2,0,Science,Bachelors,25-30,2,1,29,Office,Any,3,4,5,5,1,2,3,5.86,Tech,1,4,3,2,3,2,4,3,5,3,0,0,5,2,47.69
Art,Entrepreneur,3.130623595701958,9,1,3,1,7,0,1,3,0,3,1,0,3,1,Arts,Masters,18-24,1,0,0,Flexible,Tier2_City,5,1,5,4,0,0,4,9.25,Education,4,5,4,2,3,1,3,2,5,1,0,1,5,2,40.3
Psychology,Principal,4.305830006741974,3,0,4,0,8,1,3,2,2,4,1,4,2,1,Arts,Masters,25-30,5,1,52,Flexible,Tier1_City,4,1,2,1,3,1,5,47.69,Other,3,3,4,2,4,4,3,1,1,1,1,1,4,2,48.28
Engineering,Actuary,3.46670889356985,7,1,3,0,3,1,2,3,0,0,3,1,3,0,Science,PhD,36-40,4,0,0,Hybrid,Tier2_City,5,3,4,1,4,5,4,23.7,Other,4,1,3,5,2,2,3,4,1,3,1,0,5,4,51.2
Medicine,Principal,4.427300259905719,6,2,1,1,1,0,2,3,1,1,3,0,3,1,Science,Bachelors,18-24,7,0,0,Office,Tier1_City,1,4,0,4,3,5,5,5.3,Manufacturing,1,4,3,2,3,5,1,1,5,2,0,1,5,4,54.19
Psychology,Human Resources Specialist,3.182684782027024,1,1,1,0,6,1,3,0,4,1,0,4,4,1,Arts,Masters,18-24,14,0,0,Remote,Tier2_City,1,3,0,2,3,3,1,30.43,Education,4,5,2,2,0,2,2,1,5,4,0,0,2,4,65.99
Marketing,Construction Manager,4.601685228108791,7,2,2,0,8,0,4,0,0,3,0,3,4,1,Commerce,Masters,18-24,0,1,58,Hybrid,Tier2_City,3,1,4,5,3,1,1,12.39,Tech,2,5,3,2,1,1,3,5,4,1,1,1,5,2,37.81
Biology,Advertising Manager,4.844593062831166,1,0,4,0,1,0,3,4,0,4,2,2,3,0,Science,Bachelors,31-35,10,0,0,Flexible,Tier1_City,1,2,4,5,1,1,5,3.32,Finance,1,1,3,2,2,1,5,5,4,4,1,1,2,2,65.18
Medicine,Marketing Manager,3.901138272534268,7,0,1,1,6,1,0,0,0,1,4,4,0,0,Science,Bachelors,31-35,11,0,0,Hybrid,Any,4,1,1,3,1,5,3,38.64,Finance,5,2,2,3,5,2,3,4,5,1,0,1,1,4,52.73
Architecture,Aerospace Engineer,4.001546947070164,6,2,3,0,2,0,1,0,3,3,3,1,1,1,Interdisciplinary,Bachelors,25-30,9,0,0,Remote,Tier2_City,5,1,1,4,4,4,3,10.28,Finance,5,3,4,1,4,0,3,3,2,2,0,0,2,3,48.56
Psychology,Animator,3.9490970953798135,9,2,3,0,0,0,2,4,4,1,1,3,1,1,Arts,Bachelors,25-30,2,0,0,Remote,Tier1_City,3,1,2,3,1,2,3,47.3,Finance,2,1,5,1,1,3,4,2,4,2,0,1,2,2,45.91
Physics,Analytical Chemist,3.558884756724759,7,0,0,1,0,0,3,3,3,2,3,0,3,0,Science,PhD,36-40,6,0,0,Hybrid,Tier1_City,4,3,4,3,5,3,2,30.86,Manufacturing,5,1,2,3,3,2,4,1,3,5,1,1,1,2,69.78
Engineering,Market Research Analyst,3.975303871206556,9,1,1,0,4,1,3,1,1,2,1,0,1,1,Science,Masters,31-35,12,0,0,Remote,Any,5,5,0,1,1,1,3,7.09,Tech,2,2,3,2,3,5,4,4,3,2,1,0,2,3,53.84
Law,Fluid Mechanics Engineer,4.126727418991456,0,0,4,1,0,0,3,0,1,1,2,1,2,0,Arts,Masters,36-40,9,1,56,Hybrid,Tier1_City,5,3,2,5,1,3,1,13.24,Tech,5,2,1,5,5,5,1,3,3,5,1,1,2,1,58.0
Medicine,Financial Analyst,2.77169647291067,8,0,4,0,3,1,4,1,2,1,0,1,2,1,Science,PhD,36-40,13,0,0,Hybrid,Tier2_City,2,5,0,3,1,5,2,31.71,Tech,5,4,3,5,2,1,5,2,1,2,1,1,5,1,57.66
Marketing,Doctor,2.5084704560625912,2,2,0,1,4,0,1,1,3,1,4,1,4,0,Commerce,Bachelors,31-35,11,0,0,Hybrid,Any,2,3,0,1,0,2,3,18.89,Education,4,2,1,4,1,3,2,5,4,4,1,0,2,4,56.59
Physics,Electrical Engineer,4.69314272778357,9,0,0,0,7,0,2,1,1,0,3,3,1,1,Science,Masters,25-30,3,0,0,Remote,Tier2_City,4,1,2,4,4,0,1,28.01,Other,1,2,2,1,3,1,5,4,1,5,0,0,5,3,50.01
Engineering,Interior Designer,4.667753764453633,5,0,3,0,3,1,1,1,2,0,4,2,4,0,Science,Bachelors,36-40,9,0,0,Flexible,Tier2_City,3,2,0,3,5,1,2,40.58,Finance,5,3,5,4,2,2,4,1,2,5,0,0,4,3,60.98
Psychology,School Psychologist,3.007340971104229,3,1,3,1,7,0,3,4,0,4,4,1,2,1,Arts,Masters,36-40,4,0,0,Office,Tier1_City,5,4,4,5,1,2,1,40.25,Healthcare,1,3,5,2,1,3,5,4,5,4,0,1,4,4,63.82
Psychology,Quantum Physicist,2.5225620812487284,4,1,0,1,0,0,2,0,0,3,1,0,4,0,Arts,Bachelors,18-24,7,1,54,Hybrid,Tier2_City,5,5,5,3,4,3,5,35.81,Other,1,3,1,4,4,1,1,2,5,3,0,0,2,4,50.12
Law,Marketing Manager,2.846774309945556,6,2,1,1,1,0,3,1,1,2,1,0,0,0,Arts,PhD,18-24,0,1,38,Hybrid,Tier1_City,4,3,4,4,2,5,1,44.64,Tech,5,1,4,2,4,1,3,1,2,1,1,0,1,2,39.89
Chemistry,Music Teacher,2.9714043887543093,0,1,0,1,0,0,1,1,2,4,0,4,0,0,Science,Bachelors,40+,0,0,0,Hybrid,Any,3,2,2,3,0,2,2,12.37,Education,1,3,1,4,3,5,4,1,4,2,1,0,1,1,41.53
Education,Architectural Technologist,4.050217385187832,5,2,0,0,3,0,0,4,0,0,2,4,2,1,Arts,Bachelors,25-30,11,0,0,Office,Tier1_City,1,4,0,5,1,0,3,11.33,Manufacturing,2,3,1,3,2,0,2,3,2,1,0,1,3,3,43.69
Chemistry,Acoustics Specialist,3.7835499932329673,4,1,4,1,3,0,0,4,1,1,3,2,4,0,Science,Masters,36-40,6,1,41,Flexible,Tier1_City,3,2,0,1,5,2,2,40.57,Finance,3,5,2,2,0,1,1,1,5,2,1,1,3,3,55.06
Computer Science,Marketing Manager,3.4039371100527505,6,1,3,0,3,0,2,3,3,1,3,3,1,1,Science,Bachelors,25-30,14,1,39,Remote,Tier1_City,1,5,1,5,0,5,3,18.08,Education,2,3,3,5,3,4,5,2,5,5,1,0,1,5,71.41
Law,Human Resources Specialist,4.509771920746232,2,2,2,1,7,1,0,2,3,0,1,4,4,0,Arts,Masters,18-24,12,0,0,Remote,Tier1_City,5,5,3,1,5,3,3,27.07,Other,5,1,4,2,0,2,2,2,2,3,1,1,5,2,57.17
Education,Music Therapist,3.608758619143311,1,1,2,0,1,1,0,3,1,3,0,1,0,0,Arts,Bachelors,18-24,11,0,0,Office,Tier1_City,2,4,2,2,0,1,4,37.97,Healthcare,2,5,1,5,1,4,2,2,1,5,1,1,2,1,51.48
Computer Science,Microbiologist,4.922366912148023,7,0,0,1,7,1,3,4,0,2,4,4,0,1,Science,Masters,18-24,8,1,45,Remote,Tier3_City,2,4,5,5,2,1,5,21.61,Healthcare,3,1,2,5,2,2,4,1,2,4,1,1,3,1,66.16
Law,Financial Analyst,3.344238897316869,3,2,4,1,7,1,3,1,4,3,0,0,4,0,Arts,Bachelors,18-24,3,0,0,Flexible,Any,4,5,0,5,4,4,4,9.12,Manufacturing,2,1,4,4,5,0,3,5,1,5,0,0,2,5,49.41
Architecture,Principal,2.5493868590901165,2,0,0,0,4,1,1,1,4,3,0,4,1,0,Interdisciplinary,Bachelors,25-30,7,0,0,Office,Tier2_City,3,5,2,4,0,3,2,34.93,Tech,1,5,5,1,3,2,1,4,4,2,0,1,2,2,48.36
Biology,Mechanical Engineer,3.225133893247699,0,2,4,0,3,0,3,3,3,2,3,1,0,0,Science,Bachelors,31-35,9,1,45,Hybrid,Tier1_City,3,1,1,3,3,4,4,41.41,Tech,5,5,5,1,4,0,5,2,5,4,0,0,5,1,65.34
Law,Cybersecurity Analyst,4.617187726824841,6,2,3,0,8,1,3,2,3,1,4,2,0,0,Arts,Bachelors,40+,14,1,47,Hybrid,Tier1_City,1,4,2,1,2,4,3,3.6,Education,1,5,2,1,1,5,5,3,3,2,0,0,4,4,60.5
Education,Musician,3.928737394192271,2,0,0,0,3,1,0,1,0,3,3,1,0,1,Arts,Bachelors,25-30,6,0,0,Office,Any,4,4,4,1,3,5,2,29.44,Other,1,5,4,5,5,5,1,3,3,1,0,1,1,2,43.74
Architecture,Illustrator,3.991986720771772,1,2,1,0,5,1,1,3,4,4,2,3,1,0,Interdisciplinary,Bachelors,25-30,13,0,0,Remote,Tier1_City,3,5,0,4,2,5,4,25.06,Education,5,1,3,1,1,3,1,1,5,2,0,1,3,1,64.8
Business,Forensic Psychologist,2.7884373243443896,2,2,2,1,7,0,0,2,2,1,2,1,4,1,Commerce,Bachelors,25-30,1,0,0,Flexible,Tier2_City,4,3,1,4,3,5,1,15.2,Other,5,5,2,2,1,4,2,1,2,3,0,1,3,4,33.9
Medicine,Conductor,4.562849600506486,5,1,1,1,8,0,2,3,0,1,4,3,0,1,Science,Bachelors,25-30,13,1,11,Remote,Tier1_City,1,1,4,3,3,0,5,10.57,Tech,4,2,3,2,0,5,3,3,5,2,0,0,4,5,61.38
Engineering,Psychologist,2.8098547427924587,0,0,4,1,4,0,4,1,3,1,4,4,0,0,Science,Masters,25-30,4,1,47,Flexible,Any,5,3,3,3,5,3,1,11.84,Tech,3,3,1,2,0,4,3,1,2,3,0,1,4,1,57.71
Education,Doctor,3.0981549535734296,3,2,0,1,4,0,1,2,2,2,2,1,0,0,Arts,Masters,18-24,8,1,29,Remote,Tier1_City,4,5,3,5,0,1,2,37.07,Education,1,3,3,5,5,0,4,3,2,5,1,1,3,2,57.5
Psychology,Judge,4.537813200902043,2,1,2,0,5,0,1,4,2,1,1,4,4,1,Arts,Bachelors,18-24,12,0,0,Office,Tier1_City,2,1,2,2,0,3,4,28.2,Finance,1,2,2,5,1,4,5,4,5,5,0,1,1,3,65.68
Law,Legal Consultant,3.99322045711576,1,2,4,1,1,1,1,4,4,4,2,0,4,1,Arts,Masters,18-24,12,0,0,Remote,Tier3_City,5,1,0,3,2,5,3,49.11,Other,5,1,4,1,3,4,5,5,3,2,0,0,3,5,60.43
Education,Aerospace Engineer,4.379013973353689,4,2,4,0,4,0,3,2,1,4,4,1,4,1,Arts,Masters,18-24,8,0,0,Hybrid,Tier1_City,3,5,3,4,4,0,4,14.43,Other,5,1,3,4,0,0,1,2,5,1,0,0,1,3,67.3
Architecture,Physical Chemist,4.550846638597644,6,1,1,0,1,1,1,0,3,3,2,2,2,0,Interdisciplinary,Bachelors,31-35,2,0,0,Hybrid,Tier2_City,1,2,1,3,5,3,2,47.97,Healthcare,2,3,1,5,2,0,4,4,2,1,0,0,2,2,43.23
Music,Digital Marketing Specialist,3.7234018891500336,7,2,3,1,2,1,4,1,1,0,2,3,0,1,Arts,Masters,18-24,10,0,0,Remote,Tier1_City,1,2,0,1,0,3,2,27.21,Healthcare,1,4,4,3,4,1,3,1,4,3,1,1,5,1,58.44
Chemistry,School Psychologist,3.199634768607852,4,1,3,1,5,0,0,1,4,4,0,0,3,0,Science,Bachelors,36-40,11,0,0,Hybrid,Tier2_City,2,4,5,2,0,4,2,9.86,Manufacturing,1,2,5,2,3,4,3,4,3,2,0,0,3,1,47.48
Finance,Forensic Psychologist,2.720321167503374,5,0,3,0,2,0,0,4,0,3,0,3,4,1,Commerce,Bachelors,36-40,2,0,0,Hybrid,Tier1_City,4,5,1,5,5,3,2,9.96,Healthcare,5,2,5,2,5,4,3,5,2,3,1,0,2,2,41.78
Law,Surgeon,4.712806924092794,5,1,3,1,1,1,4,1,2,1,0,2,3,0,Arts,High School,40+,1,1,33,Hybrid,Tier2_City,2,5,1,1,1,4,4,31.6,Other,1,3,4,1,5,3,4,3,3,5,1,1,2,2,40.4
Education,AI Researcher,2.6803859837033235,4,0,0,1,4,1,2,4,0,3,3,3,0,1,Arts,Masters,36-40,6,0,0,Hybrid,Any,4,3,1,1,5,4,1,42.08,Education,3,5,2,4,2,4,4,3,1,2,0,0,3,5,54.94
Computer Science,Electrical Engineer,3.142366272628376,1,2,1,1,7,1,0,1,4,2,0,1,1,1,Science,Masters,25-30,5,1,13,Office,Any,2,5,5,2,0,2,3,38.14,Finance,4,4,3,2,5,0,1,3,5,2,0,1,1,2,43.89
Computer Science,Cybersecurity Analyst,4.376270402771505,0,2,1,1,3,1,2,3,4,0,0,0,3,0,Science,High School,25-30,14,0,0,Remote,Tier3_City,2,2,3,5,4,5,3,33.81,Education,5,1,3,5,5,2,2,1,5,2,0,0,3,2,54.02
Education,Mechanical Engineer,2.8417924338257032,9,2,4,0,9,1,3,0,1,2,3,0,0,0,Arts,Bachelors,18-24,4,1,6,Remote,Tier3_City,1,5,2,4,1,0,5,11.09,Tech,5,1,4,4,0,1,4,5,3,3,1,1,5,1,47.01
Marketing,Market Research Analyst,4.718546853978494,3,2,1,1,4,0,1,1,2,0,1,2,3,1,Commerce,PhD,36-40,6,0,0,Hybrid,Tier2_City,4,3,3,5,3,4,2,8.09,Other,1,1,3,2,4,0,3,5,1,2,0,1,2,5,46.4
Computer Science,Data Scientist,4.454382150212963,0,2,0,1,0,0,0,4,0,2,2,3,2,1,Science,Bachelors,36-40,3,0,0,Flexible,Tier1_City,2,4,3,3,5,3,2,3.01,Tech,4,1,5,1,1,2,4,1,4,4,1,0,1,1,51.36
Medicine,Ecologist,4.751253815730324,4,0,1,1,7,1,3,4,3,2,0,0,1,0,Science,Bachelors,36-40,4,0,0,Flexible,Tier2_City,3,1,2,1,3,4,2,7.78,Other,4,2,4,1,4,5,2,2,4,3,1,1,3,5,46.25
Law,Geneticist,2.945544035413487,0,2,0,0,1,0,1,2,1,2,2,0,3,0,Arts,PhD,25-30,8,0,0,Hybrid,Tier1_City,1,4,4,3,1,4,1,39.02,Healthcare,5,2,3,1,1,5,4,3,4,1,0,0,1,3,49.77
Art,Brand Manager,3.4614849483845345,8,1,0,0,5,1,4,3,2,4,2,0,1,0,Arts,Masters,31-35,14,0,0,Flexible,Tier1_City,1,3,1,4,1,4,2,45.08,Finance,5,5,1,5,5,4,3,4,3,1,0,1,1,3,61.78
Biology,Mechanical Engineer,3.16718620904648,6,0,0,1,7,0,3,1,4,3,4,0,1,1,Science,Masters,18-24,10,1,32,Office,Tier3_City,1,5,5,3,1,1,5,14.3,Other,5,2,2,1,2,0,1,4,2,4,0,0,3,4,62.58
Architecture,Financial Analyst,4.33795221219344,6,2,3,0,9,0,0,3,1,2,2,2,4,0,Interdisciplinary,Masters,18-24,8,0,0,Remote,Tier2_City,1,2,4,5,2,1,5,40.36,Manufacturing,3,5,1,3,2,4,4,4,5,1,1,0,1,2,52.52
Education,Credit Analyst,3.9635017755132487,9,0,4,0,4,0,0,1,1,4,2,4,4,0,Arts,Masters,31-35,3,0,0,Remote,Tier1_City,2,5,1,3,5,1,1,12.35,Education,1,5,1,5,3,3,3,2,1,2,0,1,2,1,47.75
Physics,Psychologist,3.733485561939524,5,0,4,1,6,1,3,3,1,0,1,0,1,1,Science,Bachelors,25-30,5,0,0,Hybrid,Tier3_City,2,1,4,4,4,1,2,14.72,Manufacturing,3,1,3,3,2,3,4,1,1,5,1,1,1,5,47.15
Computer Science,Chemical Engineer,2.8973547685203163,7,1,0,0,8,1,0,3,2,2,4,4,1,0,Science,Bachelors,40+,1,0,0,Remote,Any,1,2,1,4,4,2,4,13.54,Manufacturing,5,1,4,1,0,1,1,1,4,1,1,1,2,4,43.34
Music,Dentist,4.57548500201076,7,0,4,1,8,0,0,1,1,1,1,2,2,1,Arts,Bachelors,18-24,2,1,43,Hybrid,Tier2_City,2,4,2,4,3,4,4,5.43,Manufacturing,4,2,5,4,0,2,5,3,4,3,1,0,5,3,41.58
Physics,Financial Analyst,4.494296935979398,9,1,1,0,3,0,4,4,4,3,4,3,0,0,Science,PhD,36-40,8,0,0,Hybrid,Tier2_City,2,3,2,5,3,2,3,12.12,Manufacturing,1,2,4,5,4,0,3,2,1,1,1,1,2,4,69.79
Engineering,AI Researcher,4.467122220533415,1,0,3,1,0,1,3,3,2,0,0,1,0,0,Science,Masters,25-30,5,0,0,Hybrid,Tier1_City,4,4,5,4,3,3,1,20.56,Education,1,5,3,3,5,1,3,4,5,4,0,0,3,1,58.9
Art,Electrical Engineer,3.7185864805063007,0,0,3,0,9,0,1,1,4,1,1,0,2,0,Arts,Bachelors,36-40,7,1,29,Remote,Any,3,1,2,1,5,5,4,22.06,Tech,5,3,3,5,1,4,4,1,1,2,0,1,1,4,48.19
Computer Science,Biotechnologist,3.645278119645714,6,0,1,1,9,1,3,2,1,3,4,2,0,0,Science,Masters,36-40,14,0,0,Office,Tier1_City,4,1,0,4,0,0,3,17.54,Education,5,1,5,3,5,0,5,2,4,1,0,1,3,4,60.28
Marketing,Sound Engineer,4.456444070658088,5,2,1,1,4,1,3,3,2,4,1,2,2,1,Commerce,Bachelors,36-40,10,1,20,Hybrid,Any,5,5,5,3,3,2,5,27.19,Tech,5,4,1,5,4,0,3,5,4,2,0,1,4,3,64.26
Biology,Musician,2.966394076072948,7,2,1,1,5,1,2,2,2,0,4,2,3,0,Science,Bachelors,25-30,4,0,0,Hybrid,Any,4,5,5,3,1,1,3,20.77,Tech,5,3,1,2,3,4,3,2,3,4,0,1,5,4,48.13
Education,Architectural Technologist,2.776628454508693,4,1,3,0,8,1,4,4,2,1,3,0,2,0,Arts,Bachelors,36-40,1,0,0,Flexible,Tier3_City,3,5,1,3,3,1,2,48.61,Education,5,1,4,3,5,1,5,3,4,1,1,1,3,4,49.24
Engineering,Industrial-Organizational Psychologist,4.129685458165527,9,1,4,1,5,1,2,2,1,3,1,3,3,1,Science,Bachelors,18-24,6,0,0,Remote,Tier3_City,3,1,2,5,1,3,2,40.95,Education,5,1,2,3,3,1,4,4,3,4,0,1,4,5,51.03
Art,Lawyer,3.60409061247006,3,2,4,1,3,1,1,0,2,3,3,2,0,0,Arts,Masters,18-24,5,0,0,Hybrid,Tier2_City,4,2,4,3,2,4,5,46.76,Education,1,2,3,5,5,3,3,1,5,2,1,0,2,3,57.08
Biology,Advertising Manager,3.901443587169492,3,2,4,0,8,1,3,0,2,2,4,3,0,0,Science,Bachelors,25-30,10,1,29,Office,Any,4,4,0,5,0,0,1,29.2,Other,3,4,5,4,0,0,3,1,4,5,0,0,2,1,66.57
Engineering,Organic Chemist,3.092927408165192,9,0,0,0,2,0,4,1,0,3,3,0,3,0,Science,Masters,36-40,14,0,0,Flexible,Tier3_City,5,4,5,5,0,2,2,34.88,Tech,4,4,4,2,3,1,1,5,4,5,0,1,1,2,61.73
Engineering,Legal Consultant,4.007790470632161,4,1,3,1,4,0,4,2,2,3,1,0,4,0,Science,Masters,25-30,1,0,0,Remote,Tier1_City,1,3,0,4,5,4,2,10.83,Education,5,1,5,3,5,0,2,5,1,3,1,1,2,1,45.97
Biology,Credit Analyst,3.664719656961265,2,2,3,0,3,1,1,3,2,3,2,3,2,1,Science,Bachelors,36-40,5,0,0,Office,Tier1_City,3,3,5,1,5,4,3,38.38,Finance,4,5,1,1,0,3,3,5,4,2,0,1,2,3,52.6
Engineering,Financial Advisor,4.602415735308973,2,0,4,0,4,1,3,4,0,0,4,3,1,1,Science,PhD,31-35,12,0,0,Flexible,Tier2_City,1,2,2,4,4,5,3,14.09,Healthcare,1,4,1,1,1,2,3,3,5,1,1,0,1,4,65.91
Chemistry,Biochemist,4.931121453497415,6,0,3,0,5,0,4,0,1,2,4,3,4,0,Science,Bachelors,18-24,7,1,46,Hybrid,Tier3_City,5,5,3,4,2,5,3,9.85,Healthcare,4,3,4,5,4,2,3,4,2,4,0,0,4,3,56.44
Chemistry,AI Researcher,4.165427058709753,7,0,0,0,5,1,3,0,3,0,1,3,1,0,Science,Bachelors,36-40,12,0,0,Remote,Any,2,5,2,5,5,2,4,4.97,Finance,1,5,2,4,5,3,1,5,1,4,0,0,3,2,59.71
Education,Financial Advisor,4.687122869879469,6,0,3,0,0,0,1,4,2,1,2,4,0,1,Arts,Bachelors,18-24,0,1,26,Office,Tier3_City,2,2,5,5,1,2,5,25.19,Healthcare,2,2,1,2,3,5,5,4,5,2,0,0,5,2,42.78
Business,Electrical Engineer,2.5554677962282595,3,2,4,1,4,0,3,4,0,0,3,0,3,0,Commerce,Masters,36-40,3,1,21,Remote,Tier1_City,1,4,3,3,2,2,1,16.48,Tech,3,1,5,3,1,0,2,4,3,5,0,0,5,3,50.81
Marketing,Mechanical Engineer,2.784633996261831,9,1,4,1,4,0,3,0,2,2,4,0,4,1,Commerce,Bachelors,25-30,0,0,0,Hybrid,Tier2_City,4,5,2,3,0,2,3,49.38,Education,2,1,3,1,3,1,1,5,1,4,0,0,1,4,37.93
Biology,Financial Controller,4.300057541575838,5,1,0,0,9,0,2,3,2,1,0,2,4,0,Science,Bachelors,25-30,1,1,19,Flexible,Tier2_City,3,4,1,4,1,1,1,14.74,Education,1,3,3,3,2,1,2,4,4,3,1,1,4,2,42.87
Music,Market Research Analyst,4.367885495629984,0,1,2,0,3,1,4,0,1,1,4,0,1,0,Arts,Bachelors,25-30,0,0,0,Hybrid,Tier2_City,1,1,4,2,2,4,3,43.73,Other,2,3,2,1,3,5,4,1,1,2,0,1,2,1,30.68
Psychology,Data Scientist,2.9598129270446565,1,1,3,1,3,1,3,1,2,3,2,3,3,0,Arts,Bachelors,18-24,5,0,0,Remote,Tier1_City,4,3,5,2,0,4,2,17.87,Education,1,2,4,5,1,5,3,4,3,1,1,1,4,3,46.38
Art,Psychologist,4.423094228597996,7,2,4,1,0,1,0,0,4,3,1,2,3,0,Arts,Masters,25-30,10,0,0,Hybrid,Tier2_City,5,5,5,3,5,1,1,38.21,Finance,2,2,2,5,3,4,5,4,2,4,1,0,1,3,60.85
Chemistry,Social Media Manager,3.898208559653755,1,0,1,1,4,1,1,1,3,2,1,3,1,0,Science,Bachelors,18-24,5,0,0,Hybrid,Tier2_City,4,3,3,2,1,4,4,34.01,Finance,1,4,5,3,2,5,2,1,4,1,0,1,3,1,45.24
Engineering,Teacher,4.025612034882913,3,1,1,1,6,0,2,0,1,2,2,0,0,1,Science,Bachelors,18-24,0,1,17,Hybrid,Tier2_City,5,2,3,3,1,2,3,29.4,Tech,3,5,2,5,3,1,3,1,5,5,0,1,2,2,46.27
Art,Legal Consultant,4.375408964101245,0,2,2,1,0,0,3,4,1,0,3,0,2,1,Arts,Bachelors,18-24,3,0,0,Office,Tier2_City,1,1,0,5,0,0,5,22.59,Finance,3,1,3,2,1,0,5,2,2,5,0,1,5,2,46.08
Engineering,Aerospace Engineer,4.854224125354028,0,0,0,1,1,1,3,4,0,3,1,2,3,0,Science,Bachelors,25-30,13,0,0,Office,Tier2_City,2,5,3,4,1,5,2,34.54,Other,3,4,1,5,0,0,3,2,3,1,0,0,3,1,53.73
Physics,Interior Designer,2.698306595822588,6,1,4,1,4,0,2,1,2,4,3,2,3,0,Science,PhD,31-35,13,0,0,Hybrid,Tier1_City,3,5,1,1,5,5,3,22.14,Education,1,2,1,2,1,3,3,5,2,4,0,0,2,5,69.91
Art,Financial Controller,2.882799518386008,7,0,3,0,4,1,0,2,4,1,1,3,3,1,Arts,Bachelors,25-30,13,0,0,Flexible,Any,1,4,4,4,5,4,1,28.76,Other,4,3,4,5,0,4,5,3,5,5,0,0,2,2,69.56
Physics,School Psychologist,4.101451614074161,5,0,2,1,3,0,0,0,2,0,4,0,4,0,Science,PhD,36-40,3,0,0,Flexible,Tier1_City,2,3,3,3,5,0,3,30.72,Tech,2,4,5,3,0,1,3,4,5,4,1,0,3,1,52.56
Marketing,Conductor,4.616536608501432,5,2,1,0,1,0,0,0,4,2,1,4,3,0,Commerce,Bachelors,31-35,7,1,37,Remote,Tier3_City,5,1,0,3,0,5,2,15.57,Tech,2,3,4,2,4,0,4,4,1,4,1,1,5,3,47.77
Chemistry,Architect,4.2407699343663285,9,0,2,1,7,0,3,1,2,0,2,2,1,0,Science,Bachelors,31-35,5,0,0,Remote,Tier1_City,3,4,5,4,3,0,5,18.97,Education,2,5,2,4,5,0,1,3,2,5,0,1,4,4,53.12
Education,Fluid Mechanics Engineer,4.614284916684092,8,2,0,0,1,0,2,2,2,0,0,3,2,1,Arts,Masters,31-35,1,1,12,Hybrid,Tier2_City,4,1,4,3,3,1,5,3.85,Manufacturing,2,3,2,3,1,2,2,5,1,4,0,0,4,5,43.1
Medicine,AI Researcher,3.052639070114108,9,2,0,0,9,1,2,2,1,4,1,0,3,1,Science,Bachelors,25-30,4,1,41,Remote,Any,1,1,3,2,1,3,5,43.05,Education,3,1,2,2,4,0,5,4,4,3,0,0,4,4,47.45
Business,Urban Planner,2.9209799223269024,0,0,0,1,0,1,1,0,3,4,3,4,2,1,Commerce,Masters,31-35,3,0,0,Hybrid,Tier1_City,4,2,1,2,5,4,2,38.53,Tech,4,5,5,1,0,5,1,2,3,5,1,1,4,5,56.47
Art,Geneticist,3.3203501395447392,3,2,1,1,3,1,0,3,2,3,3,3,0,1,Arts,PhD,18-24,9,0,0,Hybrid,Any,3,2,1,3,1,1,3,11.63,Manufacturing,2,3,1,1,3,4,2,4,4,1,0,1,3,4,62.03
Art,Mechanical Engineer,3.53249080616798,5,0,1,0,2,1,2,1,3,4,1,1,0,0,Arts,Bachelors,36-40,3,0,0,Remote,Tier1_City,1,4,4,3,0,1,2,20.02,Education,4,4,3,4,0,1,5,1,5,3,0,1,4,5,49.31
Medicine,Analytical Chemist,4.695675386266579,0,0,4,1,0,0,2,4,1,4,3,3,2,1,Science,Bachelors,31-35,11,1,43,Remote,Tier1_City,1,4,0,2,1,0,2,22.79,Education,1,1,3,1,1,2,5,4,5,1,1,1,4,5,61.8
Medicine,Psychologist,3.322158064122436,2,1,2,0,5,0,3,0,0,2,0,3,1,0,Science,Masters,18-24,7,0,0,Remote,Any,4,4,1,3,4,4,3,18.72,Manufacturing,1,1,2,3,1,0,4,4,5,5,1,0,2,5,57.18
Business,Nuclear Physicist,2.793892705291886,9,2,2,0,3,1,0,3,3,2,0,4,4,1,Commerce,Bachelors,31-35,4,0,0,Remote,Tier3_City,4,1,2,3,3,1,4,40.52,Manufacturing,2,2,2,2,1,4,5,1,5,2,1,0,4,1,46.1
Medicine,Accountant,3.683614367200138,9,2,2,1,4,1,4,4,3,2,4,1,0,1,Science,Bachelors,18-24,2,0,0,Hybrid,Tier1_City,2,5,2,4,1,2,5,37.09,Healthcare,5,2,2,3,1,3,4,2,2,4,0,1,1,1,51.34
Engineering,Nurse,2.7537382498680056,0,1,3,1,4,0,2,4,0,3,3,4,4,0,Science,High School,18-24,9,0,0,Hybrid,Any,4,2,3,1,1,1,1,39.06,Other,3,4,5,5,3,1,2,1,2,3,0,0,4,3,53.44
Architecture,Teacher,2.9484314383302923,5,2,2,0,5,1,3,0,0,0,0,0,3,0,Interdisciplinary,High School,18-24,11,0,0,Flexible,Tier2_City,5,5,1,2,2,2,1,45.49,Manufacturing,2,2,3,5,4,3,3,3,5,4,1,0,2,3,46.6
Computer Science,Artist,4.273744718643564,6,1,0,1,4,1,1,1,2,4,0,2,1,0,Science,Masters,31-35,14,0,0,Remote,Tier1_City,2,3,2,4,1,3,3,30.97,Finance,3,3,4,1,2,4,4,2,4,3,0,0,3,4,55.04
Education,Marketing Manager,2.959420986933793,0,1,2,1,4,0,3,0,3,2,2,0,1,0,Arts,Bachelors,31-35,3,0,0,Flexible,Any,4,2,3,1,4,2,1,31.88,Manufacturing,2,2,1,4,4,3,3,4,3,2,0,1,1,1,44.69
Art,Data Scientist,4.039569550799667,3,1,4,0,2,1,4,3,3,2,1,0,1,0,Arts,Bachelors,36-40,0,0,0,Remote,Tier2_City,1,3,3,3,3,2,4,36.93,Tech,3,1,4,4,0,5,3,1,3,2,0,0,2,1,42.38
Education,Musician,3.1559045539068595,5,2,1,1,6,0,2,0,0,3,4,0,4,1,Arts,Masters,18-24,5,0,0,Hybrid,Tier1_City,4,3,3,3,2,0,2,35.02,Manufacturing,5,4,1,5,1,1,5,1,4,5,0,1,3,1,55.42
Marketing,AI Researcher,3.302986926840506,4,0,4,0,8,1,0,1,3,2,0,0,2,0,Commerce,Bachelors,25-30,10,0,0,Remote,Tier3_City,3,4,0,4,0,1,5,43.88,Education,5,3,5,4,1,4,1,2,4,1,1,1,1,3,46.3
Psychology,Fluid Mechanics Engineer,4.52057470234271,1,1,4,0,9,1,0,0,2,1,2,1,2,1,Arts,High School,31-35,12,1,14,Office,Tier3_City,2,1,3,3,0,3,1,39.2,Finance,1,1,1,4,2,0,3,1,4,3,1,0,2,2,45.77
Engineering,Psychologist,3.1891422185041263,7,2,3,0,6,1,0,0,0,2,3,2,4,1,Science,Masters,18-24,14,0,0,Remote,Tier2_City,1,5,0,5,3,1,1,8.66,Manufacturing,2,1,5,1,4,3,1,3,3,1,0,1,1,4,50.96
Art,Paralegal,4.418449718946178,4,0,2,0,7,1,0,1,4,4,2,0,4,0,Arts,High School,31-35,9,0,0,Flexible,Any,4,3,2,4,0,2,3,46.63,Finance,5,5,3,3,0,2,4,5,3,2,1,1,4,5,48.45
Chemistry,Conductor,3.384885475232761,5,2,0,0,5,1,3,4,4,2,3,0,2,0,Science,Masters,18-24,3,0,0,Remote,Any,3,4,3,1,4,5,3,35.11,Other,5,2,1,3,1,3,3,4,5,4,1,1,1,3,66.43
Computer Science,Biotechnologist,4.589993287665684,8,2,4,1,2,1,2,0,2,0,0,1,2,0,Science,Masters,18-24,5,0,0,Remote,Tier1_City,2,1,2,4,1,2,2,8.98,Healthcare,2,3,2,2,5,4,3,3,5,4,0,1,4,5,45.18
Physics,Composer,4.10865521345987,9,0,2,1,4,0,3,4,1,4,0,2,2,1,Science,Bachelors,25-30,1,0,0,Hybrid,Any,2,2,1,2,3,1,5,39.28,Finance,2,4,2,3,2,2,3,1,4,5,1,0,4,4,54.62
Marketing,Geneticist,2.725144924455084,6,0,1,1,2,1,0,3,3,3,3,3,4,0,Commerce,Bachelors,31-35,4,0,0,Office,Tier1_City,2,3,0,4,2,3,1,19.85,Education,1,4,5,3,2,4,1,5,2,4,1,1,1,1,54.59
Architecture,Brand Manager,4.442773882790959,4,2,1,1,0,0,1,0,4,1,2,0,0,1,Interdisciplinary,Bachelors,18-24,10,1,16,Flexible,Tier2_City,1,4,2,3,1,5,2,40.88,Healthcare,5,4,3,1,5,4,4,4,2,4,1,1,4,4,46.85
Physics,Advertising Manager,3.810636230756467,0,0,2,0,6,0,0,2,1,2,0,1,1,1,Science,Bachelors,18-24,8,0,0,Hybrid,Any,4,4,3,3,0,3,5,47.9,Manufacturing,3,5,5,1,0,2,1,3,1,2,1,0,4,1,36.45
Chemistry,Physician Assistant,2.843650757881151,1,2,3,0,1,1,1,1,1,2,1,0,0,1,Science,Masters,18-24,7,0,0,Office,Tier3_City,1,4,2,5,0,0,2,15.0,Other,2,3,4,3,2,4,2,2,3,3,1,1,5,5,45.02
Psychology,Lawyer,4.061814311862532,7,2,1,0,3,1,4,1,0,0,1,4,2,0,Arts,Masters,18-24,2,1,37,Office,Tier1_City,5,2,3,5,2,2,1,43.3,Other,2,1,4,2,5,2,2,4,2,5,0,1,4,3,45.74
Architecture,Clinical Psychologist,3.571027454594957,1,2,0,1,0,1,3,3,0,2,3,1,3,1,Interdisciplinary,Bachelors,18-24,0,0,0,Hybrid,Tier2_City,4,1,4,5,4,2,3,39.36,Other,2,5,4,3,2,0,5,2,1,1,1,0,1,4,37.07
Marketing,Nurse,4.897611441029527,7,1,2,0,0,1,1,4,1,0,0,3,3,1,Commerce,Masters,25-30,9,0,0,Office,Tier2_City,5,5,5,1,2,0,3,34.55,Finance,2,2,2,3,4,4,3,4,3,1,1,0,3,2,48.73
Physics,Dentist,3.6211924271180864,4,0,1,1,9,0,1,4,1,0,1,1,3,1,Science,PhD,31-35,2,0,0,Remote,Tier1_City,4,5,0,5,3,1,3,21.09,Healthcare,5,1,4,5,1,0,2,1,4,2,1,1,3,4,46.91
Art,Counselor,2.5980730973282458,6,2,0,1,2,0,2,2,0,2,2,3,3,0,Arts,PhD,25-30,7,1,44,Hybrid,Any,2,3,1,1,2,2,4,8.16,Manufacturing,3,4,1,2,4,1,2,3,4,1,1,1,1,4,56.11
Law,Paralegal,2.7469795201366884,9,0,0,0,1,1,1,0,1,4,1,3,0,1,Arts,Bachelors,31-35,10,0,0,Office,Tier3_City,1,1,2,5,0,1,2,25.74,Other,1,2,4,3,2,3,1,4,5,4,1,0,3,2,58.19
Biology,Landscape Architect,3.644704567343707,4,1,4,1,8,0,0,3,3,0,1,4,2,0,Science,Bachelors,31-35,2,0,0,Hybrid,Tier3_City,5,3,5,1,4,3,1,7.97,Other,4,3,2,1,3,0,4,2,1,4,1,0,4,4,42.65
Business,AI Researcher,2.7836214444027645,0,0,0,0,0,1,0,1,3,1,2,4,2,1,Commerce,Bachelors,18-24,4,0,0,Flexible,Tier2_City,2,5,2,4,4,5,2,26.51,Other,5,3,1,3,0,3,3,4,1,4,0,0,3,5,46.7
Physics,Nuclear Physicist,4.81899010782911,8,2,1,0,0,1,4,3,2,3,1,2,4,1,Science,PhD,18-24,1,1,49,Office,Tier1_City,2,2,4,4,5,5,3,41.55,Other,5,5,3,4,2,2,3,4,1,4,1,1,5,5,58.96
Architecture,Biotechnologist,2.569382584918832,3,2,4,0,3,0,2,2,1,1,1,3,2,0,Interdisciplinary,Bachelors,36-40,14,1,51,Flexible,Any,5,1,3,3,2,5,2,49.89,Manufacturing,4,3,5,5,2,1,5,4,1,2,0,1,1,4,46.71
Psychology,Ecologist,3.066477234063162,4,1,0,0,2,0,4,1,0,3,0,0,4,1,Arts,Masters,18-24,0,0,0,Remote,Tier1_City,4,1,1,1,3,4,5,12.31,Finance,4,4,5,5,5,2,4,1,5,4,1,1,2,1,50.53
Psychology,Civil Engineer,4.368380898850804,2,1,0,0,8,0,0,3,2,1,3,2,1,1,Arts,Bachelors,18-24,10,0,0,Remote,Tier1_City,5,3,3,2,0,0,2,12.77,Other,2,5,1,5,4,4,3,3,5,4,0,1,4,3,60.96
Engineering,Actuary,2.7434057836961783,2,0,1,0,2,0,3,1,3,2,4,1,3,1,Science,Bachelors,18-24,9,0,0,Remote,Any,1,3,3,3,1,5,4,41.11,Other,3,5,1,2,0,5,1,5,4,5,1,0,3,3,64.1
Education,Financial Analyst,3.385798157657682,5,2,2,0,6,0,1,0,3,1,4,3,4,0,Arts,Bachelors,31-35,14,0,0,Flexible,Any,3,2,2,4,4,2,4,25.05,Finance,5,4,5,5,5,3,3,4,4,2,0,1,2,3,64.17
Psychology,Art Director,4.168986277364487,2,1,0,1,1,0,0,2,2,2,1,2,3,1,Arts,PhD,25-30,13,1,15,Remote,Tier2_City,4,1,2,1,2,0,3,46.04,Healthcare,5,3,5,3,1,5,2,4,2,1,0,0,5,3,55.15
Finance,Legal Consultant,3.049874177934707,3,2,0,0,4,0,4,3,1,3,0,4,4,1,Commerce,Bachelors,40+,4,0,0,Hybrid,Tier1_City,2,5,2,5,5,3,1,39.14,Finance,1,2,1,2,0,2,3,1,1,3,0,1,3,1,50.24
Art,Animator,4.777232700461173,3,0,3,1,6,1,1,1,4,2,1,0,3,1,Arts,Masters,36-40,4,0,0,Remote,Tier1_City,5,5,5,2,3,3,5,37.61,Manufacturing,4,5,5,4,2,3,2,2,1,5,0,1,5,1,47.88
Chemistry,Credit Analyst,4.370887341027835,9,1,0,1,9,0,0,4,2,4,1,0,2,1,Science,Bachelors,25-30,5,0,0,Remote,Tier2_City,3,4,0,4,3,3,1,7.79,Education,4,2,3,1,4,4,4,5,1,4,1,1,4,1,42.51
Chemistry,Digital Marketing Specialist,4.992395556715065,4,1,4,1,8,1,3,3,1,1,1,2,0,0,Science,Bachelors,25-30,1,0,0,Remote,Tier2_City,5,5,0,3,0,3,1,4.69,Healthcare,5,2,4,5,3,5,2,5,5,3,0,0,4,4,44.92
Education,Paralegal,3.0770805242512496,3,0,0,1,7,1,4,3,4,4,4,2,2,0,Arts,Bachelors,25-30,8,0,0,Remote,Tier3_City,3,4,2,1,4,4,5,17.89,Education,4,2,4,3,2,4,4,5,1,1,1,0,1,4,64.35
Business,Marketing Manager,4.500163937952381,4,1,1,1,0,1,4,2,2,0,0,0,4,0,Commerce,Bachelors,18-24,1,1,18,Hybrid,Tier3_City,4,4,3,2,0,1,4,13.21,Other,2,2,3,2,0,5,5,1,1,1,0,1,1,4,29.14
Music,Market Research Analyst,4.026957581781342,8,2,4,0,4,1,2,3,3,2,0,0,0,1,Arts,Bachelors,18-24,1,0,0,Flexible,Tier2_City,5,3,1,1,5,1,3,36.48,Education,1,4,4,3,5,3,2,5,4,1,0,1,1,3,41.59
Physics,Marketing Specialist,4.890903915298074,6,0,4,0,3,0,4,1,4,0,3,2,2,1,Science,Bachelors,18-24,11,0,0,Office,Tier2_City,5,5,1,5,1,5,2,24.18,Manufacturing,5,1,4,5,5,1,4,2,2,1,0,0,3,3,58.14
Computer Science,Human Resources Specialist,4.1041479437243344,3,1,4,0,7,1,0,1,4,3,4,2,4,1,Science,Bachelors,18-24,14,0,0,Office,Tier3_City,3,4,3,3,1,4,4,27.59,Education,1,3,4,1,0,3,1,3,5,2,0,0,4,4,57.91
Computer Science,Inorganic Chemist,2.812260842045864,0,1,4,0,6,0,4,1,1,4,0,0,4,0,Science,Bachelors,18-24,4,0,0,Hybrid,Tier3_City,1,5,5,1,1,1,3,41.25,Tech,2,1,2,2,3,3,4,5,5,2,0,1,3,3,42.98
Medicine,Special Education Teacher,3.548834395889587,9,0,4,0,0,0,0,0,4,3,0,2,4,0,Science,PhD,25-30,8,0,0,Office,Any,2,5,4,4,3,3,4,25.49,Healthcare,1,1,3,3,0,2,5,4,3,3,1,0,3,1,58.44
Finance,Architectural Technologist,3.5983892362846928,9,2,3,1,8,1,3,1,0,4,4,1,2,0,Commerce,PhD,40+,3,0,0,Flexible,Any,3,5,3,3,4,1,5,28.61,Manufacturing,4,5,5,2,5,3,2,2,1,5,0,0,2,5,56.22
Physics,Credit Analyst,3.5531560976907866,5,0,0,0,8,1,4,1,0,2,3,3,4,0,Science,Bachelors,25-30,5,0,0,Flexible,Tier1_City,5,2,1,4,0,0,1,42.59,Finance,5,1,1,5,0,1,1,2,1,5,0,1,3,1,50.92
Computer Science,Biomedical Engineer,3.4400306666623743,3,0,1,0,1,1,2,4,3,3,1,3,0,0,Science,Masters,40+,1,0,0,Remote,Any,3,4,4,1,0,5,5,23.27,Manufacturing,1,1,3,5,5,1,4,5,1,1,0,0,5,2,42.27
Business,Nuclear Physicist,4.87575053662998,7,2,0,1,1,1,4,4,3,4,2,1,2,1,Commerce,PhD,25-30,13,0,0,Flexible,Tier1_City,3,5,5,3,5,1,2,6.91,Finance,3,4,3,4,4,5,2,4,2,3,0,0,4,1,74.43
Engineering,Actuary,4.218081896801345,9,2,4,1,4,0,2,2,0,1,2,1,2,0,Science,High School,25-30,12,0,0,Remote,Any,5,3,5,4,1,0,5,27.52,Manufacturing,5,2,2,4,0,3,5,2,1,2,1,1,3,4,44.27
Psychology,Astronomer,3.110095612085878,5,0,4,1,8,1,4,1,3,2,2,0,1,0,Arts,Masters,25-30,3,1,56,Hybrid,Tier3_City,5,2,4,5,4,2,1,30.23,Tech,1,1,2,5,1,0,3,1,5,4,1,1,3,1,58.97
Marketing,Education Administrator,3.8609536887931313,2,2,4,0,0,0,0,0,0,2,0,3,4,1,Commerce,PhD,18-24,14,0,0,Hybrid,Tier2_City,1,4,1,5,4,0,4,27.05,Healthcare,5,1,4,2,3,5,5,5,4,3,1,1,1,2,59.15
Business,AI Researcher,4.148435858295736,6,1,3,1,0,1,3,1,2,0,0,2,0,1,Commerce,Bachelors,18-24,11,1,28,Office,Tier1_City,1,1,4,1,5,0,3,15.13,Other,1,5,2,3,2,5,5,4,4,5,0,1,1,2,61.23
Medicine,Counselor,3.271122556888087,1,1,3,1,7,1,3,2,4,2,3,4,4,1,Science,Bachelors,36-40,8,0,0,Hybrid,Tier1_City,1,4,5,3,2,3,2,13.51,Other,1,3,5,3,3,3,2,3,3,1,0,0,5,1,58.64
Physics,Game Developer,3.2113050262054705,7,2,4,0,6,1,2,4,0,2,1,4,1,1,Science,PhD,40+,14,0,0,Remote,Tier1_City,5,2,0,2,4,3,4,20.38,Education,4,5,5,2,5,2,2,2,2,5,0,0,3,4,64.51
Art,Market Research Analyst,4.47329268239145,8,2,3,0,5,0,3,2,3,4,1,2,2,0,Arts,Bachelors,18-24,1,1,7,Office,Any,4,3,2,3,4,5,3,10.81,Manufacturing,1,3,4,1,2,0,4,3,2,5,1,0,2,5,49.29
Music,Musician,2.966511827287299,5,0,3,0,9,1,1,3,3,3,1,4,1,0,Arts,High School,18-24,0,0,0,Hybrid,Tier2_City,1,2,5,5,0,3,1,34.3,Healthcare,3,3,2,2,4,4,1,4,1,2,0,0,1,1,32.27
Architecture,Inorganic Chemist,4.084386126037623,8,2,4,0,1,0,4,0,1,2,3,1,1,1,Interdisciplinary,Bachelors,25-30,3,0,0,Remote,Tier2_City,2,5,5,4,5,0,5,31.89,Healthcare,4,3,4,5,0,4,5,1,3,3,0,1,1,3,49.5
Law,Nuclear Physicist,4.600527302617909,2,2,1,1,5,0,0,4,0,3,1,1,4,1,Arts,Bachelors,18-24,14,0,0,Hybrid,Any,4,2,4,2,4,4,4,32.72,Healthcare,3,4,1,5,5,0,2,4,4,5,0,0,4,3,63.31
Architecture,Graphic Designer,4.57039927641729,9,1,3,1,2,1,0,3,0,4,1,0,2,1,Interdisciplinary,Masters,25-30,3,1,15,Hybrid,Tier1_City,1,1,4,1,4,3,3,13.57,Healthcare,3,4,2,4,2,5,2,3,1,5,1,1,3,5,45.42
Computer Science,Music Teacher,4.06088438685563,4,2,4,1,6,0,2,4,1,1,3,2,2,0,Science,Masters,18-24,0,0,0,Remote,Tier3_City,2,1,0,2,0,3,3,14.59,Healthcare,2,2,2,3,2,3,5,4,2,4,1,1,1,4,42.67
Biology,Physician Assistant,3.671490365339853,5,2,0,1,5,0,1,2,2,1,1,2,1,1,Science,PhD,25-30,3,0,0,Remote,Tier2_City,5,5,0,1,4,0,5,40.01,Education,3,3,2,4,4,4,4,4,1,2,0,0,3,3,48.47
Physics,Legal Consultant,3.4118637030195083,0,1,2,1,5,1,3,4,2,1,2,3,3,0,Science,Bachelors,25-30,14,0,0,Flexible,Tier1_City,2,5,3,2,0,2,4,35.44,Other,1,4,2,3,5,2,2,2,4,1,0,1,2,1,58.11
Music,Electrical Engineer,4.075592821504504,5,0,3,1,7,1,4,0,4,0,3,4,4,1,Arts,Bachelors,25-30,2,1,30,Flexible,Any,1,1,1,1,2,2,4,44.13,Education,5,4,5,2,3,4,3,4,3,3,1,0,5,2,47.14
Medicine,Financial Analyst,3.7209635964660186,6,2,1,1,1,1,4,3,4,2,3,3,1,0,Science,Bachelors,18-24,12,0,0,Remote,Tier2_City,3,3,3,1,3,1,1,21.96,Manufacturing,4,1,4,1,5,2,3,1,5,4,0,0,4,5,70.27
Psychology,Clinical Psychologist,2.938482487858817,7,0,0,1,9,1,2,4,3,0,4,3,3,0,Arts,Bachelors,25-30,1,0,0,Hybrid,Tier1_City,3,2,5,2,0,5,4,28.72,Other,4,3,5,3,3,0,1,2,1,3,1,0,2,1,46.6
Physics,Surgeon,3.425792489492581,4,2,2,0,9,1,2,3,3,1,1,4,4,1,Science,Bachelors,40+,12,0,0,Hybrid,Tier2_City,2,1,1,2,0,2,5,37.72,Other,4,5,4,1,3,2,4,1,2,3,1,1,3,4,55.71
Marketing,Lawyer,4.491083071342443,2,1,3,1,2,1,1,1,2,4,1,4,2,1,Commerce,PhD,25-30,9,1,26,Hybrid,Any,5,5,0,1,4,3,4,48.79,Finance,5,1,1,1,0,1,5,3,3,1,1,1,3,3,61.71
Engineering,Art Therapist,3.492955970679445,8,2,4,1,6,1,4,0,4,1,2,3,4,1,Science,Masters,36-40,14,0,0,Hybrid,Tier1_City,4,5,2,5,0,4,1,49.51,Manufacturing,3,4,2,1,4,1,5,4,1,3,0,1,3,5,54.5
Computer Science,Quantum Physicist,2.682104082982871,0,0,4,0,3,0,0,1,4,1,3,0,4,0,Science,Bachelors,36-40,3,0,0,Remote,Tier2_City,3,3,1,2,5,1,3,49.96,Healthcare,2,4,3,2,2,1,5,5,2,5,0,0,1,3,44.91
Law,Web Developer,2.565294051058133,9,0,3,1,1,0,4,3,0,1,3,2,4,1,Arts,Masters,40+,7,1,44,Hybrid,Tier3_City,4,4,1,3,1,5,4,44.85,Finance,1,4,5,1,3,1,3,4,2,2,0,1,5,2,53.84
Music,Education Administrator,2.7367157220362497,8,1,1,1,4,1,0,0,2,2,3,1,3,0,Arts,Bachelors,31-35,6,0,0,Remote,Any,5,5,0,4,1,4,5,33.06,Other,4,4,3,1,3,0,5,5,3,5,0,0,4,2,49.53
Marketing,Legal Secretary,3.2985643678830145,4,1,2,0,3,1,4,4,2,1,3,1,0,0,Commerce,Bachelors,31-35,8,0,0,Hybrid,Tier3_City,3,3,4,1,2,4,4,3.33,Manufacturing,1,5,1,5,3,2,1,2,2,4,0,0,5,5,60.8
Business,Biochemist,2.5024418196971383,7,0,4,1,1,1,1,2,4,2,2,3,4,1,Commerce,Masters,36-40,7,1,33,Flexible,Tier1_City,5,1,3,1,0,3,2,35.88,Finance,3,2,3,5,1,5,3,3,2,4,0,1,3,4,60.55
Marketing,Architect,3.5418616613141607,5,0,0,0,7,0,3,3,1,1,0,2,1,1,Commerce,Bachelors,18-24,0,1,32,Flexible,Tier2_City,1,4,2,4,5,0,1,14.21,Other,2,2,1,3,0,3,2,5,4,1,1,0,1,5,41.09
Architecture,Credit Analyst,3.784345883667556,3,2,1,1,8,1,3,4,2,1,3,2,2,1,Interdisciplinary,PhD,25-30,11,0,0,Flexible,Tier3_City,4,1,5,5,4,0,3,5.69,Education,4,3,5,5,3,1,4,4,5,3,1,1,5,5,80.02
Education,Organic Chemist,4.311890584843755,5,2,1,0,6,1,2,0,3,0,4,4,3,0,Arts,Masters,40+,1,0,0,Flexible,Tier1_City,1,3,1,4,4,0,2,35.77,Healthcare,3,4,1,3,5,1,2,4,3,4,1,1,1,4,55.43
Law,Counselor,2.9357307882022803,5,0,4,0,3,1,3,4,4,3,4,2,1,1,Arts,Bachelors,31-35,11,0,0,Remote,Tier2_City,5,1,4,2,3,2,5,38.53,Finance,2,3,5,1,1,4,2,4,4,5,0,0,1,2,73.01
Engineering,Brand Manager,3.868825793107124,0,1,4,1,8,1,3,2,1,2,2,4,0,1,Science,Masters,40+,1,1,54,Office,Tier3_City,5,2,0,4,2,0,4,33.99,Tech,4,5,5,5,4,1,4,3,5,1,0,0,2,3,52.7
Education,Interior Designer,3.246544108930721,7,2,1,0,5,0,0,3,4,3,2,1,3,1,Arts,Bachelors,31-35,11,1,40,Remote,Tier3_City,2,3,1,1,5,5,1,20.16,Healthcare,3,3,3,4,2,3,4,5,1,2,1,0,1,2,56.15
Art,Conductor,4.040389232200274,3,2,0,0,0,0,4,1,3,3,3,1,4,0,Arts,Bachelors,36-40,7,0,0,Flexible,Tier1_City,2,4,4,4,5,3,4,27.02,Education,1,2,4,2,3,3,5,5,4,2,1,1,4,3,59.57
Music,Urban Planner,2.997772013937304,5,0,4,0,7,1,0,2,0,0,3,1,2,0,Arts,Bachelors,31-35,11,0,0,Office,Tier1_City,3,5,5,3,4,2,4,46.94,Education,5,2,4,5,0,5,5,3,5,2,1,1,3,3,54.1
Law,Musician,3.426161685011018,3,1,1,0,2,0,1,0,2,0,4,3,1,0,Arts,Bachelors,31-35,3,1,33,Hybrid,Tier2_City,1,1,3,2,3,5,4,37.29,Manufacturing,4,2,4,2,3,4,1,1,2,2,1,1,3,5,42.82
Art,Digital Marketing Specialist,3.464171447492212,4,1,0,0,5,0,3,4,0,0,1,0,4,0,Arts,Masters,25-30,8,0,0,Hybrid,Tier3_City,1,3,0,4,4,0,4,26.72,Other,2,3,2,5,0,5,4,2,3,1,1,0,5,5,50.96
Computer Science,Pharmacist,2.578061417724152,6,2,1,0,4,0,1,4,4,2,4,3,4,1,Science,Bachelors,36-40,1,0,0,Remote,Tier3_City,5,1,4,1,3,5,1,30.89,Tech,2,4,3,5,1,0,4,3,4,3,0,0,1,5,58.22
Biology,Biotechnologist,4.122613253093329,2,0,1,1,3,1,4,0,3,4,2,2,4,1,Science,Masters,36-40,13,0,0,Remote,Tier1_City,2,3,4,2,1,4,2,46.6,Finance,5,1,1,4,0,5,2,4,1,1,1,1,3,3,60.59
Finance,Music Therapist,4.330346411908788,1,2,1,0,9,0,0,3,0,1,2,3,4,1,Commerce,Masters,36-40,3,0,0,Flexible,Tier1_City,4,3,1,1,5,3,5,21.51,Manufacturing,5,2,4,1,5,0,5,1,4,5,1,0,5,1,50.82
Biology,Curriculum Developer,2.819249809262516,0,1,2,1,4,0,3,1,3,4,3,2,2,1,Science,Bachelors,31-35,12,1,56,Flexible,Tier2_City,5,4,5,5,1,3,2,7.79,Education,3,3,3,3,4,2,1,5,2,5,1,0,3,3,65.44
Finance,Mechanical Engineer,2.6509622581060586,2,0,2,1,9,0,1,2,4,1,2,3,2,0,Commerce,Masters,25-30,12,1,45,Remote,Any,1,1,5,3,4,5,1,18.31,Finance,5,1,2,5,0,5,5,2,3,3,0,1,1,5,64.25
Architecture,Electrical Engineer,2.795728281693694,6,0,4,1,6,1,4,3,1,2,1,0,4,0,Interdisciplinary,Bachelors,18-24,14,0,0,Remote,Tier3_City,1,1,3,5,2,1,5,22.51,Education,4,2,3,5,5,5,4,4,4,2,1,0,2,1,59.9
Law,Principal,4.469319517508015,7,0,2,0,9,0,0,2,4,1,4,1,0,1,Arts,Bachelors,36-40,14,0,0,Remote,Tier2_City,5,3,5,3,0,3,3,15.83,Education,5,2,1,2,2,3,1,4,4,4,1,0,3,1,60.83
Architecture,Electrical Engineer,4.123686103932712,8,2,4,0,1,0,1,4,0,0,0,3,0,0,Interdisciplinary,Bachelors,25-30,0,0,0,Flexible,Any,5,2,0,4,2,4,2,27.86,Tech,4,5,4,1,1,3,5,4,2,5,1,0,2,2,33.18
Psychology,Pharmacist,3.453148546923233,8,0,1,1,8,1,3,0,3,2,1,2,4,0,Arts,Bachelors,25-30,2,1,41,Flexible,Tier2_City,5,5,0,2,2,3,1,17.33,Healthcare,1,2,1,5,0,5,2,3,3,1,1,1,4,5,39.76
Architecture,Artist,2.645442887746214,2,1,3,1,1,0,2,3,0,3,1,3,3,0,Interdisciplinary,High School,18-24,5,0,0,Hybrid,Tier2_City,1,5,3,4,0,1,1,7.85,Finance,5,1,2,5,3,1,5,5,2,3,1,1,4,5,40.26
Medicine,Inorganic Chemist,3.688483212965872,5,1,4,0,7,0,0,1,4,1,1,3,0,0,Science,Masters,36-40,8,0,0,Office,Tier1_City,4,2,2,3,5,3,1,11.84,Tech,1,1,1,3,4,1,5,1,2,5,0,1,4,1,62.21
Chemistry,Special Education Teacher,3.947102277401511,6,2,0,0,1,0,0,1,4,3,1,0,2,0,Science,Bachelors,36-40,10,0,0,Office,Any,1,4,1,3,1,3,5,46.15,Other,2,4,2,1,2,1,1,2,5,4,1,0,5,5,55.74
Physics,Art Therapist,2.514463331506701,3,0,2,0,7,1,4,4,4,3,3,1,0,0,Science,Bachelors,36-40,0,0,0,Remote,Tier2_City,5,2,4,3,1,1,4,32.59,Education,5,1,1,1,0,5,1,4,5,3,0,0,4,3,55.33
Physics,Judge,3.37020463161692,6,0,2,0,9,1,2,0,1,4,4,2,4,1,Science,PhD,31-35,14,0,0,Flexible,Tier1_City,2,2,1,1,5,3,3,17.77,Education,2,3,2,5,0,5,3,3,5,1,1,1,1,4,71.09
Architecture,Electrical Engineer,2.693865716529177,9,1,2,0,0,1,4,1,1,3,2,3,4,0,Interdisciplinary,Masters,25-30,4,1,48,Hybrid,Tier1_City,4,4,3,2,0,5,5,20.25,Tech,1,3,3,1,2,2,4,3,5,3,0,0,5,4,56.9
Finance,Conductor,2.6455322743634464,1,1,2,0,8,1,4,4,4,4,1,4,0,1,Commerce,Masters,25-30,11,0,0,Remote,Tier1_City,3,3,4,4,3,2,5,26.19,Other,2,2,3,1,2,3,2,2,4,4,1,0,1,5,76.04
Business,Manager,2.755567700658312,6,0,0,0,6,0,4,2,4,3,1,0,3,1,Commerce,Bachelors,18-24,1,0,0,Hybrid,Tier1_City,1,1,2,4,2,5,2,34.64,Finance,1,4,3,3,0,1,5,1,4,4,1,0,1,1,53.45
Psychology,Architect,4.77076745952459,0,1,3,1,4,0,2,4,1,1,4,4,4,0,Arts,Masters,36-40,6,0,0,Hybrid,Tier1_City,4,5,5,5,4,3,3,30.36,Education,3,2,3,4,3,5,1,3,2,3,0,0,1,1,59.79
Chemistry,Teacher,2.73947062946041,9,1,0,1,6,1,3,3,4,4,4,2,2,0,Science,Masters,18-24,3,0,0,Hybrid,Any,4,5,3,3,1,0,1,46.84,Other,1,4,1,3,3,1,5,3,3,1,0,1,5,4,54.72
Marketing,Musician,2.632623440938645,9,0,0,0,8,1,0,3,0,2,4,3,0,1,Commerce,Masters,31-35,4,0,0,Office,Tier1_City,5,5,1,3,5,0,5,32.41,Finance,3,5,5,4,3,3,5,5,5,2,0,1,2,4,55.64
Physics,Brand Manager,3.431389389241369,7,1,0,0,4,1,4,4,4,1,1,1,2,0,Science,Masters,25-30,7,0,0,Flexible,Tier2_City,4,2,4,3,4,2,3,45.81,Tech,2,4,2,3,0,1,5,5,2,5,0,1,1,5,65.95
Psychology,Music Teacher,3.622034050260332,1,0,0,0,4,0,1,4,3,0,0,2,3,1,Arts,Bachelors,25-30,1,1,48,Office,Tier1_City,1,3,0,4,0,3,2,3.26,Education,1,5,2,5,1,4,5,1,3,4,1,1,1,2,44.35
Psychology,Architect,3.560777136788558,2,1,3,1,4,0,4,3,1,0,0,1,2,1,Arts,Bachelors,36-40,2,0,0,Hybrid,Tier3_City,2,3,4,5,4,4,4,44.86,Manufacturing,3,5,5,3,0,4,2,2,2,5,0,0,1,1,43.46
Psychology,Microbiologist,3.790456349056072,5,1,0,1,8,1,2,3,1,2,1,2,2,0,Arts,Bachelors,18-24,10,0,0,Hybrid,Tier2_City,4,2,4,1,4,3,3,36.91,Manufacturing,1,2,2,1,1,0,2,4,5,1,0,1,2,5,52.39
Biology,Curriculum Developer,2.708513085036241,8,1,2,0,7,1,2,4,3,2,4,3,0,1,Science,Bachelors,31-35,4,0,0,Remote,Tier1_City,1,4,3,2,2,0,1,11.09,Education,4,3,2,1,3,3,2,3,5,4,1,0,4,3,60.35
Chemistry,AI Researcher,2.778072318717103,8,2,4,0,3,1,3,2,1,1,2,3,0,1,Science,Masters,18-24,9,1,29,Hybrid,Any,5,4,2,1,0,1,5,15.36,Healthcare,4,4,3,2,0,4,2,4,4,4,1,1,4,1,62.83
Business,Human Resources Specialist,3.4790121364565603,6,2,2,1,5,1,1,4,2,4,2,4,1,1,Commerce,Bachelors,18-24,3,0,0,Remote,Tier3_City,4,3,4,4,4,2,4,28.51,Education,2,2,2,5,5,3,3,4,1,3,0,1,3,5,51.94
Music,Physician Assistant,4.23108200036071,6,1,2,1,7,0,3,3,2,1,2,0,3,0,Arts,PhD,25-30,4,1,35,Flexible,Any,3,2,5,3,1,1,2,8.87,Education,4,5,2,1,3,2,1,4,1,3,0,0,5,1,46.59
Marketing,Surgeon,3.7568191553084462,0,1,0,0,8,1,3,3,0,4,4,1,4,1,Commerce,PhD,18-24,2,0,0,Flexible,Tier1_City,3,5,4,2,0,4,1,39.91,Education,5,5,4,5,0,3,4,1,5,3,0,0,5,2,61.83
Marketing,Surgeon,3.623900101937225,8,2,1,1,5,0,3,1,3,0,4,0,4,0,Commerce,Bachelors,31-35,12,0,0,Remote,Tier2_City,2,1,2,4,1,3,4,40.19,Tech,3,1,2,3,3,0,4,2,2,5,1,1,2,2,57.92
Chemistry,Astronomer,3.1617431021907763,7,2,2,0,9,0,2,4,4,0,2,0,0,0,Science,Bachelors,25-30,11,0,0,Office,Any,5,3,2,4,5,4,2,17.14,Education,5,1,5,1,2,0,1,2,4,5,0,1,2,1,66.03
Biology,Chemist,4.822230215760138,5,2,1,1,2,0,1,3,1,3,1,2,3,1,Science,Masters,18-24,8,1,48,Office,Tier3_City,1,5,5,4,5,1,1,6.28,Education,4,4,2,5,5,2,4,5,3,5,1,1,2,1,61.97
Law,Landscape Architect,2.9528621640632906,3,1,4,0,7,0,3,1,1,0,3,3,1,0,Arts,PhD,18-24,7,0,0,Flexible,Tier3_City,4,3,4,2,3,3,5,49.48,Tech,2,3,5,3,0,3,3,4,2,3,1,1,3,3,57.91
Psychology,Electrical Engineer,2.9125678379634583,1,1,4,1,9,1,1,4,1,2,2,2,0,0,Arts,Bachelors,31-35,13,0,0,Hybrid,Tier2_City,1,1,0,2,5,5,2,14.78,Education,5,1,2,4,1,5,1,4,2,2,1,0,4,3,53.65
Physics,Artist,4.335153755000434,1,1,4,1,9,0,4,4,0,4,0,0,2,0,Science,Bachelors,36-40,5,0,0,Office,Tier3_City,3,4,0,5,4,5,4,6.18,Manufacturing,2,5,5,2,3,3,4,3,1,3,0,1,5,5,46.85
Art,Psychologist,3.419101331815086,0,1,1,1,0,0,3,0,1,1,1,1,0,1,Arts,Bachelors,25-30,14,0,0,Hybrid,Tier3_City,5,3,0,5,0,4,1,18.51,Manufacturing,1,2,2,3,5,4,5,1,4,2,0,0,3,3,49.89
Education,Music Therapist,2.884898968540502,9,1,4,1,2,0,1,4,1,1,1,1,2,1,Arts,Masters,25-30,13,0,0,Remote,Tier1_City,1,2,3,1,5,5,3,48.54,Other,5,3,2,4,5,4,3,4,5,2,1,1,1,5,59.6
Computer Science,Legal Secretary,2.6922401507338694,4,1,4,0,2,1,1,4,0,1,2,2,2,1,Science,Bachelors,31-35,0,0,0,Remote,Tier2_City,4,4,3,2,1,5,1,40.27,Education,1,4,4,5,5,0,4,1,5,4,1,0,4,5,42.63
Medicine,Web Developer,2.5644256231689235,6,0,2,0,1,0,4,2,3,3,4,3,2,0,Science,Masters,31-35,3,0,0,Remote,Tier3_City,5,4,0,2,4,0,4,25.58,Tech,5,2,4,4,4,3,3,5,5,5,0,0,3,3,71.53
Music,Aerospace Engineer,4.18760397734899,8,0,4,0,1,0,0,2,2,4,4,1,1,0,Arts,Bachelors,18-24,6,0,0,Remote,Tier1_City,4,5,0,2,5,5,4,17.35,Education,3,4,2,1,1,1,1,1,2,4,0,1,4,1,55.25
Chemistry,Music Therapist,3.7178120846654754,6,2,4,0,3,0,4,3,0,3,4,1,2,1,Science,High School,31-35,9,0,0,Remote,Tier1_City,4,2,0,5,2,0,3,22.9,Education,2,2,4,5,4,4,1,2,3,1,1,1,1,4,52.7
Music,Ecologist,2.831593073197633,6,1,3,0,2,1,1,4,2,1,0,1,3,1,Arts,Bachelors,31-35,4,0,0,Office,Tier1_City,5,3,2,4,1,2,4,3.82,Other,1,2,1,2,3,3,1,1,2,2,0,1,5,5,37.45
Music,Doctor,2.708013103790919,7,1,2,1,8,1,2,4,0,0,0,4,0,0,Arts,Bachelors,31-35,3,0,0,Office,Any,5,3,1,3,1,0,1,36.76,Finance,4,3,1,2,5,2,4,4,5,3,0,1,1,3,42.45
Education,Acoustics Specialist,2.7673563678540574,0,2,2,0,0,1,3,0,2,3,3,3,3,1,Arts,Bachelors,31-35,8,0,0,Flexible,Tier3_City,4,2,3,5,3,0,2,7.68,Other,5,4,3,5,0,4,2,4,3,5,0,0,3,3,65.25
Music,Lawyer,3.592021259100356,9,2,0,1,1,0,0,4,1,4,4,0,4,1,Arts,Bachelors,40+,7,0,0,Hybrid,Tier2_City,3,4,3,2,2,1,1,27.39,Healthcare,1,1,3,1,0,0,3,4,1,2,1,0,1,1,43.49
Education,Analytical Chemist,3.66639500626801,6,0,4,1,7,1,2,1,3,1,1,0,4,0,Arts,Bachelors,18-24,14,0,0,Flexible,Tier3_City,4,3,3,5,3,0,4,29.59,Tech,5,2,1,5,0,0,4,4,1,3,1,0,2,1,50.17
Law,Electrical Engineer,4.4892607952058246,4,1,3,0,1,0,3,1,1,0,1,3,4,0,Arts,Bachelors,40+,2,0,0,Hybrid,Tier2_City,5,3,1,1,5,0,3,3.08,Healthcare,5,2,3,5,4,0,3,1,3,2,1,1,3,2,45.18
Architecture,Physicist,3.894428455538309,9,2,0,0,5,1,4,2,3,4,4,1,3,1,Interdisciplinary,Bachelors,25-30,13,0,0,Hybrid,Any,2,3,4,2,2,1,3,49.05,Finance,5,1,2,5,5,0,5,4,4,3,1,1,2,2,71.45
Music,Sound Engineer,3.721481942624379,6,0,0,0,1,0,2,2,0,2,2,3,1,1,Arts,PhD,31-35,5,0,0,Office,Tier1_City,1,1,3,1,1,0,5,17.2,Healthcare,1,3,2,3,3,3,1,2,1,2,1,0,3,3,47.53
Music,Legal Secretary,2.829793593318892,9,2,3,1,2,0,0,3,3,1,2,2,0,0,Arts,Bachelors,18-24,11,0,0,Office,Tier3_City,4,2,4,2,3,5,3,6.63,Education,1,3,3,2,2,5,1,3,2,1,0,0,1,3,48.45
Marketing,Special Education Teacher,2.7333733027154232,2,0,0,1,6,1,4,4,3,1,3,2,1,0,Commerce,Bachelors,25-30,13,0,0,Remote,Tier1_City,1,1,2,5,4,0,3,43.16,Manufacturing,5,3,1,2,0,3,2,4,5,3,1,0,5,4,72.26
Business,Organic Chemist,4.83321359430871,7,0,3,0,4,1,1,4,3,3,3,3,0,0,Commerce,Masters,31-35,13,0,0,Office,Tier1_City,4,1,0,4,2,2,4,10.14,Tech,4,5,5,1,3,4,1,5,1,3,0,1,2,4,59.3
Education,Biologist,3.414348222991472,9,2,3,0,9,1,1,0,4,0,2,4,2,1,Arts,PhD,31-35,11,0,0,Office,Tier1_City,4,5,0,3,1,0,2,4.17,Tech,2,5,2,2,2,1,5,3,3,3,1,0,1,1,61.52
Chemistry,Risk Analyst,3.6776012698733846,1,1,0,1,8,0,0,1,0,4,0,0,0,1,Science,Bachelors,18-24,3,0,0,Flexible,Tier2_City,2,3,2,1,0,0,2,26.25,Education,5,3,4,1,2,0,3,1,1,1,0,1,2,3,23.23
Psychology,Education Administrator,3.1894378081392203,8,0,2,0,4,0,4,4,0,4,3,4,4,1,Arts,Masters,25-30,6,0,0,Flexible,Tier3_City,5,1,0,5,2,2,4,9.11,Other,4,3,5,1,3,1,4,2,3,5,1,1,3,3,64.92
Architecture,Quantum Physicist,4.076350776210536,7,1,0,1,2,1,3,3,4,4,3,0,3,1,Interdisciplinary,Masters,18-24,0,0,0,Office,Tier2_City,3,2,2,4,2,1,3,49.17,Healthcare,2,1,4,2,0,0,1,2,3,3,1,0,3,3,54.84
Education,Ecologist,3.083627181717348,7,2,3,1,8,1,3,3,3,0,4,1,3,1,Arts,Masters,40+,0,1,35,Office,Tier1_City,5,5,0,5,5,5,1,3.49,Tech,5,5,2,5,0,4,4,5,4,3,1,0,5,4,53.97
Computer Science,Interior Designer,3.775216457300359,0,0,1,1,2,1,2,3,2,4,2,4,3,0,Science,Bachelors,36-40,13,0,0,Flexible,Any,1,5,2,1,4,0,2,5.41,Other,2,4,3,5,1,2,2,4,1,4,0,0,4,5,67.29
Physics,Software Developer,3.142942163500748,9,0,2,1,4,1,3,2,0,4,2,4,0,0,Science,Masters,18-24,14,1,44,Flexible,Tier1_City,1,4,2,3,5,5,4,42.16,Finance,5,3,4,3,3,0,1,5,5,1,1,0,1,5,65.56
Computer Science,Nuclear Physicist,2.857634765149681,4,0,3,1,8,0,3,1,2,2,1,4,0,1,Science,Bachelors,36-40,11,0,0,Office,Any,4,4,0,5,2,4,1,14.27,Finance,1,3,1,1,5,2,2,4,1,4,1,1,4,2,51.34
Chemistry,Art Therapist,3.0489628578842884,0,1,3,0,4,0,3,2,1,1,2,0,4,0,Science,Masters,36-40,11,1,54,Office,Any,5,5,4,2,2,5,3,45.85,Healthcare,5,3,4,4,2,5,3,4,3,2,0,0,3,5,56.11
Education,Physical Chemist,4.700071694247695,1,0,2,0,1,0,4,0,3,1,0,0,0,1,Arts,Masters,25-30,5,0,0,Remote,Tier2_City,2,2,3,4,4,1,4,17.62,Finance,5,2,1,4,4,0,3,2,1,1,0,1,2,2,42.28
Finance,Legal Consultant,2.7041371813786954,7,1,3,0,3,1,0,0,2,4,1,0,0,0,Commerce,Bachelors,31-35,9,1,25,Office,Tier1_City,3,1,3,5,4,1,2,6.28,Manufacturing,5,5,5,2,4,1,5,2,5,5,1,1,4,5,56.68
Finance,Advertising Manager,3.870960513864112,2,2,1,1,2,0,1,0,0,4,3,4,4,0,Commerce,Masters,25-30,10,0,0,Remote,Tier2_City,5,4,1,4,3,0,1,3.5,Education,5,4,5,2,5,5,1,4,4,5,1,0,5,2,64.8
Physics,Biotechnologist,3.396924776817116,2,2,4,0,0,0,2,1,2,0,3,3,3,1,Science,High School,31-35,12,0,0,Hybrid,Tier3_City,4,1,5,2,1,2,1,16.28,Tech,4,2,3,4,0,0,4,2,4,1,0,1,2,1,49.26
Music,Sound Engineer,4.643818823860016,4,2,4,0,5,1,3,3,4,2,2,1,1,1,Arts,Masters,25-30,12,0,0,Hybrid,Tier2_City,1,2,5,3,1,1,2,25.27,Other,3,2,1,3,1,1,1,2,4,3,1,1,1,1,68.23
Education,Surgeon,4.23026783850119,7,2,0,1,0,1,2,1,1,3,1,2,2,0,Arts,Bachelors,25-30,13,1,29,Hybrid,Tier1_City,5,1,1,3,3,2,1,3.05,Education,4,4,3,1,5,2,3,2,3,1,0,0,3,4,50.55
Business,Graphic Designer,4.871818546657677,8,0,1,1,4,0,0,3,1,2,3,4,2,1,Commerce,Bachelors,25-30,6,1,38,Hybrid,Tier3_City,1,5,0,2,1,4,2,30.31,Healthcare,4,4,4,1,4,3,2,4,2,2,1,0,3,4,45.81
Psychology,Legal Secretary,3.8693062226014767,0,1,3,1,3,0,4,4,1,3,2,4,4,1,Arts,Bachelors,18-24,12,0,0,Flexible,Tier2_City,4,4,3,4,2,2,4,18.68,Education,1,4,3,2,0,5,5,4,3,2,0,1,2,3,62.1
Psychology,Inorganic Chemist,3.84651380000932,8,2,1,1,9,1,3,4,1,3,1,3,0,1,Arts,PhD,36-40,8,0,0,Office,Tier1_City,1,2,5,5,3,3,5,21.34,Tech,5,4,4,2,1,2,4,3,5,1,0,1,2,1,65.6
Music,Biotechnologist,3.345941659998906,8,2,1,0,0,1,2,2,3,0,2,0,0,1,Arts,Bachelors,25-30,14,0,0,Hybrid,Any,4,5,1,2,3,2,3,15.29,Other,4,4,5,5,4,3,2,2,4,3,0,0,2,4,61.52
Law,Architectural Technologist,3.2964978001870566,7,1,0,0,1,0,0,4,1,3,2,4,3,1,Arts,Bachelors,25-30,6,0,0,Office,Any,3,2,3,1,1,1,4,27.87,Tech,2,3,3,3,2,4,4,4,3,5,1,0,1,2,53.98
Finance,Physician Assistant,3.5596884761895966,8,1,3,0,5,1,0,1,4,3,1,4,0,1,Commerce,Bachelors,36-40,8,0,0,Flexible,Tier1_City,2,4,2,4,0,2,3,13.82,Healthcare,5,4,5,1,4,4,5,2,3,5,0,0,5,1,52.38
Biology,Financial Analyst,2.8253727302701828,8,1,1,1,5,1,3,3,3,3,1,0,1,1,Science,Masters,25-30,9,1,52,Hybrid,Tier1_City,1,1,4,3,1,2,3,9.34,Tech,1,4,4,5,4,4,5,3,4,4,1,1,1,1,67.33
Medicine,Human Resources Specialist,3.0168468072358703,3,0,2,0,0,1,4,1,4,3,4,4,1,1,Science,Bachelors,25-30,13,0,0,Hybrid,Tier2_City,5,2,2,2,5,3,2,44.86,Finance,1,5,1,4,4,5,4,3,1,1,1,0,4,2,64.48
Chemistry,Biologist,4.322227480817178,3,0,0,0,8,0,2,0,1,2,4,4,0,0,Science,Bachelors,40+,8,0,0,Hybrid,Tier1_City,3,4,1,3,0,3,5,21.36,Other,2,3,2,5,4,4,3,1,5,3,0,1,4,2,58.73
Marketing,Physical Chemist,4.033556700504597,6,2,2,1,9,0,3,3,3,1,0,0,2,0,Commerce,Bachelors,36-40,13,0,0,Flexible,Tier1_City,2,5,1,4,3,0,3,6.62,Other,1,2,4,4,0,0,2,4,2,2,1,1,4,1,55.15
Biology,Architect,3.861066913189536,2,2,4,0,1,0,3,1,3,1,4,3,0,0,Science,Bachelors,18-24,13,0,0,Hybrid,Any,5,4,0,3,0,1,3,13.83,Education,5,3,4,4,3,5,2,3,2,1,1,1,3,3,54.06
Computer Science,Nurse,2.718556866477795,0,0,3,1,3,0,1,2,0,4,4,2,1,1,Science,Bachelors,25-30,7,0,0,Flexible,Any,5,1,4,2,2,0,4,17.57,Manufacturing,3,1,2,1,2,2,1,4,5,4,1,0,4,1,54.48
Business,Psychologist,2.871303433268613,5,0,0,1,3,0,1,1,2,1,3,2,1,0,Commerce,Bachelors,40+,6,0,0,Hybrid,Tier1_City,4,4,5,4,4,3,5,39.17,Manufacturing,3,4,2,5,3,1,2,4,3,3,0,1,5,1,50.0
Computer Science,Brand Manager,4.306337179954657,5,1,1,1,0,0,4,3,4,2,3,2,2,1,Science,Masters,25-30,11,0,0,Remote,Tier3_City,2,5,4,1,0,2,5,4.05,Manufacturing,4,2,5,1,0,0,3,2,4,5,1,1,5,3,74.04
Psychology,Music Therapist,4.37317614342917,4,2,2,0,5,1,1,4,0,0,2,0,3,0,Arts,Bachelors,25-30,2,0,0,Remote,Tier1_City,5,5,3,2,5,3,3,25.48,Healthcare,1,1,4,3,4,5,3,4,4,3,0,0,1,1,44.45
Engineering,Animator,2.8230654884352093,6,2,0,1,8,0,1,0,0,3,3,0,3,0,Science,Bachelors,18-24,10,0,0,Hybrid,Tier1_City,5,2,0,5,4,4,5,22.16,Manufacturing,5,2,4,3,1,5,4,2,5,3,0,0,3,2,55.6
Law,Actuary,4.651102892377385,2,0,2,0,5,0,2,3,1,1,3,1,2,0,Arts,Bachelors,18-24,13,0,0,Hybrid,Tier1_City,5,5,4,2,2,2,4,48.51,Other,2,3,3,3,1,0,1,2,5,5,1,0,5,5,62.05
Physics,Physicist,4.689109142714154,3,2,0,0,2,1,0,0,1,1,3,1,0,1,Science,PhD,31-35,2,1,23,Hybrid,Tier1_City,3,3,1,4,5,0,2,11.46,Other,2,1,2,3,3,4,2,2,4,3,1,1,3,2,50.69
Physics,Physician Assistant,4.186650399066633,2,2,1,1,2,0,0,2,2,4,3,4,1,0,Science,PhD,31-35,10,0,0,Hybrid,Tier2_City,2,5,2,2,4,2,3,32.51,Education,5,4,1,4,5,5,2,5,4,5,0,0,3,3,74.73
Business,Physician Assistant,4.766849597934712,5,1,0,1,4,0,3,4,2,1,4,3,1,1,Commerce,Masters,40+,4,1,58,Hybrid,Tier3_City,4,1,2,1,2,4,1,12.5,Tech,5,4,4,3,1,0,5,4,5,2,0,1,5,3,59.06
Computer Science,Inorganic Chemist,4.049797933586833,3,1,2,0,0,0,0,2,1,2,3,1,2,1,Science,Bachelors,31-35,6,0,0,Office,Tier2_City,3,5,5,1,4,3,3,28.78,Finance,2,1,3,1,3,1,4,3,3,3,0,0,5,3,43.92
Chemistry,Clinical Psychologist,3.135909397000863,4,2,2,0,7,1,4,4,1,1,0,3,1,1,Science,Bachelors,18-24,12,0,0,Office,Tier2_City,3,2,4,5,4,1,3,29.09,Manufacturing,1,3,1,5,2,2,1,4,2,2,0,1,5,1,55.29
Biology,Aerospace Engineer,4.943530531242189,5,2,4,1,3,1,2,4,2,3,0,4,0,1,Science,Bachelors,18-24,11,0,0,Office,Tier1_City,3,5,2,3,1,5,2,6.54,Manufacturing,4,1,5,5,1,4,3,1,2,1,0,0,5,3,54.65
Marketing,Interior Designer,4.088235683274903,5,1,0,1,1,1,4,3,0,1,2,1,0,0,Commerce,Bachelors,40+,9,0,0,Flexible,Tier3_City,4,4,1,4,5,1,1,24.45,Manufacturing,4,3,3,1,5,4,2,4,1,1,0,0,2,2,45.52
Medicine,Principal,3.5581140273732066,8,0,0,1,6,0,1,0,2,1,3,3,0,0,Science,Bachelors,25-30,6,1,49,Hybrid,Tier1_City,4,4,3,4,5,1,1,24.67,Finance,4,2,1,2,4,1,2,5,5,5,1,0,4,2,57.1
Chemistry,Chemical Engineer,2.808252279193703,1,1,2,1,7,1,0,2,0,1,4,1,0,0,Science,Masters,25-30,0,0,0,Remote,Tier1_City,3,4,1,3,0,3,1,18.0,Education,5,3,4,2,0,0,5,1,1,5,1,1,2,3,37.13
Art,Chemist,2.712943160398153,9,2,1,0,6,0,0,1,4,4,2,4,0,0,Arts,Masters,36-40,7,0,0,Remote,Tier1_City,3,3,4,1,5,1,2,16.03,Manufacturing,2,1,3,2,2,1,5,1,1,4,0,0,1,5,59.7
Physics,Legal Analyst,3.2321983184262058,0,2,2,0,6,1,0,3,2,2,4,0,0,1,Science,Masters,25-30,0,0,0,Hybrid,Tier1_City,1,2,5,1,5,4,5,13.54,Tech,2,1,2,2,1,3,2,2,2,3,1,1,2,3,43.19
Medicine,Human Resources Specialist,3.517897530750993,8,0,0,0,4,0,3,3,2,3,3,3,2,1,Science,Bachelors,18-24,12,0,0,Hybrid,Tier2_City,4,4,1,2,4,3,1,3.28,Healthcare,2,2,1,4,1,2,2,3,4,1,0,0,1,2,67.91
Physics,Doctor,2.6624144260946494,6,2,4,1,2,0,3,4,4,1,3,0,2,1,Science,Masters,36-40,13,0,0,Flexible,Tier1_City,5,4,1,5,3,1,5,3.09,Finance,2,1,4,4,3,2,5,1,4,3,0,0,2,1,68.03
Marketing,Legal Secretary,3.80968195563605,8,0,0,0,4,0,4,3,2,0,1,0,0,1,Commerce,Bachelors,40+,10,0,0,Office,Tier3_City,2,4,2,5,1,5,4,30.72,Education,2,5,3,5,2,1,3,5,4,2,0,1,1,4,56.62
Physics,Social Media Manager,4.583758242764162,0,1,4,0,6,0,1,1,2,0,2,4,2,1,Science,Bachelors,18-24,3,0,0,Remote,Any,2,2,5,5,0,0,2,16.7,Other,3,1,1,5,0,5,2,3,5,4,1,0,4,4,52.05
Music,Financial Controller,2.8796886398404764,8,1,3,0,2,1,3,1,2,2,0,0,1,0,Arts,Masters,36-40,1,0,0,Hybrid,Tier1_City,2,4,3,2,1,3,5,10.89,Tech,5,5,5,4,0,5,4,4,2,4,0,1,4,5,39.04
Art,Clinical Psychologist,4.8411186035787495,5,2,1,1,1,0,4,2,2,3,2,2,3,0,Arts,High School,25-30,4,0,0,Office,Tier2_City,3,3,5,5,0,3,1,35.18,Finance,5,1,5,4,3,2,2,5,5,2,0,0,4,2,50.66
Medicine,Counselor,3.800045051694316,9,0,2,0,3,1,0,4,2,4,2,2,3,0,Science,Bachelors,25-30,5,0,0,Flexible,Tier2_City,4,4,0,3,2,2,1,27.86,Other,3,1,2,5,3,2,4,3,5,1,1,0,5,3,55.27
Medicine,Nuclear Physicist,4.750815445759139,5,1,3,1,7,0,4,4,3,4,3,2,4,0,Science,Bachelors,36-40,3,0,0,Remote,Any,1,1,4,2,4,1,5,46.0,Finance,4,2,3,1,3,5,5,5,3,4,0,0,3,2,57.42
Medicine,Counselor,2.6618032185845744,1,0,1,0,4,1,4,3,0,2,4,1,2,0,Science,Masters,40+,13,0,0,Hybrid,Tier1_City,1,3,4,3,5,0,5,42.06,Healthcare,1,5,3,4,1,0,3,1,4,2,0,0,1,1,69.37
Chemistry,Entrepreneur,2.662676390252148,9,2,3,0,4,1,4,1,3,4,0,4,1,1,Science,Masters,25-30,11,0,0,Flexible,Tier2_City,2,1,1,2,5,5,4,37.16,Healthcare,5,2,2,1,2,4,1,2,3,5,0,0,1,4,72.87
Education,Principal,3.1445773239529062,3,0,1,1,8,0,0,0,1,0,2,2,1,1,Arts,Bachelors,18-24,12,0,0,Flexible,Tier1_City,5,4,2,5,3,4,2,8.95,Other,5,5,3,3,0,4,1,2,3,2,1,1,5,1,43.4
Chemistry,Manager,4.531172061030071,4,1,4,1,4,0,3,0,1,4,4,2,1,1,Science,Masters,18-24,3,0,0,Hybrid,Tier2_City,5,4,2,3,1,3,3,34.31,Other,3,5,5,1,4,4,1,3,2,1,0,0,4,2,41.87
Physics,Construction Manager,4.8622518682930185,1,2,1,1,5,1,0,1,0,0,1,4,0,1,Science,Bachelors,25-30,6,1,28,Remote,Tier1_City,5,2,4,3,1,4,4,35.61,Education,5,4,5,1,0,1,5,2,4,3,0,0,1,4,40.32
Biology,Marketing Specialist,4.842914330032631,7,2,1,0,2,0,0,0,2,3,0,1,4,0,Science,Bachelors,18-24,10,0,0,Hybrid,Tier1_City,5,1,5,3,1,4,4,38.88,Manufacturing,5,5,2,4,5,1,5,1,1,2,1,1,4,3,43.09
Law,Interior Designer,2.9841266178524712,4,1,0,1,4,1,0,4,1,3,1,3,4,1,Arts,Masters,25-30,3,0,0,Flexible,Tier1_City,1,1,0,2,5,4,4,15.37,Other,4,2,4,3,2,4,2,5,3,2,0,0,4,2,48.96
Engineering,Construction Manager,4.572850872078353,5,0,4,1,2,1,2,1,1,4,3,1,3,0,Science,Masters,18-24,1,1,52,Hybrid,Tier1_City,1,5,0,4,1,2,1,33.09,Healthcare,3,2,2,2,3,3,3,2,3,4,0,1,2,3,49.19
Medicine,Marketing Manager,4.12644865422656,0,2,1,1,8,0,0,4,4,4,0,0,3,0,Science,PhD,25-30,3,0,0,Flexible,Tier1_City,4,5,3,5,4,4,5,32.06,Education,5,3,5,1,1,3,3,1,1,3,1,1,4,4,51.14
Law,Pharmacist,3.223101863978832,3,2,3,0,9,0,1,3,2,3,2,0,0,1,Arts,Bachelors,18-24,6,0,0,Hybrid,Tier2_City,1,5,1,3,0,1,2,21.11,Finance,2,1,2,3,0,0,2,5,1,5,0,0,1,2,45.29
Art,Education Administrator,3.1431220887959403,0,1,1,1,6,0,2,3,4,4,0,3,3,1,Arts,Masters,36-40,0,0,0,Hybrid,Tier2_City,4,5,4,4,5,1,1,34.18,Manufacturing,3,4,5,3,4,1,3,1,2,3,0,1,4,4,49.18
Music,Interior Designer,4.9389613665231975,8,0,2,0,3,1,2,4,3,3,4,2,0,0,Arts,Masters,18-24,14,1,32,Office,Tier2_City,4,1,5,5,4,0,4,7.07,Tech,4,1,4,4,1,4,3,3,3,3,1,0,4,4,71.37
Law,Clinical Psychologist,2.5109795049928474,3,2,1,0,9,0,0,3,2,1,3,4,2,1,Arts,PhD,25-30,3,1,52,Hybrid,Tier1_City,3,2,0,5,2,0,2,33.24,Finance,1,2,5,3,0,3,2,5,3,3,1,1,3,2,53.0
Psychology,Doctor,4.0403756355849465,3,1,0,0,5,0,1,4,2,0,0,0,0,0,Arts,Bachelors,36-40,5,0,0,Hybrid,Tier1_City,1,5,0,3,4,5,1,31.48,Education,5,4,3,2,2,4,5,5,2,2,0,0,4,5,40.8
Psychology,Education Administrator,4.581038963403907,8,0,1,0,5,0,0,3,4,0,3,3,0,1,Arts,Masters,31-35,7,0,0,Hybrid,Tier3_City,5,1,2,3,4,4,3,12.9,Tech,2,5,1,4,0,2,1,1,1,2,0,0,5,1,55.11
Music,Inorganic Chemist,2.9227230960760884,7,1,0,0,1,1,3,1,0,3,3,1,4,0,Arts,Masters,18-24,7,0,0,Office,Tier1_City,2,2,3,2,2,4,4,41.46,Finance,2,2,4,1,4,3,2,2,3,2,1,0,4,3,51.96
Biology,Chemical Engineer,3.828375390598664,8,1,2,0,1,0,3,3,0,0,4,3,0,0,Science,Bachelors,18-24,12,0,0,Remote,Any,4,2,4,4,4,2,1,44.1,Healthcare,1,2,1,4,1,4,2,3,1,3,0,1,4,4,59.21
Marketing,Marketing Manager,2.939410596524798,9,2,0,1,2,0,0,2,4,1,0,0,3,0,Commerce,Bachelors,31-35,8,0,0,Hybrid,Any,2,5,3,4,0,4,1,12.89,Education,3,2,4,1,0,1,1,2,5,2,0,1,3,4,47.11
Engineering,Landscape Architect,3.4532106714927333,8,2,1,0,0,0,4,1,4,1,1,3,3,1,Science,Bachelors,25-30,4,0,0,Office,Tier1_City,5,1,0,3,5,4,4,6.57,Tech,4,2,4,4,4,1,1,4,3,2,1,1,5,2,54.2
Education,Musician,3.33026028104501,0,1,1,0,0,1,0,4,1,1,4,0,3,0,Arts,Masters,31-35,13,0,0,Hybrid,Any,4,3,3,5,3,4,3,31.37,Other,5,4,4,3,0,2,4,3,5,3,0,0,5,3,63.42
Medicine,Architectural Technologist,3.1432563556430457,7,1,4,1,1,0,4,2,2,4,2,3,0,0,Science,Masters,25-30,1,1,33,Flexible,Tier2_City,4,1,0,3,2,3,5,25.56,Healthcare,5,1,4,2,0,2,4,3,3,5,1,1,2,1,58.39
Music,Teacher,4.672651361576454,1,2,3,1,4,1,1,1,3,1,0,3,4,0,Arts,Masters,25-30,2,0,0,Hybrid,Tier2_City,1,2,5,5,5,3,3,23.1,Other,5,1,5,4,5,0,4,1,1,2,0,1,4,5,42.92
Education,Chemist,4.48785418308666,4,1,4,1,5,0,4,3,1,2,1,2,4,0,Arts,Masters,25-30,1,0,0,Hybrid,Any,3,4,2,5,1,2,4,38.77,Other,2,5,3,5,3,4,5,1,5,4,0,1,2,4,57.88
Finance,Industrial-Organizational Psychologist,2.530400184466809,9,1,4,1,1,1,4,3,3,4,3,0,1,0,Commerce,Bachelors,31-35,8,1,54,Hybrid,Tier2_City,2,5,5,3,0,2,5,48.57,Tech,3,2,5,3,4,3,2,3,2,4,0,1,1,2,57.37
Education,Dentist,3.3892772094880668,5,2,3,0,2,1,4,1,3,2,4,2,0,0,Arts,Bachelors,36-40,5,1,26,Office,Tier3_City,5,2,1,1,3,1,1,25.45,Manufacturing,1,2,5,4,0,3,4,3,4,4,0,1,1,4,61.33
Architecture,Actuary,3.0360111617067647,2,0,0,1,4,1,1,0,3,2,2,2,3,0,Interdisciplinary,Bachelors,18-24,13,0,0,Remote,Tier2_City,3,3,4,4,0,2,3,3.29,Manufacturing,3,1,3,3,5,5,5,5,2,3,1,0,3,4,47.67
Marketing,Aerospace Engineer,2.56954780393383,2,2,3,0,2,0,1,3,0,3,1,3,2,1,Commerce,Bachelors,25-30,10,0,0,Flexible,Tier3_City,3,3,1,5,0,5,3,31.02,Education,4,5,4,5,1,5,1,2,2,5,0,1,2,5,58.3
Music,Marketing Specialist,2.839658286289489,1,0,0,1,4,0,4,0,0,2,4,4,3,1,Arts,Bachelors,18-24,11,0,0,Remote,Tier2_City,1,3,3,5,1,1,5,33.74,Tech,4,3,3,3,2,3,4,1,5,5,0,0,1,3,67.3
Biology,Market Research Analyst,2.626020329769576,2,1,4,0,7,0,3,2,0,3,2,1,2,1,Science,Bachelors,25-30,0,1,43,Hybrid,Tier1_City,4,3,0,1,3,4,1,41.92,Manufacturing,1,4,1,3,3,0,2,5,5,2,0,1,3,5,45.3
Psychology,AI Researcher,3.74775967805369,3,0,4,0,5,0,1,2,4,0,1,2,0,0,Arts,Bachelors,36-40,2,0,0,Hybrid,Tier1_City,5,1,1,2,0,2,3,12.37,Finance,2,1,3,4,5,4,3,4,2,5,1,1,1,5,44.01
Medicine,AI Researcher,3.97655772520341,2,0,3,1,5,1,0,2,4,1,3,0,2,1,Science,Bachelors,25-30,6,0,0,Remote,Any,3,2,2,1,1,5,5,27.64,Finance,1,4,5,3,3,2,5,3,5,3,0,1,2,1,49.59
Biology,Graphic Designer,4.060912345758588,6,0,0,1,5,0,0,3,4,0,4,1,3,1,Science,Bachelors,36-40,6,0,0,Remote,Tier1_City,3,3,5,1,2,2,3,24.02,Manufacturing,4,1,4,4,3,0,5,1,2,2,1,0,2,4,46.3
Medicine,Investment Banker,3.818525097911266,0,2,1,0,3,0,2,4,1,0,3,3,0,1,Science,Bachelors,31-35,4,0,0,Remote,Tier2_City,2,2,3,5,1,2,1,34.23,Other,2,5,5,2,2,2,1,3,3,3,0,0,3,5,44.49
Marketing,Accountant,4.803985972920811,6,2,1,1,4,1,4,3,0,2,0,0,1,1,Commerce,Bachelors,36-40,2,1,41,Remote,Tier1_City,5,2,3,4,4,1,1,6.01,Other,3,2,1,5,4,0,1,5,4,4,1,0,2,4,47.12
Computer Science,Aerospace Engineer,2.7903236880134403,2,1,3,0,8,1,0,1,3,3,1,2,3,1,Science,PhD,31-35,12,0,0,Flexible,Tier1_City,5,4,1,1,5,1,2,44.55,Manufacturing,4,3,4,1,1,0,1,3,3,3,1,0,4,3,64.71
Architecture,Special Education Teacher,2.638654141796821,7,0,0,0,0,1,4,4,0,2,4,0,1,1,Interdisciplinary,Masters,18-24,14,0,0,Flexible,Tier1_City,3,1,3,2,1,0,5,27.02,Education,2,4,2,5,2,3,4,3,5,4,0,0,2,2,72.58
Architecture,School Psychologist,3.8864361359450856,3,2,0,0,2,0,4,2,3,2,0,0,0,1,Interdisciplinary,Masters,18-24,6,0,0,Remote,Tier1_City,4,4,4,3,1,1,4,44.22,Other,2,3,5,3,1,0,1,5,2,1,1,1,4,4,45.77
Music,AI Researcher,4.014771031920608,3,1,3,1,1,0,1,2,2,3,2,4,0,0,Arts,Bachelors,25-30,4,0,0,Remote,Tier2_City,5,5,1,1,1,1,3,18.99,Education,5,2,5,4,1,3,3,2,3,3,1,0,5,3,49.23
Psychology,Conductor,4.09098845763941,4,1,4,1,4,0,1,1,4,4,2,0,2,1,Arts,Masters,18-24,5,0,0,Flexible,Any,5,5,1,1,0,3,1,33.72,Finance,3,1,3,1,3,5,5,5,2,4,1,0,3,3,50.13
Law,Paralegal,4.235607433834202,2,2,4,1,5,1,4,3,3,3,2,4,1,0,Arts,Masters,25-30,2,1,9,Remote,Tier2_City,2,5,5,2,3,2,3,47.97,Healthcare,2,5,4,1,0,3,5,3,3,5,1,1,3,4,64.01
Medicine,Doctor,3.635793911606589,5,0,2,0,3,0,1,2,1,3,1,1,4,0,Science,Masters,25-30,5,1,39,Flexible,Tier2_City,2,4,2,4,1,1,3,47.34,Tech,1,2,5,3,1,3,1,2,1,2,0,0,1,1,42.83
Art,Legal Secretary,4.779288423117746,3,0,0,0,9,0,2,4,0,0,0,0,4,1,Arts,Bachelors,40+,6,0,0,Remote,Tier2_City,2,2,3,1,1,2,4,47.37,Healthcare,3,3,1,1,1,1,2,5,1,1,1,1,5,5,33.14
Law,Doctor,2.5849561305404163,0,0,1,0,1,1,0,0,0,0,2,0,0,1,Arts,Masters,25-30,13,0,0,Office,Any,4,5,2,1,4,2,1,5.02,Education,3,3,4,4,1,5,5,5,1,4,1,0,1,5,44.68
Chemistry,Digital Marketing Specialist,2.91042564945114,7,2,1,0,1,1,0,0,2,1,1,3,3,1,Science,Masters,31-35,7,1,22,Hybrid,Tier2_City,4,5,3,4,4,3,2,21.94,Other,4,3,4,3,1,3,4,1,4,2,1,0,1,5,53.61
Physics,Education Administrator,3.477371050255698,7,0,2,1,0,0,3,4,4,4,0,1,4,1,Science,Masters,36-40,1,0,0,Remote,Tier1_City,5,4,1,2,2,2,5,5.86,Healthcare,3,1,3,5,3,5,2,5,3,1,0,0,3,1,49.13
Finance,Brand Manager,2.600116376385076,8,1,3,0,0,0,4,4,0,3,2,0,2,0,Commerce,Masters,36-40,1,1,44,Remote,Tier2_City,4,2,3,1,2,5,3,17.55,Education,3,3,5,3,1,4,2,3,5,4,0,0,4,4,53.45
Law,Counselor,4.4721047310848485,5,2,2,1,3,0,1,1,4,4,0,3,4,0,Arts,Bachelors,18-24,13,0,0,Office,Tier3_City,2,5,2,4,4,1,4,11.21,Healthcare,5,1,5,3,0,4,3,1,3,3,1,1,1,5,60.7
Marketing,Psychologist,2.9374676468015606,6,0,4,0,9,1,0,3,3,2,3,3,3,1,Commerce,Bachelors,25-30,5,0,0,Hybrid,Tier3_City,4,1,1,1,3,2,4,32.15,Finance,3,3,2,1,5,0,1,2,2,5,1,0,2,4,54.92
Marketing,Curriculum Developer,4.201347457002729,2,0,2,0,0,0,0,4,0,2,3,2,2,1,Commerce,High School,25-30,7,0,0,Hybrid,Any,5,5,5,3,2,0,5,39.7,Education,2,4,2,2,4,2,4,1,3,5,0,0,5,1,48.3
Education,Aerospace Engineer,3.9717035506879945,2,1,2,1,6,1,3,1,4,2,2,0,1,1,Arts,Masters,25-30,4,1,33,Remote,Tier1_City,3,4,3,5,5,0,5,27.13,Finance,1,4,4,1,4,4,2,4,3,3,0,0,3,2,55.16
Law,Music Teacher,4.670804684278981,4,2,3,0,0,0,2,1,0,2,3,0,0,0,Arts,Bachelors,25-30,13,1,38,Hybrid,Any,1,4,2,3,5,3,1,40.39,Healthcare,5,2,5,2,1,5,2,2,1,5,0,0,3,1,56.13
Biology,Accountant,3.418297859085923,8,0,4,0,2,1,4,3,3,3,1,1,3,0,Science,Bachelors,36-40,0,0,0,Hybrid,Tier1_City,4,1,5,1,3,5,3,3.6,Manufacturing,5,2,3,3,3,2,1,4,2,1,1,1,4,1,41.83
Medicine,Surgeon,3.0578199631808545,5,0,1,0,1,0,2,0,2,1,3,2,0,1,Science,Bachelors,25-30,10,0,0,Hybrid,Tier1_City,3,2,3,2,4,1,3,41.56,Manufacturing,5,5,5,3,0,3,4,3,3,4,1,1,5,3,59.23
Psychology,Chemical Engineer,3.662947899767944,4,0,3,0,1,0,2,4,4,1,0,3,3,0,Arts,Bachelors,25-30,0,0,0,Remote,Tier2_City,5,1,5,5,2,3,5,11.38,Tech,5,3,3,5,0,2,1,2,4,5,1,1,5,2,53.73
Psychology,Manager,4.872518471397738,5,2,0,0,8,1,3,1,4,4,1,4,0,0,Arts,Bachelors,40+,9,0,0,Hybrid,Tier1_City,3,5,2,3,1,0,2,24.66,Manufacturing,4,3,2,1,1,3,4,2,5,1,1,0,5,3,57.35
Biology,Biomedical Engineer,4.690852572470332,6,1,1,1,1,1,1,2,0,3,1,0,4,1,Science,Masters,18-24,8,0,0,Office,Tier2_City,3,4,4,4,4,5,3,23.8,Tech,5,1,1,5,3,1,1,1,1,4,0,0,3,3,53.11
Finance,Clinical Psychologist,4.26958508566941,1,1,4,1,1,1,2,0,4,1,4,0,0,1,Commerce,Masters,25-30,3,0,0,Flexible,Any,3,2,2,2,2,1,4,44.04,Healthcare,4,2,5,4,4,5,1,4,3,5,0,0,2,4,53.63
Physics,Mechanical Engineer,2.5789322803613595,0,0,0,1,5,0,3,3,0,3,0,4,3,0,Science,Bachelors,31-35,11,0,0,Office,Any,2,5,0,3,3,2,5,48.4,Tech,4,4,2,3,5,0,1,4,2,1,0,0,3,5,54.77
Psychology,Quantum Physicist,2.756898033556556,4,1,1,0,6,1,1,1,0,2,2,2,3,0,Arts,Bachelors,18-24,9,0,0,Remote,Tier2_City,4,1,3,4,5,1,3,14.99,Tech,3,1,1,5,2,2,3,1,1,2,1,0,3,5,46.33
Biology,Architect,4.140348785585896,0,2,2,0,8,1,1,2,1,0,0,0,1,1,Science,Bachelors,31-35,0,0,0,Remote,Tier2_City,3,5,0,1,3,4,1,6.17,Tech,1,4,1,4,1,2,1,1,1,2,0,0,3,3,26.07
Music,Organic Chemist,3.660172560762738,0,1,2,1,7,1,4,2,3,4,0,0,1,0,Arts,Masters,18-24,10,0,0,Remote,Any,5,1,4,4,2,1,5,33.57,Finance,3,1,2,2,1,5,2,1,3,3,1,1,2,1,63.18
Medicine,Nurse,4.425464503233561,8,2,0,1,8,0,4,3,3,0,4,2,2,1,Science,Bachelors,36-40,7,0,0,Remote,Tier2_City,1,3,2,3,3,2,4,26.63,Tech,4,2,2,1,1,2,3,1,2,4,1,1,3,4,57.49
Finance,Manager,4.68324854679364,7,2,2,0,0,1,3,1,4,1,0,0,2,1,Commerce,Bachelors,25-30,1,1,35,Remote,Any,1,3,5,3,2,4,1,29.59,Other,3,3,2,4,3,0,1,5,2,4,1,1,3,3,41.31
Psychology,Conductor,3.598212589235391,6,2,0,1,0,0,1,0,1,2,3,1,1,0,Arts,Bachelors,25-30,11,0,0,Remote,Any,1,4,1,1,2,5,5,5.17,Education,2,3,3,1,2,1,4,1,4,3,0,0,5,4,48.99
Education,Web Developer,3.4987549922436463,0,1,4,0,3,1,3,3,4,1,0,3,4,0,Arts,Masters,25-30,1,0,0,Remote,Tier1_City,2,2,1,4,3,3,5,39.44,Healthcare,5,2,4,3,3,0,5,1,1,1,1,1,5,1,44.58
Physics,Counselor,3.3447487145190222,5,1,2,0,7,1,0,4,4,4,1,4,2,1,Science,Masters,18-24,0,0,0,Remote,Tier1_City,4,4,5,4,0,5,3,13.92,Finance,5,4,4,2,1,4,3,1,4,5,1,0,4,1,52.21
Architecture,Advertising Manager,4.616532566658067,2,0,2,0,7,1,1,2,4,1,0,4,4,0,Interdisciplinary,Masters,25-30,0,1,13,Hybrid,Tier2_City,1,5,2,1,1,1,1,18.74,Education,4,5,4,3,2,0,4,5,2,3,1,0,1,1,43.7
Education,Nurse,2.593167460584694,8,2,1,0,0,1,2,0,4,1,0,4,0,0,Arts,Masters,25-30,8,0,0,Remote,Any,2,3,4,4,4,3,5,13.73,Healthcare,3,5,3,4,0,4,3,3,5,1,0,0,2,4,57.23
Art,Inorganic Chemist,2.871241435540828,4,0,1,1,0,1,2,0,0,1,2,3,3,0,Arts,Bachelors,25-30,12,0,0,Remote,Tier3_City,5,4,5,1,5,1,4,47.46,Finance,2,2,2,2,0,2,4,3,5,4,1,1,4,2,56.96
Finance,Principal,4.464301170361594,2,2,2,1,1,0,1,0,0,3,3,4,2,0,Commerce,Bachelors,25-30,0,1,7,Office,Tier2_City,5,1,2,2,1,0,1,10.93,Healthcare,2,1,4,4,5,1,2,1,5,4,0,1,3,1,47.28
Physics,Judge,4.816803983391161,1,2,3,0,1,1,2,2,0,3,0,4,1,1,Science,High School,25-30,5,0,0,Remote,Tier1_City,2,2,5,3,4,0,3,37.42,Manufacturing,2,3,3,1,2,3,4,2,3,5,1,0,3,2,45.79
Physics,Brand Manager,3.3002000947730585,7,0,0,0,2,0,1,4,3,4,4,4,4,0,Science,Bachelors,25-30,11,0,0,Remote,Tier1_City,4,3,1,2,4,2,2,14.55,Healthcare,4,4,3,3,1,1,2,5,3,4,1,0,1,3,70.59
Education,Biomedical Engineer,4.957343533703352,0,1,1,1,5,1,0,2,4,1,0,0,0,1,Arts,Bachelors,31-35,6,0,0,Remote,Any,5,2,1,5,5,5,5,22.97,Manufacturing,3,5,2,1,3,4,4,1,2,3,0,0,5,2,41.67
Engineering,Special Education Teacher,4.365414511289016,1,1,1,1,2,1,1,1,4,3,1,1,4,1,Science,Bachelors,25-30,3,1,41,Hybrid,Tier2_City,4,2,1,5,1,0,2,49.81,Manufacturing,2,3,1,2,1,1,3,5,4,1,1,1,2,4,41.78
Music,Architectural Technologist,3.8038361922724073,9,1,1,1,8,0,4,3,2,0,0,0,2,1,Arts,Bachelors,18-24,4,0,0,Office,Tier2_City,2,3,2,5,5,4,5,7.73,Other,2,2,3,5,2,5,5,5,3,2,0,0,4,2,47.29
Music,Fluid Mechanics Engineer,4.027502192003178,5,2,2,1,7,1,0,3,3,1,0,3,0,0,Arts,PhD,31-35,3,0,0,Remote,Any,5,1,4,1,2,4,3,44.42,Healthcare,3,3,5,1,5,2,3,3,2,3,1,0,5,4,43.72
Marketing,Nuclear Physicist,4.513801950788883,1,0,2,1,2,0,2,1,2,4,0,1,4,0,Commerce,Masters,36-40,3,0,0,Hybrid,Any,5,1,4,4,5,1,3,47.46,Manufacturing,3,5,3,2,1,0,2,4,5,4,0,1,4,5,55.82
Psychology,Sound Engineer,2.740900897113145,8,0,4,0,5,1,2,0,0,4,4,4,0,1,Arts,Masters,25-30,9,0,0,Office,Tier2_City,3,1,4,2,3,3,3,35.82,Other,5,4,1,2,1,4,4,4,5,2,0,1,1,1,65.28
Finance,Market Research Analyst,2.842687724940971,7,1,3,1,5,1,1,0,4,0,2,0,0,0,Commerce,Masters,25-30,14,1,50,Hybrid,Tier2_City,5,2,5,2,0,4,3,3.47,Finance,1,1,1,4,0,4,4,4,1,3,1,1,4,2,47.86
Chemistry,Marketing Manager,4.921824776069605,1,0,4,1,9,1,0,4,2,2,4,0,3,1,Science,Bachelors,25-30,14,0,0,Flexible,Tier3_City,1,1,1,2,0,1,1,41.58,Manufacturing,1,1,5,1,4,4,4,1,4,1,0,1,4,1,49.38
Chemistry,Composer,3.839950242822825,9,0,2,1,1,0,2,2,4,2,3,1,4,1,Science,Masters,25-30,0,0,0,Flexible,Tier1_City,3,5,3,2,0,3,1,44.47,Tech,2,3,4,3,3,2,5,4,2,4,1,1,5,3,49.27
Engineering,Art Director,2.890378627964299,5,2,1,0,0,1,0,2,2,1,3,1,2,1,Science,Bachelors,31-35,5,1,38,Remote,Tier2_City,2,5,5,5,1,0,5,49.1,Finance,3,1,3,1,5,1,3,1,2,5,1,1,3,2,44.16
Psychology,Physical Chemist,3.100139515503696,2,0,4,0,5,0,1,1,1,3,2,2,1,0,Arts,Masters,18-24,13,0,0,Hybrid,Tier1_City,1,1,2,2,1,1,1,42.45,Other,5,5,2,4,1,4,3,2,5,1,1,1,3,5,56.38
Law,Pharmacist,4.731014095973839,1,1,0,1,1,1,2,2,4,1,2,2,3,1,Arts,Bachelors,31-35,9,0,0,Office,Tier3_City,1,1,1,4,2,3,5,23.94,Finance,4,4,2,2,0,3,4,3,3,2,0,0,4,3,53.54
Marketing,Inorganic Chemist,3.886349861667633,0,2,3,0,2,0,1,2,0,0,1,1,2,1,Commerce,PhD,18-24,13,0,0,Flexible,Any,4,3,4,5,0,2,1,35.37,Finance,1,1,5,3,4,4,4,2,3,5,1,1,4,5,58.89
Chemistry,Doctor,3.456400202142431,4,2,4,0,3,0,1,3,3,0,1,4,0,1,Science,Bachelors,25-30,9,0,0,Office,Any,3,3,2,2,2,5,1,25.8,Tech,1,1,1,5,0,1,4,1,2,5,0,1,1,3,58.56
Music,Quantum Physicist,4.240342843160789,2,0,3,0,7,1,2,4,2,2,1,2,0,0,Arts,Bachelors,36-40,6,0,0,Remote,Tier1_City,4,4,5,1,0,5,1,19.59,Tech,3,2,4,3,1,1,3,2,3,1,1,1,2,4,47.19
Business,Fluid Mechanics Engineer,3.087536686440691,9,2,3,1,2,0,2,2,1,4,3,1,0,1,Commerce,PhD,25-30,6,0,0,Remote,Tier2_City,3,2,4,3,1,2,4,32.44,Tech,4,1,3,1,3,3,5,4,2,3,1,0,4,4,53.18
Law,Accountant,3.8653807143555294,1,2,4,1,3,0,4,3,3,2,4,2,0,1,Arts,High School,18-24,7,0,0,Office,Tier1_City,3,2,0,3,3,4,3,39.18,Tech,1,1,3,3,4,0,4,2,1,5,0,1,4,4,59.18
Marketing,Illustrator,3.976267154657036,5,0,1,0,6,0,2,4,3,4,2,1,4,1,Commerce,Masters,40+,6,0,0,Hybrid,Tier1_City,1,3,1,3,3,5,4,32.89,Other,5,5,3,1,1,4,4,5,3,3,1,0,3,1,61.72
Medicine,Special Education Teacher,2.755806963491179,8,0,0,1,0,0,1,3,2,2,2,1,4,0,Science,Masters,36-40,5,0,0,Hybrid,Tier2_City,5,5,4,5,3,3,1,41.85,Tech,1,1,2,3,2,1,5,5,1,5,1,1,2,4,50.01
Marketing,Legal Consultant,2.7521862357955653,4,0,4,0,4,1,2,1,4,4,0,0,3,0,Commerce,Masters,31-35,11,0,0,Hybrid,Tier3_City,4,4,0,2,5,2,1,11.29,Other,3,2,4,1,5,3,5,3,4,5,1,1,1,1,64.03
Computer Science,Physician Assistant,3.220644832251341,7,1,2,1,5,1,4,0,2,2,4,1,0,0,Science,PhD,25-30,14,0,0,Remote,Tier1_City,4,3,4,5,3,4,4,20.56,Other,3,2,5,2,5,3,4,2,1,3,0,1,4,2,64.41
Computer Science,Physicist,2.714923494220713,0,2,3,0,0,0,3,2,4,3,0,2,0,1,Science,PhD,18-24,7,0,0,Flexible,Tier1_City,1,4,1,4,4,1,5,17.69,Education,4,2,2,2,1,2,2,1,4,1,1,1,3,3,59.26
Medicine,Architectural Technologist,2.7155459533373287,1,0,2,0,3,1,2,3,4,0,1,2,3,1,Science,Bachelors,36-40,2,0,0,Flexible,Tier2_City,5,2,3,1,0,1,3,12.12,Education,1,1,1,1,0,1,5,3,1,2,0,1,5,5,35.15
Computer Science,Game Developer,4.51816113541175,7,2,2,0,3,1,0,0,1,3,3,0,4,1,Science,Masters,25-30,8,1,46,Hybrid,Tier1_City,3,2,4,1,3,3,5,23.83,Tech,4,3,4,1,1,5,5,4,3,4,0,0,5,3,51.37
Chemistry,Landscape Architect,2.813932014214184,4,1,2,0,2,1,2,3,1,4,0,0,4,1,Science,Masters,36-40,2,1,11,Hybrid,Tier1_City,3,2,4,3,4,3,3,47.55,Other,1,3,1,5,2,1,3,4,1,4,1,1,2,3,45.4
Business,Microbiologist,2.904603407347337,1,1,2,1,4,1,0,3,2,0,2,0,4,0,Commerce,Masters,25-30,3,0,0,Office,Tier2_City,5,5,5,3,4,3,2,28.29,Finance,2,5,3,1,5,1,1,5,3,3,1,0,1,2,43.61
Law,Interior Designer,3.793846320888042,7,1,2,1,0,1,3,2,3,4,0,3,1,1,Arts,Bachelors,25-30,12,1,12,Remote,Tier2_City,3,3,0,3,4,5,3,16.46,Manufacturing,1,3,2,4,2,2,4,3,2,5,1,0,3,4,66.44
Law,Zoologist,3.3134449548884835,4,0,2,0,9,1,4,4,4,0,3,0,0,1,Arts,Masters,40+,9,1,23,Remote,Tier2_City,4,4,1,2,2,3,5,19.64,Manufacturing,3,5,4,1,1,5,1,4,2,3,0,1,5,1,58.6
Chemistry,Psychologist,4.62014144927786,6,1,1,0,1,1,0,2,2,1,1,0,4,0,Science,PhD,25-30,13,0,0,Remote,Tier1_City,4,3,4,4,2,2,3,31.81,Education,3,5,2,2,2,3,1,2,4,1,1,1,5,3,53.7
Education,Investment Banker,4.333267369787044,6,2,1,1,6,0,4,0,1,0,1,0,4,1,Arts,PhD,18-24,5,0,0,Flexible,Tier1_City,4,2,5,4,4,2,2,19.58,Tech,2,2,4,3,0,3,4,3,5,4,1,1,4,3,59.68
Art,Aerospace Engineer,4.471123447825455,4,1,1,0,8,0,1,3,2,2,3,2,1,1,Arts,Bachelors,18-24,11,1,57,Hybrid,Tier1_City,1,2,5,4,5,4,2,28.3,Healthcare,1,4,3,2,2,0,3,2,1,2,0,0,1,3,53.64
Finance,Physicist,2.9858862750354547,7,1,4,1,0,0,1,0,1,3,4,4,0,1,Commerce,High School,25-30,13,0,0,Remote,Tier1_City,3,3,2,4,3,2,1,15.89,Manufacturing,1,5,4,4,5,3,5,2,3,5,1,1,5,5,57.57
Law,Astronomer,3.5800121981773376,0,2,1,0,8,1,2,2,2,2,4,4,2,1,Arts,Bachelors,18-24,11,0,0,Hybrid,Tier1_City,1,1,5,3,0,5,2,19.26,Other,3,1,3,3,2,5,3,2,5,2,0,1,1,1,62.89
Medicine,Biochemist,3.3013151380854486,5,2,1,0,3,0,2,3,0,1,3,2,3,0,Science,Masters,25-30,7,0,0,Remote,Tier3_City,3,1,1,1,5,1,4,36.17,Other,2,2,2,2,3,1,3,3,2,3,1,1,5,3,51.71
Finance,Judge,4.506321042403485,8,1,2,1,8,1,0,3,3,2,0,1,0,1,Commerce,Masters,25-30,2,0,0,Remote,Tier1_City,4,3,0,3,1,4,5,30.48,Manufacturing,3,1,2,1,0,2,4,3,3,3,1,0,5,5,43.2
Engineering,Legal Consultant,2.8036861647293043,7,2,1,1,0,0,1,4,0,3,1,2,4,1,Science,Bachelors,31-35,12,0,0,Hybrid,Tier1_City,4,2,0,4,2,2,4,7.39,Finance,2,1,2,1,5,5,2,5,3,3,1,1,5,2,51.76
Architecture,Biomedical Engineer,4.850591729497563,9,0,3,1,3,1,0,3,0,1,0,3,1,0,Interdisciplinary,Bachelors,25-30,9,0,0,Hybrid,Tier1_City,5,4,0,3,3,3,4,48.74,Manufacturing,3,3,3,3,2,5,5,3,5,3,0,1,2,4,48.86
Marketing,Special Education Teacher,3.1007709753591968,8,2,4,1,2,1,0,1,4,2,0,4,4,0,Commerce,Bachelors,40+,5,0,0,Hybrid,Tier2_City,3,1,1,4,3,2,5,5.32,Education,5,1,1,5,5,5,5,1,3,4,1,0,1,2,52.27
Marketing,Biomedical Engineer,4.747360550692697,7,1,0,0,6,1,0,4,3,2,0,3,0,1,Commerce,Bachelors,18-24,4,0,0,Office,Tier1_City,2,3,5,5,1,0,4,6.9,Tech,1,5,1,4,1,0,4,3,5,2,1,1,2,1,49.21
Psychology,Biomedical Engineer,4.505719224563499,2,0,0,0,7,0,2,3,0,3,0,4,0,0,Arts,PhD,25-30,4,1,31,Office,Tier1_City,1,5,1,1,1,4,4,35.97,Tech,4,1,4,2,2,3,2,5,1,3,1,0,3,3,50.27
Education,Credit Analyst,4.8927248759582405,0,1,4,0,8,0,1,4,0,0,2,1,4,0,Arts,Masters,18-24,4,0,0,Hybrid,Tier1_City,4,3,4,5,3,5,4,36.28,Other,5,1,2,2,4,2,2,3,1,2,1,1,3,3,37.85
Biology,Marketing Manager,4.782691512416964,1,2,2,0,3,1,2,3,1,3,2,4,4,0,Science,Bachelors,31-35,8,0,0,Hybrid,Any,5,2,0,2,1,2,2,3.89,Manufacturing,3,3,1,4,4,4,1,1,1,3,0,1,4,5,53.77
Finance,Analytical Chemist,3.878201660816744,6,0,0,0,3,0,2,4,1,4,4,3,1,1,Commerce,Bachelors,40+,12,0,0,Hybrid,Any,5,3,5,3,3,2,5,33.21,Healthcare,2,1,5,2,5,3,1,3,2,4,1,1,4,3,65.12
Psychology,Physical Chemist,4.0841392238152645,6,2,0,1,7,1,2,4,1,3,1,4,0,0,Arts,Bachelors,36-40,6,0,0,Hybrid,Tier3_City,4,1,0,2,5,5,5,4.56,Education,4,5,2,3,0,2,3,5,5,1,0,0,2,3,54.56
Psychology,Psychologist,2.947239037616728,9,0,4,0,5,0,3,3,4,1,0,2,3,0,Arts,PhD,25-30,11,1,56,Hybrid,Tier1_City,3,1,5,3,1,1,5,48.16,Other,2,5,5,5,4,1,5,1,1,2,0,1,4,3,63.94
Finance,Lawyer,3.013492517905266,2,1,0,1,1,1,4,3,0,2,4,0,1,1,Commerce,Bachelors,25-30,8,0,0,Hybrid,Tier1_City,5,3,5,5,5,3,4,35.72,Manufacturing,2,1,1,3,4,5,5,5,2,4,1,1,1,4,57.93
Music,Risk Analyst,4.653817248684606,6,2,1,1,7,0,3,3,3,1,4,4,2,0,Arts,Bachelors,36-40,14,0,0,Remote,Tier2_City,3,4,1,4,5,3,2,11.77,Education,1,5,3,5,2,5,5,4,2,2,0,1,2,4,68.51
Finance,Quantum Physicist,2.9075444956174907,0,0,3,0,8,0,1,2,3,3,3,2,2,0,Commerce,Bachelors,36-40,8,0,0,Remote,Tier1_City,5,3,1,4,1,1,5,10.43,Healthcare,3,5,5,1,0,4,3,2,2,3,0,1,2,1,53.63
Biology,Physical Chemist,3.6596433365777328,5,2,3,1,5,1,0,0,1,1,0,2,1,1,Science,Masters,40+,12,0,0,Hybrid,Tier2_City,1,4,2,3,3,1,3,29.77,Other,1,3,5,5,3,0,2,5,1,5,0,0,2,1,52.81
Business,Civil Engineer,3.730852082583001,5,1,3,0,3,1,1,0,1,4,4,2,3,0,Commerce,Masters,25-30,13,0,0,Hybrid,Tier2_City,3,1,0,4,4,0,5,32.78,Education,2,2,2,5,2,0,2,4,3,5,1,0,5,4,66.46
Art,Dentist,3.605520710607247,1,1,4,1,2,1,4,0,4,0,0,4,0,1,Arts,Masters,40+,5,0,0,Hybrid,Tier2_City,5,5,5,5,3,5,1,42.07,Other,1,2,4,5,3,1,5,3,1,1,1,0,2,4,48.35
Art,Social Media Manager,4.823797857484889,4,1,3,1,7,1,0,4,2,3,2,3,2,0,Arts,Bachelors,18-24,13,0,0,Flexible,Tier2_City,4,4,1,4,0,4,3,45.46,Education,5,4,3,2,1,2,2,1,2,1,0,1,4,2,51.64
Medicine,Biologist,2.599927194054961,3,1,4,1,9,0,1,2,2,1,0,0,3,0,Science,Bachelors,25-30,5,0,0,Hybrid,Tier1_City,2,3,1,5,1,3,5,21.45,Education,2,2,2,5,5,4,5,5,4,4,1,1,5,1,47.69
Physics,Nuclear Physicist,3.6366378711725584,1,1,0,0,7,0,0,2,0,2,1,1,1,0,Science,Bachelors,18-24,3,1,59,Flexible,Tier3_City,4,2,4,2,2,1,4,42.67,Other,2,1,2,4,4,3,2,1,1,5,0,1,3,5,36.38
Psychology,Music Therapist,4.48725661503091,5,0,0,1,1,0,0,2,3,1,2,0,4,0,Arts,Masters,25-30,7,0,0,Hybrid,Tier3_City,3,2,0,5,1,1,5,28.49,Tech,5,5,1,1,2,1,4,4,1,5,0,0,5,4,48.06
Computer Science,Graphic Designer,3.659730304255536,4,0,1,1,3,0,1,1,1,0,3,1,2,1,Science,High School,31-35,13,0,0,Remote,Tier2_City,4,3,2,1,0,5,2,25.12,Healthcare,2,2,4,1,0,5,1,5,3,5,0,1,5,4,48.51
Finance,Illustrator,2.8048912350028425,9,2,1,0,4,0,4,3,1,2,0,4,4,0,Commerce,Masters,36-40,1,1,51,Flexible,Tier1_City,4,1,1,1,5,4,2,35.85,Other,4,3,4,2,4,5,4,3,1,2,1,0,4,3,46.01
Computer Science,Composer,4.065741282367567,9,1,3,1,4,0,2,2,0,1,0,1,4,0,Science,Masters,31-35,4,1,45,Flexible,Tier3_City,2,1,4,1,2,1,5,7.85,Tech,4,4,3,3,1,1,1,3,1,5,0,0,4,1,40.86
Finance,Brand Manager,4.830591006781066,0,1,3,1,4,0,1,2,4,3,4,3,1,1,Commerce,Masters,31-35,0,0,0,Hybrid,Any,4,1,5,3,2,0,4,15.47,Finance,3,1,3,4,5,1,2,3,2,3,0,0,3,4,54.04
Music,Biomedical Engineer,3.820843399701008,7,0,0,0,3,0,3,4,2,0,4,1,1,1,Arts,Bachelors,25-30,9,1,49,Remote,Tier2_City,5,3,4,3,3,4,4,41.39,Manufacturing,3,2,4,3,4,1,4,2,2,5,0,0,2,1,64.24
Law,Geneticist,2.863678271443142,0,1,4,0,5,0,2,1,4,0,4,4,4,0,Arts,Bachelors,31-35,13,0,0,Remote,Tier2_City,1,2,3,3,4,0,4,26.69,Other,1,5,5,5,4,3,5,3,4,2,1,0,4,3,68.93
Physics,Art Director,4.919814954909816,0,1,2,0,0,0,2,0,2,2,2,1,3,0,Science,Bachelors,25-30,1,0,0,Office,Tier3_City,2,5,5,5,3,2,5,45.68,Tech,1,3,5,3,3,1,4,2,2,3,0,0,2,1,40.77
Medicine,Mechanical Engineer,3.415085264317863,3,0,2,1,1,0,3,2,1,2,0,4,4,1,Science,Masters,36-40,0,0,0,Remote,Tier2_City,3,2,5,3,2,3,5,7.17,Other,5,2,2,4,1,0,2,5,5,5,1,1,4,1,54.72
Biology,Illustrator,4.128306164812591,8,0,4,0,4,0,4,1,4,1,2,2,2,0,Science,Masters,31-35,5,0,0,Hybrid,Any,5,1,5,2,2,1,1,17.73,Other,5,5,4,2,0,0,2,5,3,4,1,1,4,1,58.21
Music,Biologist,2.828562091139589,4,0,4,0,7,1,2,2,4,0,3,3,3,1,Arts,Bachelors,31-35,1,0,0,Hybrid,Tier3_City,3,3,0,1,4,4,2,19.71,Other,2,2,2,2,4,5,1,4,1,3,1,0,5,1,47.24
Finance,Astronomer,3.1047177059122566,9,2,1,1,8,0,2,0,2,4,0,2,1,0,Commerce,Bachelors,25-30,11,0,0,Remote,Tier3_City,2,3,4,5,1,0,3,22.87,Education,3,1,5,5,4,1,4,4,1,2,1,0,5,5,51.56
Medicine,School Counselor,3.185250281716952,7,2,1,0,8,1,1,0,3,1,1,1,4,1,Science,Masters,36-40,3,0,0,Office,Tier2_City,2,5,2,1,4,3,3,49.38,Finance,3,4,3,4,5,5,2,1,5,2,1,0,5,1,48.46
Psychology,Mechanical Engineer,4.624645909235166,8,1,1,0,5,1,1,1,3,4,1,3,1,0,Arts,Masters,25-30,12,1,8,Office,Tier1_City,4,2,0,3,5,3,2,17.6,Healthcare,3,5,4,2,0,2,4,5,3,1,0,1,4,5,61.13
Chemistry,Chemist,2.564076399722838,9,0,1,1,8,1,1,0,2,0,4,2,3,0,Science,Bachelors,25-30,4,0,0,Hybrid,Tier2_City,2,1,2,5,3,1,1,27.38,Healthcare,3,4,1,5,0,0,3,1,5,1,0,1,2,4,46.68
Biology,Composer,3.6850128614065567,9,1,1,1,5,1,2,0,0,3,1,0,0,1,Science,Masters,31-35,6,0,0,Hybrid,Tier1_City,3,5,5,4,1,3,2,28.2,Other,1,4,2,3,2,4,2,4,5,5,1,0,4,4,51.16
Physics,Biotechnologist,2.850631784029195,1,2,3,0,2,1,4,2,2,3,4,3,3,0,Science,Bachelors,25-30,9,0,0,Office,Tier2_City,2,1,4,2,3,1,1,39.23,Tech,4,3,4,4,2,5,1,1,3,5,1,0,4,5,73.12
Medicine,Legal Consultant,4.876722256427276,9,0,3,0,4,0,3,1,0,0,4,4,0,1,Science,Bachelors,36-40,0,0,0,Hybrid,Tier3_City,1,2,0,3,4,2,1,27.34,Other,5,5,1,2,4,2,1,4,1,2,0,1,5,4,34.67
Finance,Physical Chemist,4.666020681373089,4,0,1,0,4,1,1,0,4,3,1,2,2,0,Commerce,PhD,25-30,11,1,59,Hybrid,Tier2_City,4,5,4,3,1,1,4,31.47,Education,5,3,2,4,2,1,5,2,1,5,1,0,2,2,64.7
Finance,Organic Chemist,3.290702081205048,0,2,3,1,0,0,4,0,1,0,0,1,4,1,Commerce,Masters,25-30,10,0,0,Hybrid,Tier1_City,2,1,4,2,4,5,2,38.41,Education,3,4,5,2,4,3,2,4,3,5,0,0,4,3,59.89
Chemistry,Physician Assistant,4.8964656905248605,8,0,4,1,9,0,3,4,0,0,2,1,4,0,Science,Masters,36-40,4,0,0,Remote,Tier1_City,1,4,4,2,5,0,3,7.75,Other,3,1,2,2,0,5,5,5,2,4,1,0,2,3,52.17
Music,Zoologist,4.740422605405439,5,2,2,0,9,1,1,2,2,4,2,1,0,0,Arts,High School,25-30,14,0,0,Flexible,Tier1_City,3,3,5,4,0,5,5,48.28,Healthcare,1,1,3,4,2,2,1,5,3,1,1,0,4,3,50.13
Computer Science,Musician,4.651142993164735,8,1,3,0,8,1,2,1,3,2,3,1,3,0,Science,Masters,25-30,3,1,59,Hybrid,Tier3_City,3,2,1,3,2,3,5,42.78,Education,1,2,2,2,5,4,2,2,5,1,0,1,1,3,48.73
Business,Clinical Psychologist,3.1461554560703817,7,1,3,0,3,1,4,3,2,4,0,3,1,1,Commerce,Bachelors,25-30,6,0,0,Hybrid,Tier3_City,1,3,5,3,1,3,2,21.27,Manufacturing,5,2,2,3,1,5,3,2,5,3,0,0,3,4,60.71
Medicine,Market Research Analyst,2.708838647989939,0,0,4,0,4,0,2,4,1,0,1,3,3,1,Science,Bachelors,25-30,13,0,0,Office,Tier3_City,1,1,1,1,2,3,5,37.24,Tech,3,5,4,5,1,2,4,4,1,3,0,1,4,3,54.2
Marketing,School Counselor,4.123430087088962,0,1,1,1,8,0,1,0,1,1,1,4,2,1,Commerce,Bachelors,31-35,9,0,0,Hybrid,Tier1_City,2,5,2,5,0,1,1,38.83,Tech,3,1,4,1,0,0,2,5,3,1,0,1,2,1,44.16
Marketing,Financial Advisor,2.657779365565327,9,1,2,1,8,0,0,0,1,4,0,0,3,0,Commerce,Bachelors,18-24,6,1,20,Remote,Tier1_City,4,1,1,5,1,4,5,42.96,Education,5,4,5,4,4,0,5,4,3,5,0,0,5,5,46.64
Biology,Nurse,3.308289575221525,5,0,2,1,9,1,2,1,3,1,3,3,2,1,Science,Masters,36-40,7,0,0,Flexible,Any,4,4,2,1,2,1,1,11.85,Healthcare,1,1,3,4,1,3,2,4,1,2,1,0,3,4,50.71
Psychology,Accountant,3.9164313961750783,7,2,0,0,3,0,3,3,1,1,1,0,2,1,Arts,Masters,31-35,3,1,49,Remote,Tier1_City,5,4,1,5,2,0,1,36.07,Other,5,5,3,5,2,5,1,2,5,5,1,0,3,3,53.87
Finance,Mechanical Engineer,2.894942579627964,3,0,4,0,0,0,4,1,2,1,0,2,0,0,Commerce,Bachelors,18-24,3,0,0,Hybrid,Tier2_City,1,2,5,2,1,1,3,4.57,Manufacturing,1,2,5,3,3,5,1,4,1,2,1,1,1,4,39.99
Business,Construction Manager,4.1933387892025245,0,0,3,1,0,0,3,3,0,4,1,3,4,1,Commerce,Bachelors,31-35,9,0,0,Hybrid,Tier3_City,3,3,4,5,2,3,5,8.43,Manufacturing,1,2,1,1,4,2,1,4,4,5,0,0,1,3,61.85
Art,Surgeon,3.2862775906167863,4,1,4,0,0,1,3,1,4,2,3,0,1,0,Arts,Bachelors,31-35,4,0,0,Hybrid,Tier2_City,5,1,1,5,2,2,3,39.48,Other,1,3,2,3,2,5,4,2,5,1,1,1,4,2,48.48
Engineering,Social Media Manager,4.405176245950773,9,0,4,0,7,1,3,0,4,3,1,1,1,0,Science,Bachelors,18-24,4,0,0,Office,Tier2_City,1,4,3,1,1,0,5,41.21,Manufacturing,3,2,4,4,4,5,2,2,3,2,1,0,3,2,45.8
Computer Science,Teacher,2.899358974507063,0,1,0,0,9,0,0,2,3,3,3,4,4,1,Science,Masters,25-30,10,1,38,Office,Tier1_City,1,5,5,4,2,5,1,30.84,Finance,5,4,5,1,5,3,1,3,2,1,0,1,2,4,55.79
Medicine,Art Director,3.470550207435597,1,0,4,1,0,0,3,1,3,4,3,4,3,0,Science,Masters,25-30,2,1,43,Office,Any,5,1,4,5,2,2,5,30.34,Education,1,5,5,2,5,2,1,4,2,4,0,1,5,2,53.93
Architecture,Zoologist,4.429713944259856,3,1,1,0,6,1,1,3,3,4,2,2,3,1,Interdisciplinary,High School,31-35,4,0,0,Hybrid,Tier1_City,4,2,3,5,3,0,3,38.23,Manufacturing,4,2,4,4,2,1,3,3,2,1,1,0,3,1,44.73
Computer Science,Legal Secretary,2.692136751019407,5,2,1,0,1,0,1,2,2,4,2,3,4,1,Science,High School,31-35,4,0,0,Flexible,Tier1_City,1,5,4,4,5,0,4,45.59,Education,1,2,4,3,0,2,1,2,3,1,0,0,5,1,48.02
Engineering,Mechanical Engineer,3.366024482311816,6,2,2,0,7,1,2,3,0,4,1,0,1,1,Science,Masters,25-30,7,1,56,Hybrid,Tier2_City,5,3,5,1,3,3,3,22.79,Healthcare,1,4,1,5,0,5,5,5,3,1,1,1,4,5,52.72
Psychology,Paralegal,4.046262076337831,0,2,3,0,3,0,0,3,4,2,2,4,1,0,Arts,Masters,31-35,6,0,0,Hybrid,Tier1_City,2,2,5,4,0,5,4,8.4,Healthcare,1,2,3,2,0,2,1,3,2,1,0,1,1,2,51.65
Business,Curriculum Developer,2.640475599603884,3,0,2,1,1,0,2,4,4,2,0,0,2,0,Commerce,Bachelors,31-35,7,1,15,Flexible,Tier2_City,2,3,1,1,3,1,2,42.43,Other,2,4,4,1,0,1,5,1,2,3,1,0,1,4,52.04
Biology,Legal Secretary,4.378570310775405,5,2,2,0,3,1,4,3,1,4,2,4,4,0,Science,Bachelors,31-35,12,1,47,Remote,Tier2_City,3,3,0,2,3,5,3,19.06,Healthcare,4,2,5,4,2,4,4,1,4,4,0,0,5,4,73.8
Chemistry,Biologist,4.405886302888042,1,2,1,1,2,0,4,2,1,2,2,0,0,0,Science,Masters,31-35,4,0,0,Remote,Tier1_City,4,4,2,1,0,3,5,9.29,Finance,3,4,2,5,1,0,4,3,1,5,1,0,2,2,52.78
Psychology,Musician,3.633936492963229,7,2,0,1,9,0,3,1,1,3,3,0,0,0,Arts,Bachelors,25-30,11,1,44,Flexible,Tier1_City,5,3,4,2,2,3,4,31.89,Healthcare,5,2,1,5,2,2,2,1,2,4,1,1,2,5,58.26
Engineering,Illustrator,4.207062070197479,6,2,0,0,2,0,4,4,1,2,1,2,2,0,Science,High School,36-40,10,0,0,Flexible,Tier1_City,4,5,0,2,2,3,5,30.17,Education,5,5,2,3,2,3,3,5,2,1,0,0,4,3,47.17
Art,Microbiologist,3.873605699725135,6,2,1,0,0,0,4,2,2,0,1,4,1,0,Arts,Masters,31-35,1,0,0,Office,Tier1_City,4,5,0,1,3,2,4,25.29,Tech,5,3,2,5,3,1,2,4,4,5,0,1,4,3,55.23
Psychology,Marketing Manager,3.4882144501139924,0,1,1,0,5,0,2,3,1,0,0,3,1,1,Arts,Masters,36-40,7,0,0,Hybrid,Tier1_City,5,5,1,3,0,5,3,43.41,Tech,3,3,3,3,3,4,1,5,1,5,1,0,2,3,50.83
Computer Science,Education Administrator,4.729115670520532,0,0,3,0,6,0,4,2,4,1,1,0,3,1,Science,Masters,25-30,8,0,0,Hybrid,Tier3_City,1,1,4,1,2,5,3,15.79,Education,1,1,2,1,5,0,4,1,2,4,1,1,4,5,55.52
Education,Financial Controller,2.6685891521167298,0,2,2,1,0,0,4,4,0,1,2,1,1,0,Arts,Masters,18-24,1,0,0,Remote,Tier1_City,2,4,0,5,4,0,5,3.62,Tech,4,3,5,4,2,0,5,4,4,4,1,0,5,2,53.7
Business,Fluid Mechanics Engineer,2.860216854366495,9,2,3,0,1,1,4,0,2,2,0,0,3,1,Commerce,Masters,25-30,13,1,46,Hybrid,Tier1_City,3,4,2,5,1,4,3,18.2,Manufacturing,5,4,5,1,0,3,2,1,5,1,1,0,5,4,54.57
Marketing,Illustrator,4.853102128581741,2,0,0,0,9,0,1,2,4,3,2,1,0,1,Commerce,Bachelors,25-30,0,0,0,Hybrid,Tier1_City,1,5,3,3,1,1,5,3.46,Tech,2,4,4,3,3,4,4,3,1,2,1,0,3,5,37.37
Physics,Counselor,2.5429638416105376,3,1,1,1,0,1,0,2,2,4,4,0,3,0,Science,Bachelors,31-35,11,0,0,Remote,Tier2_City,4,1,1,2,5,3,1,28.55,Finance,2,3,3,1,3,3,5,5,1,5,0,1,1,5,59.8
Physics,Marketing Specialist,2.754683273690368,5,2,1,1,1,1,2,2,1,0,4,4,3,0,Science,Bachelors,25-30,5,0,0,Hybrid,Tier3_City,4,3,5,3,1,5,4,20.78,Healthcare,4,4,4,4,2,0,5,4,5,5,1,1,2,1,59.48
Law,Marketing Specialist,4.533265571223811,3,0,3,0,8,1,0,2,0,1,2,3,1,0,Arts,Bachelors,36-40,2,0,0,Hybrid,Any,5,3,1,5,3,5,5,41.26,Tech,5,5,2,4,4,5,1,2,2,1,0,1,5,1,32.56
Law,Biochemist,4.461172848160005,6,2,1,0,1,0,4,0,3,1,2,4,4,0,Arts,Masters,31-35,0,0,0,Office,Tier2_City,2,3,1,3,1,0,4,40.49,Tech,1,4,5,5,3,2,2,5,5,5,0,0,3,2,60.19
Medicine,Web Developer,4.607625760086498,0,1,3,1,7,1,2,1,4,1,2,4,0,0,Science,Masters,31-35,12,0,0,Hybrid,Tier1_City,2,4,2,1,1,1,1,23.43,Other,5,5,4,3,0,1,5,2,2,1,0,0,2,4,58.31
Biology,Conductor,3.139241515607809,9,1,3,0,0,0,3,4,2,2,2,1,2,0,Science,PhD,18-24,5,0,0,Flexible,Tier1_City,3,3,5,3,4,4,4,13.17,Finance,1,5,5,1,5,1,4,3,2,2,1,1,3,3,55.95
Marketing,Financial Advisor,4.913047297654204,3,2,0,0,0,0,1,1,2,3,3,2,2,0,Commerce,Masters,40+,11,0,0,Hybrid,Tier1_City,1,1,1,2,2,4,5,22.85,Other,5,5,4,5,2,3,2,1,4,3,1,0,2,3,65.09
Biology,Ecologist,3.199086588840861,9,0,3,1,8,1,0,0,3,2,3,2,2,1,Science,Bachelors,36-40,7,1,14,Hybrid,Tier3_City,3,1,2,1,4,3,3,33.14,Finance,2,2,1,5,4,2,1,3,4,4,0,0,4,3,55.34
Architecture,Legal Analyst,4.443832054685701,8,2,4,1,3,0,2,3,3,2,0,4,0,0,Interdisciplinary,Bachelors,31-35,8,0,0,Hybrid,Tier2_City,4,3,5,4,3,4,4,11.94,Tech,3,1,3,1,1,0,1,2,3,2,1,1,1,3,54.35
Law,Graphic Designer,3.716329454308753,0,1,4,0,7,0,4,3,4,3,3,4,1,0,Arts,Masters,25-30,12,0,0,Remote,Tier1_City,4,4,0,5,1,4,4,39.33,Manufacturing,4,4,4,3,0,1,4,4,1,2,1,0,2,2,68.56
Biology,Aerospace Engineer,3.8642255873965263,8,2,2,1,6,1,0,1,1,2,0,2,2,0,Science,Masters,25-30,5,1,28,Hybrid,Tier3_City,2,2,4,5,2,1,1,18.54,Tech,1,2,2,3,0,1,5,3,4,2,1,0,5,2,44.67
Education,Legal Consultant,2.522991840284248,8,1,2,1,9,1,3,0,2,1,3,0,1,1,Arts,Masters,18-24,11,1,30,Office,Any,4,5,0,3,5,1,2,46.81,Manufacturing,3,1,5,4,2,3,1,1,1,5,1,0,4,1,61.51
Finance,Clinical Psychologist,4.058247951335221,2,2,4,1,4,1,3,1,2,2,2,0,0,0,Commerce,Masters,25-30,5,0,0,Hybrid,Any,1,3,4,1,5,3,3,27.06,Other,1,2,5,3,1,4,1,4,2,1,0,0,3,3,45.32
Chemistry,Curriculum Developer,4.612272780700713,2,2,3,1,6,0,0,0,0,2,3,3,0,1,Science,Masters,18-24,0,0,0,Flexible,Tier1_City,1,3,1,4,1,5,5,42.81,Healthcare,4,4,3,5,0,1,5,4,4,5,1,0,2,3,47.39
Biology,Physicist,3.6840560487064025,5,1,4,1,9,1,1,2,2,3,1,0,1,1,Science,Masters,25-30,4,1,27,Hybrid,Tier1_City,3,5,0,1,1,0,1,31.95,Education,3,5,3,4,0,5,5,1,3,3,0,0,4,4,48.71
Architecture,Zoologist,3.988254578657074,9,0,1,1,9,0,1,4,3,1,0,0,3,1,Interdisciplinary,Bachelors,31-35,2,0,0,Remote,Tier1_City,1,2,2,5,5,3,5,29.07,Healthcare,3,2,1,2,2,3,5,4,2,5,1,0,2,3,43.66
Finance,Sound Engineer,2.9029453632665687,7,0,4,1,7,0,3,2,2,1,0,4,0,0,Commerce,Masters,25-30,6,1,48,Hybrid,Tier2_City,4,3,1,1,5,2,5,35.06,Tech,4,1,4,4,0,0,3,5,5,1,0,1,4,2,57.79
Architecture,Artist,4.968284967131201,9,0,3,0,2,1,3,1,2,4,1,1,2,0,Interdisciplinary,Masters,25-30,11,0,0,Office,Tier2_City,5,3,0,4,3,4,4,41.14,Tech,4,1,1,5,5,1,3,4,4,2,1,1,3,1,61.77
Medicine,Nuclear Physicist,4.141365294567283,0,1,0,0,6,0,4,3,4,0,4,4,2,1,Science,Bachelors,36-40,8,0,0,Hybrid,Any,2,2,0,3,1,0,1,33.29,Manufacturing,1,1,4,1,4,3,5,2,1,5,0,1,2,5,63.12
Art,Software Developer,2.70453425467304,6,1,0,0,8,1,3,1,1,4,1,1,4,1,Arts,Masters,18-24,12,0,0,Flexible,Tier1_City,2,5,2,2,5,5,1,40.47,Finance,3,2,4,1,1,4,5,5,3,4,1,0,5,3,63.74
Law,Psychologist,3.563844870213725,1,1,4,0,4,1,1,1,0,3,4,1,3,1,Arts,Bachelors,31-35,10,0,0,Office,Tier2_City,2,1,2,1,0,5,3,11.95,Other,4,1,3,1,3,2,4,3,3,1,1,1,3,3,46.68
Chemistry,Paralegal,3.040468963075224,1,1,1,0,5,0,1,1,2,2,2,3,1,1,Science,PhD,18-24,5,0,0,Remote,Tier3_City,5,3,0,2,5,1,2,16.04,Other,1,3,3,5,3,1,1,4,3,2,1,0,4,5,59.2
Psychology,Biotechnologist,4.5077066866698345,5,2,2,0,9,1,0,1,0,0,0,3,3,1,Arts,High School,18-24,4,0,0,Remote,Tier1_City,4,3,5,5,2,2,5,13.8,Other,5,1,4,4,1,3,2,1,2,3,1,1,5,5,32.98
Psychology,Animator,4.3202108871144365,1,0,3,0,6,1,1,2,1,4,0,0,0,1,Arts,Masters,18-24,6,0,0,Hybrid,Tier1_City,1,4,2,3,2,5,3,40.52,Manufacturing,4,1,3,1,5,2,3,5,2,5,0,1,2,4,50.59
Biology,Principal,2.6234703627729474,0,1,3,1,6,1,1,0,2,4,2,3,2,1,Science,Bachelors,31-35,10,1,52,Remote,Tier2_City,4,2,3,3,0,2,3,7.05,Finance,3,2,4,3,4,4,3,4,4,3,0,1,5,2,57.65
Business,Surgeon,2.613645821777072,0,2,1,0,9,0,1,2,1,4,3,4,3,1,Commerce,Masters,25-30,8,0,0,Hybrid,Tier3_City,3,3,5,1,3,4,5,40.41,Finance,5,4,3,2,2,5,5,2,1,1,0,0,3,3,51.09
Business,Musician,3.76044108361455,4,2,1,1,3,1,1,0,1,3,4,2,1,0,Commerce,Bachelors,36-40,4,0,0,Office,Any,4,4,5,3,1,1,4,21.28,Finance,4,2,2,1,2,1,5,4,5,5,1,0,2,5,49.45
Architecture,Manager,3.029504629429524,3,0,2,1,3,0,0,0,1,3,3,4,4,1,Interdisciplinary,Bachelors,25-30,14,1,16,Hybrid,Tier3_City,4,1,3,1,1,0,4,6.74,Finance,2,2,4,1,3,3,5,4,2,4,0,0,2,1,53.94
Marketing,Quantum Physicist,4.7105230428028175,7,1,3,0,1,0,0,4,3,0,0,4,1,1,Commerce,Bachelors,18-24,4,0,0,Hybrid,Tier3_City,2,2,2,1,5,1,5,22.95,Tech,3,3,5,2,0,2,2,5,3,3,1,0,5,5,48.41
Music,Microbiologist,2.8556163965329464,7,2,1,1,6,0,1,2,1,4,4,2,0,0,Arts,PhD,31-35,9,0,0,Hybrid,Tier2_City,4,1,0,2,2,4,1,17.12,Education,3,4,2,3,1,0,3,2,3,4,0,0,2,5,65.81
Engineering,Doctor,4.7591638648388415,1,1,3,1,9,1,2,2,3,3,1,2,2,1,Science,Bachelors,18-24,3,0,0,Remote,Tier1_City,5,4,2,3,3,5,2,30.82,Other,1,2,1,2,4,0,2,4,1,4,1,1,3,2,44.01
Law,Social Media Manager,3.795747456216404,6,0,1,0,1,0,3,0,2,4,2,3,1,0,Arts,Bachelors,31-35,4,0,0,Office,Tier3_City,2,5,2,1,3,2,4,25.21,Education,2,3,3,1,2,3,1,5,5,4,0,1,5,3,53.24
Chemistry,Quantum Physicist,3.1160327913278376,1,2,0,0,2,1,0,2,4,2,0,0,0,1,Science,Masters,18-24,6,0,0,Office,Any,3,2,4,2,3,4,2,16.95,Healthcare,4,2,1,1,1,2,2,1,4,5,1,1,1,5,53.95
Education,Electrical Engineer,4.402992204374994,4,2,2,1,3,0,2,2,3,2,3,4,1,0,Arts,Bachelors,25-30,2,1,39,Hybrid,Tier1_City,5,5,3,4,5,5,3,43.53,Healthcare,2,3,5,4,0,0,4,4,4,1,1,1,5,5,50.55
Physics,Aerospace Engineer,4.7892595046375135,3,1,0,0,6,0,2,0,0,2,0,3,0,0,Science,PhD,31-35,3,0,0,Remote,Tier1_City,5,4,1,2,1,3,3,22.12,Healthcare,4,5,3,5,3,1,3,3,2,5,0,1,1,3,48.39
Education,Conductor,4.330707068133036,2,2,3,0,9,1,2,2,4,0,2,2,2,1,Arts,Bachelors,40+,8,0,0,Office,Tier2_City,3,2,1,2,3,2,5,25.12,Manufacturing,1,1,1,4,0,3,2,1,5,2,0,1,2,2,57.03
Architecture,Teacher,3.242772101330041,9,2,0,0,1,0,3,1,3,0,1,1,4,1,Interdisciplinary,Masters,25-30,14,0,0,Hybrid,Any,1,3,1,1,5,4,5,42.79,Healthcare,5,1,2,4,4,4,3,4,2,1,0,1,1,3,56.79
Business,Geneticist,4.33055524235508,6,1,1,1,1,1,2,2,4,3,4,1,4,1,Commerce,Bachelors,36-40,11,0,0,Remote,Tier1_City,4,4,2,5,5,0,5,7.19,Other,2,2,1,4,5,5,5,1,2,5,1,1,4,2,66.7
Physics,Principal,3.736026782037807,7,1,4,1,3,0,1,0,1,1,4,2,4,0,Science,Bachelors,18-24,1,1,28,Flexible,Tier3_City,4,4,1,5,0,0,4,21.32,Healthcare,3,3,3,4,5,1,2,3,1,2,1,0,4,4,32.02
Business,Organic Chemist,2.907738053221077,3,0,3,0,4,0,2,1,0,2,0,0,0,1,Commerce,Masters,36-40,7,0,0,Office,Tier3_City,1,1,4,5,4,5,2,21.93,Healthcare,4,5,2,4,3,3,3,1,4,5,1,0,5,3,52.1
Chemistry,Analytical Chemist,4.046778004666745,3,0,3,0,9,1,2,1,2,4,4,3,2,0,Science,Masters,31-35,8,0,0,Hybrid,Tier3_City,3,5,2,2,3,5,3,26.3,Tech,2,1,5,3,0,0,2,4,3,2,0,0,4,4,59.88
Law,Marketing Manager,3.4160535443044204,4,1,4,0,8,1,3,3,3,1,0,0,2,1,Arts,Masters,18-24,4,0,0,Hybrid,Tier2_City,1,2,0,1,4,0,2,7.99,Healthcare,4,2,1,5,5,4,2,3,1,4,0,1,4,2,48.82
Art,Chemist,4.52052612886636,3,0,2,0,1,0,3,2,2,4,1,3,2,1,Arts,Bachelors,25-30,6,0,0,Flexible,Any,2,2,0,3,1,3,4,7.83,Education,2,2,4,5,4,1,2,2,1,5,1,1,1,5,54.4
Finance,Interior Designer,3.777934688672143,4,2,1,1,3,0,1,2,1,0,1,3,3,1,Commerce,Bachelors,18-24,5,0,0,Office,Tier1_City,2,3,2,2,5,1,2,22.57,Tech,3,3,3,5,5,5,4,5,3,3,0,1,2,1,49.95
Finance,Quantum Physicist,2.88434064582131,8,1,3,1,0,0,1,2,2,4,3,1,1,0,Commerce,Bachelors,25-30,0,0,0,Hybrid,Tier1_City,2,2,5,2,3,0,2,4.55,Finance,4,4,4,3,4,2,4,5,5,1,0,1,1,2,44.52
Business,Mechanical Engineer,2.532361680062106,1,2,3,0,2,0,1,0,4,4,1,0,2,1,Commerce,PhD,18-24,14,0,0,Office,Tier1_City,1,3,3,1,2,5,5,14.98,Manufacturing,4,2,4,3,4,4,2,4,3,3,1,1,5,5,59.84
Law,Industrial-Organizational Psychologist,2.9910194986732503,3,0,0,0,1,0,1,0,3,3,0,2,3,1,Arts,Bachelors,31-35,7,1,24,Remote,Tier1_City,5,2,3,4,1,5,2,12.46,Tech,5,5,1,3,1,5,2,5,3,2,1,1,5,1,44.26
Marketing,AI Researcher,2.863716968848215,6,1,0,1,4,1,2,3,0,0,3,2,4,1,Commerce,Bachelors,40+,8,0,0,Remote,Tier1_City,2,1,0,2,0,3,2,26.0,Tech,1,5,4,1,4,0,3,5,3,3,0,1,2,4,49.56
Medicine,Graphic Designer,3.457590301279646,2,0,4,0,2,1,4,2,4,1,0,1,4,1,Science,Bachelors,18-24,9,0,0,Remote,Tier1_City,1,4,1,4,0,0,2,3.52,Education,2,4,2,5,2,5,5,4,3,4,1,1,3,5,57.86
Psychology,School Counselor,3.621549139224456,1,1,4,0,3,1,3,2,4,0,3,3,1,1,Arts,Masters,25-30,10,0,0,Remote,Tier3_City,2,2,4,4,4,3,1,34.76,Other,3,5,5,2,4,4,1,4,4,5,0,0,3,3,75.86
Music,Actuary,3.705558183416031,8,2,1,0,8,0,2,4,1,0,0,3,4,1,Arts,Bachelors,25-30,0,0,0,Office,Tier2_City,2,4,2,5,5,0,3,43.21,Other,5,3,5,4,0,0,5,1,4,1,0,0,4,3,42.77
Marketing,School Psychologist,3.442307348389396,2,2,2,0,4,1,2,4,0,4,0,0,2,1,Commerce,PhD,36-40,14,0,0,Remote,Tier3_City,4,5,4,1,4,1,3,36.22,Healthcare,5,2,4,1,2,3,3,5,1,1,0,0,1,3,51.72
Medicine,Aerospace Engineer,4.261960839421026,8,2,4,1,2,0,0,4,2,1,1,3,2,1,Science,Bachelors,25-30,7,1,27,Office,Tier1_City,1,4,4,4,2,4,2,41.45,Finance,1,3,3,1,3,5,4,1,1,4,1,0,2,5,46.89
Education,Music Teacher,3.5490088287411243,0,1,0,1,0,1,3,1,2,2,1,4,1,0,Arts,Masters,25-30,2,0,0,Hybrid,Tier1_City,4,5,5,1,2,0,5,33.24,Education,3,4,4,4,5,1,3,5,5,2,0,0,4,2,54.73
Art,Cybersecurity Analyst,2.794241841170221,0,0,0,1,2,1,4,2,1,0,1,4,3,0,Arts,Bachelors,25-30,11,0,0,Hybrid,Tier1_City,3,2,4,5,0,4,5,26.85,Education,2,4,3,1,5,5,3,5,3,3,1,0,5,4,51.08
Chemistry,Psychologist,3.6839773824088695,3,1,3,1,6,1,2,0,3,3,1,2,4,1,Science,Masters,25-30,5,1,14,Hybrid,Tier1_City,2,1,2,1,3,0,5,13.29,Tech,4,3,5,3,2,3,1,2,5,3,0,1,5,5,57.18
Medicine,Brand Manager,4.453348273799989,9,2,3,1,8,1,4,3,4,3,4,1,0,0,Science,PhD,18-24,9,0,0,Hybrid,Tier1_City,2,1,1,2,0,1,3,16.14,Finance,1,1,2,1,0,4,5,5,5,4,1,1,2,1,73.87
Education,Inorganic Chemist,4.2394664536510565,1,0,3,0,9,0,1,4,1,2,2,3,4,1,Arts,Bachelors,25-30,7,0,0,Hybrid,Tier1_City,4,4,5,4,0,5,4,17.93,Education,4,4,3,5,5,3,4,4,5,1,0,1,3,5,52.94
Medicine,Curriculum Developer,4.600171133273524,3,1,2,0,0,0,0,0,1,3,1,4,2,0,Science,PhD,18-24,4,0,0,Hybrid,Tier2_City,1,1,2,1,2,4,2,4.79,Other,5,2,5,5,5,1,3,5,5,1,1,1,5,5,49.85
Law,Organic Chemist,4.204547283763455,2,0,2,1,2,0,2,4,3,1,1,1,4,0,Arts,Bachelors,25-30,7,0,0,Office,Tier1_City,5,5,5,3,4,3,3,45.92,Manufacturing,4,4,1,2,3,4,1,3,4,4,0,0,4,4,59.15
Biology,Biotechnologist,3.2861426408080137,5,1,1,1,7,1,3,4,0,1,1,3,1,0,Science,PhD,25-30,6,0,0,Hybrid,Tier1_City,5,1,0,1,2,0,5,45.31,Manufacturing,2,3,4,5,0,3,3,2,3,3,1,1,5,2,60.36
Computer Science,Investment Banker,2.9263511534682496,6,1,2,0,5,0,3,2,3,1,4,1,1,1,Science,Masters,25-30,6,0,0,Office,Tier1_City,3,1,1,4,5,5,3,8.07,Education,2,3,3,4,0,5,3,1,1,3,1,0,3,2,59.8
Medicine,Marketing Manager,3.907645315744914,6,2,3,0,0,0,4,4,0,2,1,3,0,1,Science,Bachelors,18-24,6,0,0,Office,Any,1,1,0,5,2,0,3,29.16,Tech,4,5,2,4,1,3,5,5,2,4,0,0,2,2,52.56
Law,Pharmacist,4.15548648630632,2,1,4,1,7,0,0,2,3,1,1,2,2,0,Arts,Bachelors,36-40,8,0,0,Office,Tier1_City,1,3,4,5,2,3,3,24.98,Manufacturing,4,1,4,5,1,3,5,5,4,5,0,0,4,2,58.07
Law,Education Administrator,4.756125008137885,4,1,1,0,3,1,0,2,4,1,3,4,3,1,Arts,Bachelors,36-40,5,1,34,Remote,Tier1_City,4,3,1,4,0,1,5,35.12,Tech,1,3,5,3,0,2,1,1,5,5,1,1,3,4,59.91
Engineering,Forensic Psychologist,3.229242496360154,2,0,3,1,8,0,3,4,2,2,0,0,3,0,Science,Bachelors,18-24,5,1,39,Flexible,Tier1_City,2,4,4,2,3,2,4,31.34,Healthcare,2,5,5,5,4,4,3,2,2,1,1,1,2,1,43.7
Engineering,Urban Planner,4.63219873440587,2,1,4,1,2,1,1,0,3,4,1,3,4,0,Science,Bachelors,25-30,10,0,0,Hybrid,Tier3_City,2,2,0,2,0,0,1,8.84,Healthcare,4,5,5,3,1,1,3,1,3,4,0,0,5,5,59.27
Art,Credit Analyst,3.679800274152736,5,1,4,1,7,0,4,4,1,1,3,1,3,0,Arts,Bachelors,31-35,8,0,0,Office,Tier2_City,1,2,5,5,1,3,2,34.02,Tech,3,2,3,4,5,4,3,5,3,2,0,1,5,3,54.59
Education,Pharmacist,3.7263872948756,4,2,2,0,5,0,4,0,2,1,1,1,1,0,Arts,Bachelors,18-24,14,0,0,Office,Tier1_City,5,5,2,5,2,2,2,31.62,Education,1,5,1,5,0,5,2,1,5,1,1,1,4,2,54.82
Biology,Music Teacher,2.500177000892376,2,1,0,0,3,1,2,4,0,3,0,1,2,1,Science,Masters,25-30,5,0,0,Hybrid,Tier2_City,3,5,5,4,2,0,3,27.97,Healthcare,1,1,1,2,2,4,2,1,4,3,1,1,5,4,49.39
Finance,Industrial-Organizational Psychologist,3.769319019962869,7,0,1,0,9,0,3,1,0,3,0,4,0,1,Commerce,Bachelors,25-30,6,0,0,Flexible,Tier2_City,4,4,5,2,1,4,4,21.91,Other,1,2,5,4,0,3,3,5,2,1,0,0,3,5,44.92
Engineering,Mechanical Engineer,2.72698107370906,8,2,3,0,4,0,4,0,3,1,3,4,1,1,Science,Bachelors,36-40,14,0,0,Remote,Tier1_City,1,3,1,5,2,5,5,47.88,Healthcare,1,3,4,2,0,0,5,2,5,1,0,1,2,2,60.26
Computer Science,Illustrator,3.3486554509805693,5,1,2,0,4,1,0,4,1,3,2,4,2,1,Science,Masters,36-40,6,0,0,Hybrid,Tier1_City,3,1,4,2,2,5,1,42.92,Other,4,3,2,4,3,3,1,4,2,1,1,0,1,2,51.68
Law,Forensic Psychologist,4.1911047980432095,5,0,0,0,2,0,4,2,1,4,3,4,4,0,Arts,Bachelors,25-30,1,1,43,Remote,Any,1,3,3,5,5,3,1,30.5,Manufacturing,5,5,4,1,1,0,5,2,4,2,1,0,1,5,51.42
Physics,Judge,3.8736111831640336,1,0,0,1,5,0,1,0,3,4,4,0,1,0,Science,Bachelors,25-30,12,0,0,Remote,Tier2_City,3,3,4,1,2,4,3,3.3,Education,3,4,3,1,3,2,1,4,1,4,1,1,2,4,55.49
Medicine,Graphic Designer,2.9719157419665643,7,0,1,0,2,0,1,3,3,4,0,0,1,1,Science,Bachelors,36-40,11,1,36,Office,Tier2_City,3,4,0,3,1,1,3,23.31,Tech,5,1,1,1,4,2,4,5,2,4,1,1,2,2,54.85
Business,School Counselor,2.767899592967789,8,0,0,1,3,0,0,1,0,0,4,0,2,0,Commerce,PhD,36-40,7,1,24,Remote,Tier1_City,2,3,0,1,0,2,5,35.92,Healthcare,5,1,2,2,0,0,3,5,3,1,0,0,4,1,46.26
Law,Education Administrator,2.5501043759769164,0,2,1,1,7,0,4,2,1,4,0,1,3,1,Arts,Masters,40+,11,0,0,Flexible,Tier3_City,4,2,5,5,2,3,5,8.51,Education,4,5,5,3,1,3,3,4,2,5,1,0,1,5,60.04
Art,Electrical Engineer,3.8266484206160776,9,2,3,1,7,0,4,0,1,0,4,2,1,0,Arts,Bachelors,18-24,10,0,0,Hybrid,Tier1_City,4,3,5,3,3,0,5,22.11,Healthcare,1,1,5,4,1,3,2,5,2,5,0,1,3,5,62.87
Medicine,Market Research Analyst,3.217015688971685,0,2,0,1,7,0,4,4,1,0,4,1,2,0,Science,Masters,18-24,5,0,0,Hybrid,Tier1_City,2,2,2,3,1,5,3,12.01,Manufacturing,1,2,3,1,5,4,4,5,3,5,1,0,3,4,58.89
Computer Science,Doctor,4.949026458295352,6,2,0,1,3,0,3,1,4,0,4,0,0,1,Science,Bachelors,31-35,3,0,0,Hybrid,Tier2_City,5,5,1,5,4,0,4,18.89,Education,4,5,3,2,1,4,2,4,3,1,0,1,5,4,47.12
Psychology,Astronomer,3.576234841145489,7,0,2,1,8,1,3,1,0,0,2,1,3,1,Arts,Masters,25-30,10,0,0,Remote,Tier2_City,4,5,3,5,5,2,3,4.25,Finance,4,4,3,4,0,2,5,1,2,1,1,1,1,2,51.37
Biology,Actuary,3.5010519660775405,1,2,2,1,2,0,0,1,3,4,0,3,2,0,Science,Masters,18-24,12,0,0,Flexible,Any,2,4,0,2,1,4,3,8.96,Manufacturing,2,3,3,1,0,4,2,2,2,4,1,1,4,5,54.34
Medicine,Digital Marketing Specialist,4.415123864787411,3,0,2,0,9,1,4,4,1,1,4,4,3,1,Science,Masters,18-24,6,0,0,Office,Tier1_City,3,1,1,5,0,4,1,24.37,Tech,1,1,5,1,5,4,1,2,2,2,1,1,1,5,55.1
Law,Microbiologist,4.597891159316205,8,2,2,1,0,0,2,3,3,0,0,3,4,1,Arts,Bachelors,36-40,7,0,0,Hybrid,Tier2_City,3,3,3,4,1,3,5,45.21,Education,3,3,5,1,2,4,3,3,4,3,1,1,1,5,52.82
Business,Graphic Designer,2.7511598275515543,9,1,4,1,2,0,3,3,1,1,1,2,2,1,Commerce,High School,36-40,0,1,45,Remote,Tier1_City,4,1,2,5,4,3,2,26.06,Other,2,4,3,2,3,2,5,5,3,4,0,0,5,5,37.56
Art,Electrical Engineer,4.175081452915652,8,0,0,0,6,0,0,4,0,0,4,4,1,1,Arts,Bachelors,25-30,9,0,0,Hybrid,Tier3_City,3,2,1,4,5,4,5,24.29,Healthcare,5,4,5,3,3,4,4,1,5,1,0,1,4,4,60.18
Law,Teacher,4.590538117131509,4,0,4,0,7,0,0,3,3,4,1,3,4,1,Arts,Masters,36-40,12,0,0,Remote,Tier1_City,4,1,4,5,3,3,4,40.02,Other,1,2,3,1,0,0,3,1,3,1,0,1,4,4,57.65
Law,Architectural Technologist,4.7707029224415365,9,2,0,1,4,1,0,2,4,3,4,0,4,0,Arts,Masters,25-30,12,0,0,Office,Tier2_City,1,3,5,2,4,4,4,15.59,Education,4,4,2,1,4,1,5,5,4,5,0,1,1,4,69.79
Law,Chemist,2.7077240279676733,1,1,3,0,4,1,3,2,3,3,0,3,1,1,Arts,Masters,36-40,3,1,38,Office,Tier1_City,2,1,5,4,1,2,5,7.47,Tech,4,4,3,3,5,1,4,2,2,1,0,0,5,5,43.28
Chemistry,Social Media Manager,3.137613069616109,5,2,3,0,9,0,0,1,4,4,0,2,1,1,Science,PhD,25-30,3,0,0,Hybrid,Tier2_City,5,1,3,1,4,3,5,12.85,Other,4,1,3,3,1,4,1,3,2,1,1,1,1,5,49.89
Chemistry,Chemist,3.23996796072836,4,2,3,0,3,0,3,2,4,4,3,0,2,1,Science,Bachelors,18-24,9,1,50,Flexible,Tier2_City,4,1,4,4,1,4,3,40.19,Other,1,3,2,5,0,4,1,3,4,5,1,0,2,5,66.7
Music,Legal Consultant,2.566178167728086,7,2,2,0,2,1,1,1,3,2,0,2,1,0,Arts,Masters,25-30,8,1,6,Remote,Tier1_City,5,4,5,2,3,3,2,34.82,Other,3,1,1,1,0,4,4,3,1,3,1,1,4,1,49.27
Biology,Manager,4.98813126097628,8,2,2,1,0,1,3,2,4,4,0,0,1,1,Science,Masters,25-30,12,1,16,Hybrid,Tier2_City,2,1,4,4,3,0,3,7.3,Education,4,1,4,4,0,0,3,4,4,1,1,1,3,4,63.24
Psychology,Composer,3.2077490554539967,1,0,1,0,4,0,4,1,0,2,2,3,0,1,Arts,PhD,25-30,5,0,0,Office,Tier1_City,2,3,5,5,0,5,1,34.35,Healthcare,1,5,3,5,1,2,1,4,2,5,1,0,1,4,61.93
Chemistry,Musician,4.152594899283876,8,0,4,1,4,1,4,3,0,2,0,3,2,1,Science,PhD,18-24,3,0,0,Remote,Tier3_City,1,3,3,5,3,0,1,46.78,Other,5,5,2,4,1,1,5,5,3,5,0,0,1,3,61.43
Architecture,Interior Designer,2.8764529449449423,6,0,3,1,8,1,3,2,2,4,4,0,3,1,Interdisciplinary,Masters,40+,12,0,0,Hybrid,Tier2_City,2,1,4,2,2,1,4,5.11,Manufacturing,2,2,2,3,5,3,3,3,3,2,0,1,4,3,63.05
Medicine,Clinical Psychologist,2.770380893327048,3,2,3,0,9,0,3,1,0,2,2,0,1,1,Science,Bachelors,18-24,0,0,0,Hybrid,Any,3,4,3,3,4,4,4,31.97,Manufacturing,1,2,5,5,0,4,4,1,3,1,1,0,3,4,39.02
Chemistry,Pharmacist,3.0949005045744946,8,1,0,1,9,1,4,0,1,4,0,1,3,0,Science,Masters,18-24,7,0,0,Hybrid,Tier1_City,5,2,4,5,4,1,2,20.82,Healthcare,1,4,3,2,2,3,1,4,1,3,0,1,2,3,47.8
Business,Electrical Engineer,3.907816743915832,1,0,4,0,5,0,4,4,1,2,4,4,0,0,Commerce,Bachelors,25-30,10,0,0,Hybrid,Tier1_City,2,1,2,1,1,4,4,26.55,Finance,4,2,2,5,3,5,1,4,5,3,0,0,2,1,70.64
Marketing,Brand Manager,4.588656511524854,3,1,3,1,0,0,2,3,4,4,3,1,1,1,Commerce,Masters,25-30,8,0,0,Hybrid,Tier1_City,2,4,2,2,3,5,1,27.82,Finance,2,2,1,5,5,0,2,5,5,4,0,1,3,2,76.83
Medicine,Lawyer,2.5817938507228293,2,1,4,0,8,0,2,2,4,3,3,2,3,0,Science,PhD,25-30,4,0,0,Hybrid,Tier1_City,5,5,1,4,0,3,2,39.24,Manufacturing,2,4,1,3,2,5,2,4,2,1,0,0,2,4,53.94
Physics,Ecologist,2.635398082593409,4,2,4,0,4,0,2,0,2,2,3,4,3,0,Science,Bachelors,31-35,4,0,0,Remote,Tier1_City,5,3,4,4,0,4,1,29.18,Other,4,3,4,1,2,2,3,5,3,5,0,1,2,5,48.49
Psychology,Sound Engineer,3.333233872506088,2,1,3,1,0,1,3,3,2,3,0,1,3,1,Arts,Masters,25-30,9,0,0,Remote,Tier1_City,1,5,2,1,0,0,5,30.88,Tech,3,4,5,3,0,3,3,1,3,5,0,1,5,1,58.95
Biology,Accountant,4.666600552395334,1,0,4,1,5,0,0,2,0,1,3,3,2,1,Science,Bachelors,31-35,7,1,17,Hybrid,Any,2,3,2,5,5,3,5,18.65,Education,1,4,5,3,1,4,4,5,3,2,1,0,4,3,47.95
Music,Mechanical Engineer,3.8783570157564378,4,2,3,0,2,0,3,4,4,0,2,1,1,0,Arts,Bachelors,31-35,7,0,0,Remote,Tier2_City,3,2,2,2,2,5,2,8.92,Healthcare,4,3,5,3,3,4,4,3,3,5,1,1,2,1,62.82
Marketing,Forensic Psychologist,3.708773885264708,4,1,3,1,3,0,2,1,4,3,3,0,2,0,Commerce,Bachelors,18-24,4,0,0,Flexible,Tier2_City,3,4,0,1,3,0,3,35.09,Tech,3,4,3,4,2,0,4,4,4,5,1,0,3,1,61.09
Computer Science,Financial Advisor,3.2903094965888564,3,1,3,1,5,1,4,3,1,0,3,0,2,1,Science,Masters,25-30,3,0,0,Office,Tier3_City,1,2,4,5,0,3,4,3.02,Other,4,5,1,2,4,5,2,2,2,4,1,0,5,4,47.55
Business,Biomedical Engineer,2.972804592464388,5,1,2,1,0,0,0,3,1,4,3,3,0,0,Commerce,PhD,36-40,5,1,24,Hybrid,Tier1_City,2,5,1,2,2,4,2,18.45,Education,5,2,3,4,1,4,1,5,4,5,0,0,1,1,63.2
Music,Social Media Manager,4.329333253456779,5,1,4,0,8,1,0,3,1,1,4,0,0,0,Arts,PhD,18-24,9,1,36,Office,Any,5,4,2,4,4,4,4,13.25,Manufacturing,3,4,2,5,5,3,1,1,1,2,1,0,4,1,56.4
Finance,Composer,4.677810890359408,5,0,1,0,8,1,1,1,2,0,3,4,3,0,Commerce,Bachelors,25-30,4,0,0,Hybrid,Tier2_City,3,5,3,2,1,0,1,21.26,Healthcare,3,1,4,3,1,2,4,3,2,2,0,1,5,3,42.1
Medicine,Chemist,3.0092964507703543,4,2,1,0,9,1,2,3,0,4,1,1,1,1,Science,Masters,36-40,7,0,0,Remote,Tier1_City,2,1,0,3,3,2,3,17.63,Tech,2,2,4,1,3,4,2,5,3,4,1,1,2,1,56.19
Finance,Advertising Manager,2.6352784736583232,0,2,3,0,7,0,2,0,3,2,0,3,3,1,Commerce,Masters,25-30,8,0,0,Hybrid,Tier3_City,1,5,4,2,3,4,4,36.1,Education,1,5,3,3,3,4,4,3,3,3,0,1,2,2,58.31
Marketing,Digital Marketing Specialist,4.759924798573758,5,2,1,0,8,0,1,4,1,2,4,0,3,1,Commerce,Bachelors,25-30,12,0,0,Office,Tier2_City,1,2,5,3,5,2,5,15.23,Manufacturing,4,5,4,4,3,3,5,1,4,4,1,0,3,2,67.98
Law,Chemical Engineer,4.737779867871984,7,2,1,1,6,1,3,2,2,3,4,0,1,0,Arts,Bachelors,40+,0,1,20,Remote,Tier2_City,5,2,1,2,4,3,5,29.36,Manufacturing,4,4,3,2,0,2,3,3,5,1,0,1,1,1,46.22
Education,Financial Analyst,4.114170380810557,8,0,3,1,7,1,0,3,4,2,1,2,3,1,Arts,Bachelors,18-24,8,0,0,Hybrid,Any,1,1,2,3,3,2,1,24.42,Education,1,3,5,4,1,3,2,1,4,4,0,0,3,3,61.89
Chemistry,Illustrator,4.49268869340046,6,1,3,1,6,0,2,4,3,3,3,3,1,1,Science,PhD,18-24,12,0,0,Remote,Any,1,4,3,4,5,0,2,40.65,Finance,1,1,2,3,0,0,1,4,5,3,1,1,2,3,81.8
Biology,Nuclear Physicist,3.888507498413032,8,0,3,1,4,1,4,2,3,4,0,0,4,0,Science,Masters,36-40,8,0,0,Hybrid,Any,1,5,0,5,5,1,4,23.12,Finance,2,4,5,2,0,4,5,3,2,4,0,0,1,4,61.92
Psychology,Graphic Designer,2.88490369438604,2,2,4,1,3,1,3,3,2,2,1,4,2,0,Arts,Masters,36-40,5,1,24,Hybrid,Tier2_City,3,5,3,3,5,1,1,43.6,Education,1,3,4,1,0,1,3,2,2,1,1,1,2,2,52.41
Computer Science,Fluid Mechanics Engineer,4.81867074455551,8,1,3,1,0,1,1,0,0,2,2,1,4,1,Science,Bachelors,25-30,10,0,0,Hybrid,Tier3_City,5,5,3,3,3,0,5,3.01,Education,5,5,2,4,1,0,3,2,2,3,1,1,3,5,51.14
Business,Industrial-Organizational Psychologist,3.092058673180828,3,0,4,0,8,0,3,1,1,2,2,1,1,1,Commerce,Masters,25-30,9,1,45,Remote,Tier1_City,5,4,0,4,3,1,5,31.43,Education,2,2,1,4,5,5,3,2,1,1,0,1,4,5,50.01
Biology,Architect,3.1596921930170683,0,0,4,1,3,1,1,0,1,1,2,1,4,1,Science,High School,36-40,4,0,0,Remote,Tier3_City,5,2,3,3,3,0,5,3.46,Manufacturing,3,5,3,5,4,5,2,5,2,3,0,1,3,2,36.54
Engineering,Interior Designer,2.7948244224173595,0,0,0,1,2,1,4,3,1,0,3,0,3,1,Science,Bachelors,31-35,6,0,0,Hybrid,Tier1_City,1,1,2,1,2,4,3,36.55,Other,1,4,2,2,2,5,2,4,4,3,1,1,5,2,51.6
Finance,Art Therapist,2.5934538009939603,3,2,3,1,6,1,1,0,2,2,3,4,3,0,Commerce,Masters,25-30,10,0,0,Office,Tier2_City,1,4,0,4,5,2,3,14.04,Other,3,3,3,4,1,1,2,4,4,3,1,1,4,3,68.05
Education,Biochemist,2.8053489694771425,3,2,3,0,3,1,4,4,2,4,3,1,4,1,Arts,Bachelors,18-24,7,0,0,Hybrid,Any,3,1,4,1,2,1,5,20.86,Healthcare,2,4,2,5,1,3,1,1,5,1,1,1,4,2,63.39
Medicine,Dentist,4.0260844497782085,6,0,4,0,8,1,4,1,3,3,3,3,3,1,Science,Masters,25-30,8,1,18,Hybrid,Tier3_City,1,3,0,4,1,4,2,20.88,Manufacturing,5,5,4,1,3,1,1,1,2,1,1,0,4,3,57.27
Marketing,Architectural Technologist,4.544593053300446,8,2,3,1,8,0,1,2,1,1,4,2,0,1,Commerce,Bachelors,36-40,8,1,46,Hybrid,Any,3,1,5,3,3,1,3,42.78,Manufacturing,5,1,5,4,2,2,1,5,5,1,1,1,3,3,54.05
Medicine,Biotechnologist,3.913539310614861,1,0,4,1,8,1,2,3,3,4,3,4,2,0,Science,Masters,36-40,9,0,0,Office,Tier1_City,5,3,1,1,4,3,4,7.8,Finance,1,5,4,4,3,4,5,3,4,3,0,0,4,5,71.21
Finance,Risk Analyst,3.748083407310995,0,2,4,0,5,1,2,2,4,3,4,2,4,0,Commerce,Bachelors,40+,10,0,0,Hybrid,Tier1_City,3,1,5,3,0,0,3,34.34,Education,5,4,1,3,4,2,5,5,3,1,1,0,1,4,59.57
Computer Science,Chemist,2.8913875726109666,7,2,0,1,0,1,4,2,1,2,4,1,2,0,Science,Masters,36-40,2,0,0,Remote,Any,2,3,5,4,1,0,4,49.12,Manufacturing,4,3,4,4,5,2,4,2,2,2,0,0,5,2,49.22
Finance,Pharmacist,4.416735718970175,3,2,4,1,8,0,0,3,0,3,2,0,3,0,Commerce,Bachelors,25-30,12,0,0,Remote,Tier2_City,4,5,2,3,0,4,3,4.05,Manufacturing,2,4,2,1,0,3,4,4,1,2,0,1,3,4,39.18
Physics,Web Developer,4.541825346935029,1,2,4,1,2,1,3,0,0,0,3,2,0,1,Science,High School,25-30,7,0,0,Remote,Any,1,4,4,1,0,3,5,48.4,Education,5,2,1,5,3,2,3,1,1,4,0,0,3,1,42.46
Physics,Animator,3.68162633500062,9,0,0,1,5,0,0,2,1,0,3,4,2,0,Science,PhD,31-35,0,0,0,Hybrid,Tier3_City,5,5,5,1,3,2,4,3.87,Other,2,2,2,2,4,1,3,1,3,4,1,0,3,5,48.87
Medicine,Psychologist,4.446980277892987,5,2,2,1,4,1,2,0,2,0,4,1,2,0,Science,Bachelors,31-35,6,1,11,Remote,Any,4,2,2,3,4,3,2,42.53,Healthcare,2,3,5,1,2,5,2,4,5,5,1,0,1,2,55.24
Education,Marketing Manager,3.310291093810476,7,1,1,1,4,0,2,1,2,3,3,1,0,0,Arts,Masters,25-30,11,1,46,Remote,Tier2_City,4,4,2,2,0,3,3,48.18,Finance,4,5,3,2,0,0,3,2,5,3,1,0,2,2,63.55
Law,Game Developer,3.632365709834868,5,2,4,1,0,1,0,4,3,4,2,2,2,0,Arts,PhD,18-24,14,0,0,Hybrid,Tier3_City,5,5,0,4,5,5,3,49.67,Tech,1,4,5,1,4,5,3,2,5,2,0,0,1,4,71.37
Law,Doctor,2.974140321677971,6,1,2,0,5,0,3,0,0,3,1,2,1,0,Arts,Bachelors,36-40,4,1,57,Hybrid,Tier1_City,4,1,5,4,0,2,5,24.58,Other,2,2,5,5,3,0,5,2,2,5,1,1,2,1,43.03
Biology,Zoologist,4.91075198766719,4,1,0,1,6,0,3,1,1,3,1,1,0,1,Science,Bachelors,25-30,12,0,0,Office,Any,3,4,4,3,1,2,4,43.75,Manufacturing,4,1,5,3,4,0,1,4,5,3,1,1,4,3,56.9
Chemistry,Ecologist,3.9277963905947457,3,0,2,0,3,1,4,2,0,4,2,4,0,0,Science,Masters,25-30,12,0,0,Hybrid,Tier1_City,5,1,0,2,4,3,5,8.75,Healthcare,5,2,2,5,4,1,3,5,1,1,1,0,1,4,64.02
Law,Actuary,3.997064248379866,6,2,4,1,9,1,1,2,0,3,1,1,3,0,Arts,PhD,31-35,1,0,0,Flexible,Tier1_City,5,5,1,1,4,1,4,22.99,Tech,3,5,3,2,0,4,4,2,1,3,1,1,4,5,42.92
Law,Advertising Manager,4.619017347944126,8,2,3,1,3,0,1,1,2,1,4,4,3,1,Arts,PhD,31-35,1,0,0,Flexible,Tier2_City,3,4,1,5,0,5,3,17.47,Other,1,3,2,2,1,1,4,5,1,1,0,1,4,1,39.51
Architecture,Ecologist,2.744254863110593,7,2,2,0,0,1,3,1,3,0,1,0,4,1,Interdisciplinary,Bachelors,18-24,7,1,54,Office,Tier3_City,2,5,1,5,4,1,3,21.57,Other,3,1,1,4,4,0,3,3,5,3,1,1,3,4,57.63
Psychology,Civil Engineer,3.663486943387524,7,2,0,0,1,0,0,3,1,4,1,4,2,1,Arts,Masters,36-40,4,1,44,Flexible,Tier3_City,2,2,0,3,1,3,3,35.99,Education,4,4,2,3,0,4,2,1,2,1,1,1,4,2,42.84
Biology,Data Scientist,4.414576633369844,2,2,3,1,7,1,3,0,4,0,0,0,1,1,Science,Bachelors,25-30,13,0,0,Remote,Tier1_City,4,5,0,2,1,1,3,7.11,Tech,2,4,5,5,5,3,4,5,1,1,1,1,4,4,43.25
Medicine,Legal Consultant,4.832715341686393,2,0,2,1,0,1,0,4,1,3,1,4,2,0,Science,PhD,18-24,11,0,0,Office,Tier3_City,5,2,1,2,1,2,1,49.91,Education,4,3,4,5,5,1,3,3,4,3,1,1,4,5,65.32
Education,Urban Planner,2.9136857589724685,4,0,4,0,9,1,0,3,1,3,0,1,2,1,Arts,PhD,25-30,10,0,0,Hybrid,Tier3_City,3,5,0,4,5,2,3,32.85,Other,1,1,4,2,0,2,4,4,1,2,0,0,1,5,54.79
Music,Nuclear Physicist,3.836548250060551,8,1,4,0,7,1,4,2,1,1,4,1,0,0,Arts,Bachelors,31-35,2,0,0,Office,Tier2_City,5,4,3,1,3,1,3,44.06,Other,1,1,2,3,2,2,3,3,2,5,0,0,5,5,50.85
Biology,Credit Analyst,2.820656328611776,2,0,1,0,8,1,0,1,1,1,1,3,2,0,Science,Bachelors,40+,0,1,46,Hybrid,Tier1_City,3,1,3,2,0,2,4,42.0,Other,5,1,5,5,2,2,5,3,1,1,1,0,4,4,26.51
Architecture,Mechanical Engineer,4.2563876663377,1,1,2,0,9,0,1,3,1,0,2,0,3,1,Interdisciplinary,Bachelors,36-40,10,1,12,Remote,Tier2_City,2,4,3,5,4,0,3,39.0,Healthcare,4,3,5,3,1,1,4,1,3,5,0,1,5,5,57.07
Education,Legal Consultant,2.891742744634625,1,2,2,1,4,0,0,0,1,2,4,4,0,1,Arts,Bachelors,36-40,6,0,0,Flexible,Any,2,5,2,1,1,2,3,4.84,Other,1,3,4,3,3,3,3,3,3,5,0,0,4,3,52.87
Psychology,Brand Manager,4.580794012425272,8,1,4,0,7,0,1,3,3,4,2,2,4,1,Arts,Masters,18-24,10,1,57,Remote,Any,4,5,4,1,0,3,4,27.27,Tech,4,4,3,5,4,4,5,3,3,1,0,1,5,5,59.54
Biology,Legal Analyst,3.520073900360843,3,1,1,1,6,0,4,3,2,3,0,2,4,1,Science,Bachelors,18-24,11,0,0,Office,Tier1_City,3,5,5,3,0,4,3,18.42,Finance,5,2,3,3,4,1,3,1,1,4,1,0,1,1,58.05
Education,Legal Analyst,3.0950775978569496,3,2,3,0,1,0,1,2,3,3,1,3,1,1,Arts,Bachelors,25-30,2,0,0,Office,Tier1_City,2,3,4,2,3,1,3,8.31,Healthcare,5,5,5,1,0,1,3,4,2,5,0,1,3,2,47.3
Art,Conductor,2.818859901231531,1,1,3,1,3,1,4,2,0,2,1,0,3,1,Arts,Bachelors,25-30,6,0,0,Hybrid,Tier1_City,1,2,4,3,5,5,5,19.12,Tech,4,4,1,2,0,1,2,2,5,1,1,0,2,4,50.21
Computer Science,Human Resources Specialist,4.646495957345289,5,2,1,0,9,0,0,3,3,2,1,3,4,0,Science,PhD,36-40,11,1,46,Hybrid,Tier2_City,2,1,1,2,4,1,1,33.31,Manufacturing,1,1,1,3,0,4,3,5,2,3,0,0,5,4,61.59
Physics,Legal Analyst,3.834721529944837,0,2,0,1,8,0,3,4,3,0,1,2,3,0,Science,Masters,31-35,1,0,0,Remote,Tier2_City,5,2,3,4,5,2,4,13.84,Tech,2,2,1,3,5,3,4,5,4,4,1,1,5,5,55.09
Music,Mechanical Engineer,2.684850573653053,5,1,3,0,2,0,3,0,2,1,2,1,0,0,Arts,Bachelors,40+,3,1,53,Flexible,Tier2_City,3,5,5,3,4,2,5,23.9,Tech,2,5,1,1,2,1,1,3,4,2,1,0,4,4,44.82
Music,Game Developer,4.139437358867264,4,2,4,1,0,1,3,0,0,0,4,4,1,0,Arts,Bachelors,25-30,1,0,0,Flexible,Tier2_City,1,5,3,3,1,4,2,22.01,Finance,5,1,1,4,5,5,3,2,2,3,0,0,4,4,39.69
Art,Financial Advisor,3.471231488025225,7,1,4,0,0,1,0,1,1,0,1,3,0,0,Arts,PhD,25-30,3,0,0,Office,Tier1_City,2,2,0,5,1,4,2,5.47,Healthcare,1,3,4,3,5,0,4,2,1,1,1,0,2,1,37.19
Chemistry,Marketing Specialist,4.004200214841949,9,2,3,0,7,1,1,4,0,0,4,3,3,1,Science,Masters,25-30,4,0,0,Office,Tier1_City,2,2,2,3,0,5,1,32.52,Manufacturing,5,2,5,5,0,4,3,3,3,3,1,0,5,4,51.28
Marketing,Risk Analyst,3.82522054656344,1,2,3,0,5,1,0,3,3,4,3,3,1,1,Commerce,Bachelors,18-24,14,1,18,Remote,Tier1_City,3,2,2,2,4,3,2,32.09,Other,5,3,2,4,1,5,1,5,3,2,0,0,4,2,64.79
Marketing,Surgeon,3.2287439334785484,8,2,2,1,1,0,1,2,0,0,3,3,0,0,Commerce,Bachelors,25-30,13,0,0,Hybrid,Tier1_City,1,3,3,5,4,0,1,48.42,Healthcare,5,5,4,4,0,3,1,5,5,3,0,1,3,4,60.86
Education,Nurse,2.652376289218082,8,0,4,0,0,0,4,3,4,2,2,0,2,1,Arts,Bachelors,25-30,7,1,15,Hybrid,Tier3_City,3,2,0,3,5,3,2,17.01,Healthcare,5,5,4,1,3,0,3,2,1,5,1,0,4,1,57.43
Psychology,Accountant,4.875438524551528,6,2,3,1,0,0,1,3,4,1,3,3,3,1,Arts,Bachelors,25-30,1,0,0,Hybrid,Tier1_City,2,5,3,3,1,5,2,22.69,Manufacturing,4,1,5,5,5,1,4,2,5,5,0,1,4,3,54.98
Chemistry,Architectural Technologist,4.240817077328899,6,2,0,1,1,0,2,3,0,0,2,2,3,1,Science,Masters,25-30,9,0,0,Remote,Tier2_City,4,1,1,4,2,1,5,21.97,Manufacturing,4,3,3,4,0,5,5,3,2,3,1,0,4,3,52.88
Computer Science,Composer,3.909908992869825,4,2,4,1,8,1,4,1,4,2,2,1,3,0,Science,PhD,18-24,2,1,30,Hybrid,Tier1_City,3,4,1,3,0,2,2,46.23,Finance,1,4,4,3,4,5,2,5,5,5,1,1,1,4,61.24
Architecture,Legal Consultant,4.690791094666293,3,1,0,0,4,1,3,1,2,0,4,3,1,1,Interdisciplinary,Bachelors,25-30,9,0,0,Office,Tier2_City,2,2,4,1,4,3,1,22.21,Education,1,4,4,1,4,0,3,5,4,4,1,1,5,1,61.12
Music,Clinical Psychologist,4.1620138011819,2,0,4,0,9,0,3,2,0,0,4,0,1,1,Arts,Masters,25-30,11,1,48,Remote,Tier2_City,3,2,5,5,3,2,3,23.81,Finance,3,3,2,1,0,2,4,3,5,1,0,1,5,3,53.82
Engineering,Mechanical Engineer,4.466769326324216,7,2,1,1,7,1,1,0,0,4,3,2,0,1,Science,Bachelors,18-24,12,0,0,Remote,Tier1_City,2,2,5,1,3,2,3,14.86,Other,2,5,1,1,4,5,1,3,3,5,0,1,3,1,56.39
Physics,Industrial-Organizational Psychologist,3.262963811113283,1,2,4,0,3,0,2,4,0,0,0,1,4,0,Science,Masters,25-30,4,0,0,Remote,Tier2_City,3,1,5,5,2,3,3,3.05,Manufacturing,4,2,4,2,0,3,4,4,4,1,0,0,3,3,41.84
Marketing,Artist,3.526482545538566,0,1,0,1,1,0,1,4,4,2,1,1,0,1,Commerce,Masters,25-30,10,1,6,Office,Tier1_City,2,2,4,4,1,3,1,8.19,Tech,1,3,1,4,5,5,3,2,3,2,1,1,3,1,59.09
Chemistry,Doctor,4.424072731071658,2,0,2,1,6,0,3,0,1,4,0,4,4,1,Science,Bachelors,25-30,11,1,56,Hybrid,Tier2_City,1,2,3,3,1,4,1,36.08,Tech,5,1,5,5,0,5,4,2,2,5,0,0,4,4,60.27
Medicine,Judge,3.565961869069856,6,1,3,1,1,1,1,4,1,2,0,4,2,0,Science,Bachelors,18-24,11,0,0,Remote,Tier3_City,5,2,4,3,1,5,3,35.08,Healthcare,4,4,4,5,5,5,4,2,5,3,0,0,4,3,61.34
Computer Science,Biotechnologist,3.545681783297157,1,1,2,1,6,1,4,0,1,4,4,1,0,0,Science,Masters,25-30,8,0,0,Office,Tier2_City,5,1,3,3,5,5,2,18.16,Healthcare,2,1,2,2,2,5,3,1,5,3,1,0,3,5,64.94
Business,Analytical Chemist,3.458683124901981,0,0,1,0,8,1,1,3,4,2,2,1,1,1,Commerce,Bachelors,31-35,9,0,0,Remote,Tier3_City,3,4,2,5,3,0,3,25.23,Education,4,2,2,3,5,3,3,1,5,2,1,1,5,4,62.05
Business,Quantum Physicist,3.581251910429879,9,1,3,1,1,0,2,0,0,3,2,2,4,1,Commerce,Bachelors,31-35,10,0,0,Hybrid,Tier1_City,2,5,1,3,1,4,4,16.98,Education,2,4,5,4,2,2,5,3,1,2,0,1,2,4,44.07
Business,Dentist,3.2500422082943654,5,0,2,1,2,1,0,0,1,4,3,0,3,0,Commerce,Bachelors,36-40,4,0,0,Office,Tier1_City,5,1,0,1,3,0,1,37.35,Education,3,4,1,1,4,5,3,4,1,1,0,0,5,1,33.21
Education,Human Resources Specialist,2.845498053280636,1,1,3,0,4,1,2,3,2,2,4,0,4,1,Arts,PhD,25-30,14,0,0,Hybrid,Tier1_City,5,2,0,3,2,3,4,42.6,Education,1,4,3,2,4,0,1,1,4,5,0,0,4,4,73.92
Biology,Market Research Analyst,2.55833004056694,7,1,3,0,9,0,4,4,1,2,2,0,4,0,Science,Bachelors,25-30,13,1,49,Hybrid,Tier1_City,3,3,2,4,0,5,4,45.26,Tech,2,1,5,2,1,3,4,2,3,3,0,0,3,3,58.16
Business,Musician,4.931258144625964,7,1,4,0,5,0,4,1,4,2,2,0,3,1,Commerce,Masters,36-40,8,1,6,Remote,Tier2_City,3,1,5,1,5,5,1,11.17,Manufacturing,3,5,3,4,5,1,1,4,2,5,0,0,1,4,66.06
Education,Clinical Psychologist,4.990184459562483,6,1,0,0,3,1,4,3,3,2,4,4,2,1,Arts,Bachelors,25-30,3,0,0,Remote,Tier2_City,3,2,3,3,4,0,3,35.67,Other,4,1,2,5,5,2,2,5,1,3,1,0,3,4,55.58
Marketing,Judge,3.60400263561394,9,0,2,0,4,0,0,0,4,4,3,1,0,0,Commerce,Masters,31-35,9,1,22,Hybrid,Tier3_City,4,2,5,3,2,1,5,48.26,Other,1,5,2,4,1,3,2,3,3,4,1,0,4,1,63.09
Music,Mechanical Engineer,3.089139066723705,4,1,3,1,1,0,0,1,4,1,0,1,2,0,Arts,Masters,25-30,4,0,0,Remote,Tier3_City,1,5,1,2,3,4,4,33.58,Education,2,3,4,5,0,5,3,1,5,1,0,1,2,4,50.65
Chemistry,Fluid Mechanics Engineer,2.548279720946466,9,0,2,0,7,0,3,3,0,3,1,1,2,1,Science,Masters,25-30,14,0,0,Flexible,Tier2_City,1,1,3,5,2,4,3,19.5,Finance,2,4,2,4,1,3,4,4,5,2,0,0,3,2,62.68
Art,Astronomer,3.3155159163069485,2,1,1,1,6,0,2,1,3,4,2,0,0,1,Arts,Bachelors,31-35,8,1,14,Hybrid,Tier2_City,1,1,3,1,4,4,5,32.89,Other,1,1,1,5,3,5,3,1,3,4,0,0,5,2,58.68
Law,Legal Secretary,2.877421294565441,3,1,3,1,0,0,3,0,2,4,4,1,3,1,Arts,Masters,18-24,3,1,17,Hybrid,Tier1_City,2,5,2,2,5,5,4,35.36,Education,4,2,2,2,2,4,5,1,5,1,0,1,4,3,56.23
Finance,Software Developer,3.170175521065804,4,1,2,1,9,1,2,1,4,3,4,2,1,0,Commerce,Masters,25-30,4,0,0,Remote,Tier2_City,2,3,2,4,0,2,3,21.66,Tech,4,2,4,5,5,5,1,3,1,3,1,0,1,1,54.77
Finance,Biotechnologist,3.4850882236691474,2,2,1,1,1,0,4,4,3,4,3,3,2,1,Commerce,Bachelors,18-24,4,1,41,Flexible,Tier1_City,1,3,4,5,4,5,4,7.89,Healthcare,5,5,5,4,4,0,3,1,2,5,0,0,4,3,67.45
Chemistry,Civil Engineer,2.984049795963198,2,1,3,0,0,0,4,0,4,0,4,4,0,0,Science,Bachelors,25-30,3,0,0,Hybrid,Tier2_City,3,4,2,1,5,2,3,31.51,Finance,4,5,4,3,1,2,5,3,1,2,0,1,3,4,53.08
Physics,AI Researcher,2.8011812623533023,8,0,0,0,9,1,0,3,3,1,2,4,0,0,Science,Bachelors,18-24,3,1,49,Hybrid,Tier3_City,4,4,4,3,3,5,2,40.7,Education,1,4,5,4,3,3,1,3,5,5,1,0,1,1,59.4
Education,Doctor,4.175994007663808,6,0,0,0,8,1,1,1,2,4,4,0,2,1,Arts,High School,25-30,10,0,0,Hybrid,Tier2_City,1,5,5,1,4,3,2,49.89,Tech,3,5,4,2,1,2,3,5,2,5,0,1,5,5,58.84
Psychology,Organic Chemist,3.773601506210994,3,2,3,0,6,1,0,3,4,4,4,2,1,0,Arts,Masters,31-35,4,1,40,Hybrid,Tier1_City,3,1,5,3,2,5,1,13.48,Healthcare,1,2,2,5,4,1,3,2,5,4,0,0,3,1,69.2
Art,Animator,2.5586368806088657,0,1,4,1,4,0,2,0,2,1,0,2,1,1,Arts,Bachelors,31-35,11,0,0,Hybrid,Any,5,2,0,5,1,3,5,35.92,Education,2,1,3,5,1,4,3,5,2,2,1,1,4,4,46.15
Marketing,Cybersecurity Analyst,2.7757413521793364,1,1,4,0,2,0,2,0,2,1,4,1,1,0,Commerce,Bachelors,25-30,5,0,0,Hybrid,Tier1_City,4,3,4,3,2,2,4,4.32,Tech,5,1,1,5,2,5,5,1,4,5,0,0,5,2,55.11
Marketing,Actuary,4.532557181417703,6,0,0,1,3,1,3,4,3,2,3,3,1,1,Commerce,Masters,40+,6,0,0,Hybrid,Any,2,1,4,4,3,4,4,48.58,Tech,5,5,3,2,5,0,1,5,5,1,0,1,2,4,63.28
Law,Market Research Analyst,4.902978828091328,1,1,4,0,4,0,1,2,1,1,4,4,1,1,Arts,Bachelors,25-30,14,0,0,Hybrid,Tier3_City,5,4,5,3,0,2,3,3.59,Manufacturing,3,5,1,4,1,5,4,4,4,3,1,0,2,2,60.5
Law,Artist,4.588177131213744,6,1,4,1,7,1,4,4,0,0,2,0,3,1,Arts,Bachelors,25-30,5,0,0,Remote,Tier2_City,5,3,0,4,4,0,5,19.86,Tech,2,2,2,5,3,0,5,5,1,4,0,0,2,1,46.14
Engineering,Lawyer,4.984682992266606,1,1,3,1,1,1,3,4,2,0,1,2,0,0,Science,Bachelors,36-40,14,1,56,Remote,Tier1_City,5,2,1,5,0,4,4,6.59,Education,4,3,4,3,5,1,5,5,1,4,0,0,5,4,52.39
Art,School Psychologist,2.6290882362300065,3,1,0,1,1,1,4,4,4,2,0,1,3,1,Arts,PhD,31-35,0,1,27,Remote,Any,3,4,3,5,3,5,5,32.19,Tech,4,1,4,3,1,3,5,5,1,2,0,0,2,3,46.58
Music,Entrepreneur,4.3169123540938905,4,1,4,1,5,0,1,3,3,3,1,0,0,0,Arts,Masters,31-35,14,0,0,Remote,Tier2_City,1,2,5,1,4,5,5,18.96,Finance,4,5,5,1,4,4,1,3,5,3,1,1,1,1,64.01
Computer Science,Entrepreneur,2.6537611913585173,4,2,1,0,4,0,3,3,4,4,0,1,0,0,Science,Masters,18-24,1,1,9,Flexible,Tier1_City,5,4,3,4,5,5,2,37.45,Tech,1,4,3,3,1,0,2,2,3,4,1,1,5,4,55.24
Art,Microbiologist,2.918488582606793,4,2,1,1,9,0,2,3,4,2,2,1,1,0,Arts,Bachelors,25-30,6,0,0,Hybrid,Tier2_City,1,2,2,4,5,5,4,25.86,Tech,4,5,1,1,3,5,4,5,4,4,1,0,1,1,56.72
Engineering,Doctor,3.7502581663735,3,1,2,0,6,1,1,0,3,2,3,1,4,0,Science,Masters,36-40,13,0,0,Flexible,Tier2_City,5,3,2,2,2,5,4,22.71,Other,2,5,4,5,1,2,4,5,4,1,1,1,3,1,56.32
Law,Landscape Architect,3.02742685341044,4,0,3,1,7,1,1,1,2,4,3,0,3,0,Arts,Bachelors,25-30,2,1,53,Hybrid,Tier1_City,3,5,1,2,2,2,1,19.38,Finance,5,1,2,2,0,1,4,2,4,4,0,1,2,4,49.13
Law,Mechanical Engineer,2.976155475858366,1,2,2,1,8,1,1,3,3,0,4,0,0,0,Arts,High School,31-35,11,0,0,Hybrid,Tier1_City,1,2,2,2,3,3,5,7.05,Education,1,5,4,2,4,5,2,5,5,4,1,1,4,1,60.93
Biology,Physician Assistant,2.6079487162813204,5,0,3,0,4,0,4,3,4,2,0,2,3,1,Science,High School,25-30,9,1,28,Office,Tier1_City,2,3,3,3,5,2,3,12.63,Healthcare,4,4,5,2,0,0,5,2,4,3,0,1,1,5,61.84
Architecture,Principal,3.417875811516344,3,2,1,1,0,0,0,2,0,3,4,0,1,0,Interdisciplinary,Masters,36-40,10,1,46,Hybrid,Tier1_City,4,1,5,2,4,1,2,33.04,Manufacturing,2,4,4,5,5,5,2,5,4,2,0,0,2,4,58.84
Engineering,Biochemist,4.229414540347824,8,0,4,1,0,1,0,3,4,1,1,2,3,0,Science,Bachelors,25-30,12,0,0,Hybrid,Tier1_City,5,1,5,4,5,2,1,26.35,Other,3,4,2,5,0,3,4,5,4,3,0,1,2,5,62.32
Law,Entrepreneur,4.129901660389496,7,1,4,1,2,1,0,4,0,3,2,0,0,1,Arts,Bachelors,25-30,1,0,0,Hybrid,Tier1_City,5,4,4,3,2,4,2,6.29,Healthcare,2,2,4,4,5,4,5,4,5,3,0,1,3,2,45.73
Biology,Brand Manager,3.6272465065766073,0,1,1,1,2,0,2,0,2,0,0,1,0,1,Science,High School,18-24,5,0,0,Hybrid,Tier1_City,3,5,4,5,3,5,3,28.57,Education,5,4,1,3,5,0,1,4,5,4,0,1,1,1,45.4
Engineering,Social Media Manager,2.674636866312764,6,2,3,1,3,0,3,1,2,3,3,0,0,0,Science,Bachelors,31-35,10,1,56,Office,Tier1_City,4,4,2,1,5,2,1,5.54,Education,2,1,1,5,4,3,4,4,3,4,1,0,4,2,66.02
Physics,Paralegal,3.207707016511781,8,2,2,1,0,0,4,1,3,3,4,2,0,0,Science,Masters,31-35,3,0,0,Office,Any,1,2,3,2,3,3,2,27.05,Other,2,3,4,3,4,3,5,3,4,3,0,0,1,2,63.35
Education,Principal,4.718267247871415,5,1,4,0,7,1,4,3,1,4,3,4,0,0,Arts,Bachelors,18-24,11,0,0,Flexible,Tier2_City,5,5,5,5,5,5,3,48.35,Finance,1,5,2,2,3,1,1,1,3,2,0,0,4,2,63.71
Art,Judge,2.7553684358722785,5,0,3,0,6,0,2,2,4,0,1,4,2,1,Arts,Masters,31-35,14,0,0,Flexible,Tier2_City,2,2,0,4,0,0,1,17.45,Healthcare,5,5,2,3,3,5,2,4,4,5,1,1,1,1,67.79
Law,Architectural Technologist,3.981143412722163,6,1,4,1,0,0,0,4,2,3,3,1,4,0,Arts,Bachelors,25-30,10,0,0,Hybrid,Tier2_City,2,3,0,1,5,1,3,37.0,Tech,4,5,4,4,3,3,5,1,4,1,1,1,5,2,59.72
Psychology,Zoologist,3.347379675398612,0,2,3,0,6,1,2,1,3,0,4,0,1,0,Arts,Masters,18-24,4,1,33,Remote,Tier1_City,3,5,5,5,2,4,1,38.04,Finance,5,4,2,2,0,1,5,2,1,5,1,1,2,2,47.63
Finance,Principal,4.544025622297497,2,2,1,1,1,0,3,4,4,1,3,2,4,0,Commerce,Masters,25-30,14,0,0,Remote,Any,5,1,5,1,4,3,4,22.03,Finance,3,4,1,3,5,2,2,1,1,1,0,1,3,4,65.42
Architecture,Risk Analyst,4.418817245109315,9,1,1,0,8,1,0,2,2,2,4,0,4,0,Interdisciplinary,Bachelors,18-24,5,1,28,Remote,Tier2_City,3,3,5,2,2,1,4,30.88,Manufacturing,5,4,1,4,1,5,1,2,3,1,0,1,5,2,46.22
Chemistry,Marketing Specialist,3.498165193992921,1,2,0,0,9,1,2,1,2,3,3,4,2,1,Science,Bachelors,25-30,2,0,0,Remote,Tier2_City,4,3,4,4,2,2,2,25.19,Finance,1,3,1,3,2,1,2,1,5,2,0,0,1,3,53.22
Architecture,Investment Banker,4.636023047951017,3,2,3,1,4,0,2,2,3,1,1,2,2,0,Interdisciplinary,Masters,25-30,0,0,0,Hybrid,Any,2,2,3,1,2,1,5,16.32,Healthcare,4,3,5,4,1,0,4,2,3,2,0,1,5,1,42.95
Architecture,Organic Chemist,4.523102296862377,0,1,2,0,4,1,2,0,0,1,2,2,1,1,Interdisciplinary,Masters,31-35,2,0,0,Remote,Tier3_City,2,4,5,5,3,5,5,38.47,Education,5,3,3,3,2,1,3,4,1,1,0,1,3,4,33.0
Physics,Legal Consultant,3.885979719313245,7,2,1,0,6,1,0,4,2,0,1,2,4,0,Science,Bachelors,31-35,2,1,10,Hybrid,Tier1_City,3,2,4,2,1,5,3,36.03,Other,4,3,1,2,2,4,2,4,2,1,0,1,4,5,32.92
Engineering,Surgeon,3.2193759894883485,3,0,2,0,4,0,0,1,4,2,4,1,2,1,Science,Bachelors,31-35,5,0,0,Remote,Any,4,3,3,2,1,0,1,45.33,Manufacturing,1,3,4,2,2,2,4,4,5,3,0,1,5,3,52.33
Medicine,Marketing Specialist,4.597016382673311,8,0,4,0,6,1,2,3,1,2,0,4,0,0,Science,Masters,18-24,3,0,0,Hybrid,Any,1,5,5,5,0,1,4,32.05,Other,2,5,5,1,2,1,5,2,2,1,0,0,1,5,40.05
Physics,School Psychologist,2.6645090237657283,8,0,2,0,4,0,0,4,3,2,3,4,1,0,Science,Masters,36-40,6,0,0,Remote,Any,4,1,0,5,2,1,5,21.27,Other,3,5,4,4,4,2,4,3,5,2,1,1,1,3,62.22
Education,School Counselor,4.421842593446108,9,0,3,1,6,0,0,1,3,2,0,3,0,1,Arts,Bachelors,31-35,12,0,0,Office,Tier1_City,3,3,5,1,1,5,4,36.56,Tech,5,3,2,3,3,5,5,1,1,3,0,1,2,4,49.55
Education,Principal,2.526102504452201,0,2,1,1,4,1,3,2,3,3,0,3,1,0,Arts,Bachelors,18-24,14,0,0,Office,Any,3,4,2,3,0,2,3,32.09,Healthcare,4,5,3,3,4,1,3,2,2,1,1,0,5,3,54.25
Engineering,Inorganic Chemist,4.59522593289074,5,0,0,1,7,1,0,4,2,0,4,1,0,0,Science,Bachelors,36-40,10,0,0,Hybrid,Tier2_City,4,4,1,2,3,2,3,31.98,Tech,5,3,5,3,0,3,3,4,2,3,1,0,4,1,56.51
Finance,Lawyer,3.337116954220479,1,0,4,1,4,1,3,0,2,3,2,1,0,0,Commerce,Masters,18-24,1,0,0,Flexible,Tier2_City,3,5,2,1,2,4,1,42.94,Finance,1,3,2,5,4,3,2,1,4,4,0,1,1,1,51.21
Biology,Architect,2.8154244952496192,6,1,2,1,5,0,1,4,4,4,2,2,0,1,Science,Bachelors,25-30,11,0,0,Remote,Tier1_City,2,4,3,5,4,2,5,45.79,Healthcare,2,3,2,4,3,5,3,4,2,1,0,1,2,1,58.64
Finance,Ecologist,4.223908445993966,0,1,1,0,7,0,4,1,3,0,0,3,4,0,Commerce,PhD,25-30,3,1,41,Office,Tier1_City,3,5,4,1,3,1,3,11.47,Other,1,5,1,3,1,0,2,3,4,1,0,0,5,3,51.8
Music,Electrical Engineer,3.0842222360004192,5,1,4,1,4,1,1,1,3,1,3,0,0,1,Arts,Bachelors,25-30,7,0,0,Hybrid,Tier1_City,1,4,4,5,0,0,3,17.76,Manufacturing,4,2,4,1,3,3,1,5,1,2,0,1,3,4,38.82
Business,Cybersecurity Analyst,4.35795140090502,8,1,2,0,3,1,1,1,1,3,0,1,0,1,Commerce,Bachelors,36-40,10,0,0,Hybrid,Tier2_City,2,2,0,4,3,2,4,33.56,Other,5,2,2,2,1,4,5,4,2,3,1,1,5,2,49.03
Finance,AI Researcher,2.919460065982149,0,0,1,0,0,1,3,4,4,2,2,0,2,0,Commerce,Masters,25-30,5,0,0,Remote,Tier1_City,5,1,5,5,4,5,2,29.19,Manufacturing,4,2,2,5,0,3,2,5,4,3,0,1,2,4,61.38
Art,Art Therapist,4.310403241313077,6,2,3,0,0,0,0,3,2,2,4,0,2,1,Arts,PhD,18-24,9,0,0,Remote,Tier1_City,2,1,0,5,3,5,5,33.66,Tech,1,1,2,5,2,4,3,3,2,1,0,0,1,4,56.29
Physics,Paralegal,4.360816212532555,2,0,1,1,5,0,2,2,1,4,1,0,3,0,Science,Masters,36-40,2,0,0,Flexible,Any,2,3,2,5,0,4,1,23.35,Education,5,2,3,2,5,1,3,5,1,1,0,1,3,5,33.45
Law,Judge,4.9173821899959504,7,1,1,1,7,1,0,0,0,0,3,4,2,0,Arts,Bachelors,36-40,9,0,0,Hybrid,Tier3_City,2,3,5,3,4,4,1,22.38,Other,4,2,5,5,4,5,5,4,2,2,0,1,1,4,45.73
Art,Mechanical Engineer,4.206152256477707,4,2,2,1,5,0,4,2,3,4,0,2,4,1,Arts,Masters,31-35,11,0,0,Remote,Tier2_City,4,2,2,5,4,1,4,8.53,Manufacturing,5,2,1,1,5,1,5,3,2,1,1,1,4,2,58.2
Art,Judge,4.403881828897793,0,2,3,0,1,0,0,4,2,4,2,2,2,0,Arts,Masters,25-30,1,0,0,Hybrid,Tier3_City,5,2,1,2,3,2,1,32.31,Tech,3,4,5,1,2,4,1,1,3,4,1,1,2,3,48.19
Physics,Physicist,4.31139869424532,2,1,2,0,7,0,4,0,0,0,3,1,0,0,Science,Bachelors,18-24,14,0,0,Remote,Tier2_City,1,1,3,2,4,2,3,11.26,Education,1,3,2,2,0,0,1,5,3,2,0,1,5,3,54.31
Biology,AI Researcher,3.757350660549759,9,2,4,0,3,0,4,4,0,0,0,0,2,1,Science,Bachelors,31-35,2,1,23,Remote,Tier1_City,2,3,2,1,3,4,5,34.54,Healthcare,1,5,3,4,0,3,3,5,4,3,1,1,4,2,43.28
Marketing,Microbiologist,3.6558925029140665,8,2,3,0,6,1,0,2,4,2,1,0,1,0,Commerce,Bachelors,18-24,0,1,33,Flexible,Tier2_City,4,3,2,3,2,2,1,48.45,Manufacturing,3,4,2,5,1,4,5,2,2,1,0,0,4,3,34.61
Finance,Financial Advisor,4.121670530841656,1,0,0,1,6,1,3,1,1,3,3,0,1,1,Commerce,Bachelors,18-24,0,1,55,Hybrid,Tier2_City,3,1,0,1,4,1,5,15.05,Manufacturing,2,3,4,3,1,3,2,4,2,4,1,1,3,1,45.09
Education,Marketing Specialist,2.7279421286986496,1,2,1,0,5,1,2,3,1,2,2,1,4,0,Arts,PhD,25-30,1,0,0,Hybrid,Tier1_City,5,5,5,2,3,0,1,9.68,Other,4,2,5,3,5,2,2,4,2,3,1,0,3,3,48.41
Art,Biotechnologist,4.213002542311614,2,1,0,1,2,0,2,2,1,2,1,2,1,1,Arts,Bachelors,18-24,13,0,0,Flexible,Tier1_City,1,2,3,2,2,5,2,4.14,Other,2,2,1,1,0,0,5,5,2,5,1,1,4,1,53.36
Architecture,Organic Chemist,4.770496428508363,4,2,1,0,3,0,3,1,3,0,3,0,4,0,Interdisciplinary,PhD,18-24,2,1,13,Hybrid,Tier1_City,5,3,0,4,4,1,2,20.8,Tech,5,4,3,4,3,1,4,5,3,2,0,1,1,2,52.77
Finance,Actuary,4.930988417028842,2,1,2,1,3,0,4,2,0,4,4,3,2,1,Commerce,Bachelors,25-30,12,0,0,Hybrid,Tier2_City,1,1,1,5,2,2,5,13.09,Manufacturing,4,5,5,4,2,4,1,5,2,2,0,0,2,2,59.01
Medicine,Financial Controller,4.794150018016719,0,0,3,0,0,0,3,4,0,1,3,0,3,0,Science,Masters,18-24,8,0,0,Remote,Tier1_City,1,2,2,2,5,1,2,26.12,Tech,4,4,2,5,4,2,4,4,4,2,0,1,4,4,63.37
Education,Inorganic Chemist,3.1286058378923496,4,1,1,0,0,1,0,1,3,4,1,2,0,0,Arts,Bachelors,18-24,7,0,0,Hybrid,Tier3_City,3,1,5,1,4,5,2,27.64,Manufacturing,4,4,1,5,0,5,2,2,2,3,1,0,5,3,53.23
Law,Graphic Designer,3.2706272598286,4,2,3,0,2,1,0,2,0,1,2,1,2,0,Arts,Bachelors,18-24,11,0,0,Hybrid,Tier1_City,1,5,2,1,5,3,3,19.42,Tech,3,3,3,2,4,4,5,5,3,2,0,0,2,5,50.44
Psychology,Biochemist,3.0980981488127863,1,0,0,1,6,1,4,0,0,1,0,2,2,0,Arts,Bachelors,18-24,14,1,34,Remote,Tier2_City,3,4,2,5,0,5,1,38.25,Manufacturing,1,1,2,1,0,5,2,4,4,2,1,1,2,3,47.41
Education,Artist,4.276933284493649,9,2,1,0,7,0,2,4,0,1,1,0,3,0,Arts,Bachelors,31-35,10,1,45,Office,Any,2,3,4,5,0,5,2,45.53,Healthcare,3,5,2,2,1,4,1,4,3,3,1,1,5,4,46.49
Computer Science,Biologist,3.042001067970248,7,0,1,1,1,1,1,0,0,1,1,3,4,1,Science,Masters,36-40,10,1,21,Office,Any,5,2,3,4,3,3,5,12.94,Other,3,5,5,2,1,5,2,2,4,4,0,0,3,3,57.52
Medicine,Accountant,3.8870176622779393,7,1,0,1,1,1,1,4,3,2,1,4,3,0,Science,Bachelors,25-30,14,1,35,Hybrid,Tier3_City,1,1,0,3,1,2,3,42.31,Healthcare,3,4,2,4,0,4,5,2,4,5,1,1,5,5,63.92
Business,Animator,3.906365108731226,4,1,4,0,2,1,4,3,1,4,2,3,3,1,Commerce,Masters,25-30,8,0,0,Flexible,Tier1_City,3,1,0,1,5,2,2,9.17,Tech,2,4,2,5,4,4,5,2,2,5,1,0,3,3,69.12
Engineering,Manager,4.192685163683663,3,2,0,1,1,1,0,4,2,2,4,4,1,0,Science,Bachelors,18-24,6,1,39,Remote,Tier3_City,2,2,0,5,5,0,5,13.75,Healthcare,3,2,3,3,2,1,5,1,5,1,1,0,3,5,61.4
Biology,Construction Manager,2.7915358756808906,2,2,3,1,9,1,3,4,0,1,3,0,0,1,Science,Bachelors,18-24,6,0,0,Remote,Tier2_City,5,3,1,1,0,5,1,29.39,Tech,1,4,2,2,0,1,1,1,3,5,1,0,2,5,48.68
Physics,Electrical Engineer,3.715576858087579,3,2,2,1,0,0,0,4,3,0,0,4,1,1,Science,Bachelors,25-30,4,0,0,Office,Tier3_City,2,3,4,5,5,1,2,17.41,Other,4,3,4,1,0,1,2,5,4,2,0,0,3,4,44.03
Biology,Entrepreneur,3.0568170242321417,5,1,0,1,5,0,4,0,3,4,0,0,2,0,Science,PhD,25-30,6,0,0,Remote,Any,4,1,1,2,1,0,5,4.96,Tech,2,2,4,2,3,0,1,4,4,3,1,1,2,5,60.52
Computer Science,Geneticist,4.459975685318261,4,2,4,1,4,1,0,4,2,3,4,3,1,1,Science,Masters,31-35,3,1,52,Remote,Tier1_City,5,3,3,1,2,2,5,16.86,Other,3,1,1,3,0,5,1,2,3,1,1,0,1,2,50.73
Computer Science,Entrepreneur,3.931848663530897,6,2,0,0,8,1,2,1,2,1,0,1,4,0,Science,Bachelors,31-35,4,1,30,Remote,Tier2_City,3,4,0,2,2,2,4,45.53,Finance,3,3,4,3,5,1,2,1,3,3,0,0,5,5,42.39
Biology,Music Teacher,3.131562364954274,6,1,1,1,6,0,0,0,1,0,3,2,1,1,Science,Bachelors,25-30,11,0,0,Office,Tier1_City,1,5,0,1,1,4,5,11.19,Healthcare,4,5,4,1,1,3,4,5,1,2,1,1,5,2,41.15
Medicine,Chemist,3.7939461747524574,4,2,0,1,2,0,4,0,3,4,3,2,0,1,Science,Bachelors,18-24,0,0,0,Remote,Tier1_City,3,5,0,3,5,0,4,38.9,Finance,4,5,5,3,3,1,2,4,3,5,1,1,3,2,54.35
Marketing,Psychologist,3.013089670263553,8,0,4,0,3,0,4,4,0,2,3,4,4,1,Commerce,PhD,31-35,10,0,0,Remote,Tier2_City,3,4,2,4,5,2,1,36.95,Other,2,3,4,3,3,4,1,2,5,2,1,0,3,1,73.77
Chemistry,Digital Marketing Specialist,4.4947663971673215,0,2,1,0,0,1,4,0,2,0,2,1,3,0,Science,Masters,25-30,3,0,0,Remote,Tier2_City,3,3,2,2,5,3,1,7.99,Other,1,4,2,3,1,4,3,1,5,3,1,1,1,1,52.29
Physics,Judge,3.0366971601765,4,0,3,0,2,0,4,0,3,1,4,1,1,1,Science,Bachelors,31-35,2,0,0,Office,Tier2_City,5,1,5,5,3,4,3,18.48,Finance,2,4,5,2,1,3,4,1,5,1,0,1,1,2,47.74
Biology,Aerospace Engineer,3.178367419181247,1,2,0,1,2,1,1,3,1,4,3,3,0,1,Science,Masters,25-30,1,1,9,Hybrid,Tier3_City,5,3,0,3,4,1,4,11.9,Other,4,4,4,1,5,2,4,4,1,5,0,0,2,5,53.32
Biology,Conductor,4.512959032987295,3,0,1,1,8,0,2,4,0,2,0,1,1,1,Science,Bachelors,31-35,1,0,0,Remote,Tier2_City,4,2,0,1,1,4,5,4.09,Manufacturing,1,5,2,2,1,4,3,1,1,5,0,1,4,5,35.38
Chemistry,Artist,3.668152175690723,4,1,4,1,5,0,0,4,4,3,3,1,2,0,Science,PhD,36-40,7,0,0,Office,Any,2,2,2,2,1,5,3,11.13,Tech,3,3,1,1,4,4,4,4,1,2,1,1,1,5,57.55
Education,Civil Engineer,3.562462327986841,3,1,0,0,2,0,2,3,0,1,2,4,1,0,Arts,Bachelors,36-40,0,1,22,Office,Tier3_City,3,3,1,1,1,5,3,12.47,Education,3,4,5,3,5,1,2,2,4,5,0,1,1,1,48.01
Art,Paralegal,2.6213899958507763,7,0,0,1,0,0,0,1,4,0,4,4,3,1,Arts,Masters,25-30,7,0,0,Hybrid,Any,4,4,4,1,1,1,1,10.8,Finance,5,2,2,3,3,1,3,4,2,2,1,1,5,1,53.56
Biology,Human Resources Specialist,3.2595859822694506,3,1,3,1,8,1,4,0,0,0,0,2,0,0,Science,Bachelors,25-30,8,0,0,Remote,Tier3_City,4,2,1,1,1,3,5,7.28,Manufacturing,4,5,5,5,2,4,3,2,1,4,0,0,5,2,42.33
Engineering,Nuclear Physicist,3.1930720468035343,4,0,4,0,4,0,3,2,3,3,0,3,1,0,Science,Masters,25-30,5,1,44,Hybrid,Tier2_City,5,5,4,4,5,1,4,27.74,Healthcare,5,3,1,3,2,3,3,3,2,2,0,0,1,5,56.08
Art,Biotechnologist,2.584863806616787,9,0,2,1,1,1,1,1,2,2,1,3,2,1,Arts,Masters,36-40,0,1,28,Flexible,Tier2_City,2,1,2,4,3,0,1,18.16,Education,2,3,1,1,5,4,2,1,2,5,1,0,1,3,44.58
Music,Actuary,3.4210372419170376,2,1,3,0,9,1,3,4,0,1,4,4,2,1,Arts,Masters,25-30,9,0,0,Remote,Tier3_City,4,4,5,5,0,1,3,45.69,Other,2,3,5,4,4,1,4,3,2,4,1,0,5,2,63.45
Chemistry,Animator,4.059766999473988,8,0,3,0,9,1,3,1,2,1,0,1,2,1,Science,Masters,18-24,11,0,0,Remote,Tier2_City,1,2,5,2,5,1,2,11.8,Tech,1,3,2,1,2,5,4,4,5,5,1,0,1,4,64.19
Education,Software Developer,2.536450919988231,8,2,2,0,2,0,4,3,2,1,2,3,2,1,Arts,Masters,25-30,6,0,0,Remote,Tier2_City,4,1,0,3,5,4,3,31.33,Manufacturing,4,1,3,3,3,1,5,2,1,3,0,1,1,2,55.6
Music,Music Therapist,3.416462622712041,1,0,4,1,1,0,1,4,3,3,2,0,0,0,Arts,Bachelors,18-24,14,0,0,Hybrid,Tier3_City,5,5,0,3,4,3,2,45.33,Education,1,2,5,3,1,1,2,1,3,3,1,1,4,1,59.42
Biology,Market Research Analyst,4.404489116244504,7,0,0,1,2,1,3,4,2,3,3,4,3,1,Science,Bachelors,25-30,14,0,0,Office,Any,3,2,0,3,0,1,1,5.22,Tech,1,1,3,4,3,3,4,5,3,4,0,1,1,2,67.16
Physics,Legal Consultant,4.241196544893009,7,0,4,0,9,0,4,3,2,4,1,2,0,1,Science,Bachelors,25-30,4,0,0,Remote,Tier1_City,5,2,1,1,1,0,4,27.27,Tech,2,4,2,3,5,4,5,1,5,1,1,1,3,5,50.47
Business,Social Media Manager,3.934793887165688,3,0,1,1,0,1,2,3,1,2,0,3,2,1,Commerce,PhD,25-30,14,1,31,Remote,Tier2_City,5,1,0,4,0,4,5,24.18,Education,2,1,4,5,4,1,5,5,4,3,0,1,3,1,62.21
Marketing,Illustrator,4.293808755789327,1,1,1,1,4,1,1,2,3,0,0,2,4,0,Commerce,Bachelors,18-24,8,0,0,Flexible,Tier2_City,2,1,4,2,3,3,2,46.65,Manufacturing,4,1,5,4,4,2,1,1,4,5,1,1,4,1,54.78
Psychology,Civil Engineer,4.017502429624632,9,1,1,1,5,1,1,0,1,0,3,3,2,1,Arts,Masters,36-40,6,0,0,Office,Tier1_City,1,3,0,1,2,3,5,34.2,Other,2,5,1,2,0,5,2,2,1,1,0,1,1,3,40.39
Psychology,Conductor,3.471642798981356,8,0,3,0,2,1,1,3,3,4,4,4,2,0,Arts,Masters,31-35,4,0,0,Flexible,Any,1,2,2,4,5,2,1,19.41,Education,4,3,4,5,4,1,5,4,3,3,1,1,4,5,63.78
Chemistry,Entrepreneur,4.05811540676652,7,2,4,0,2,0,2,2,4,0,1,4,2,1,Science,Bachelors,36-40,12,0,0,Office,Tier3_City,2,5,0,4,0,5,1,36.44,Finance,5,1,2,1,4,0,3,2,2,3,1,0,1,5,52.6
Medicine,Illustrator,2.8995785151998064,9,0,4,0,8,1,3,2,1,1,4,0,2,1,Science,Bachelors,25-30,1,0,0,Hybrid,Tier1_City,2,1,1,2,4,0,1,30.38,Tech,3,3,1,5,5,2,3,1,1,2,0,0,1,4,40.24
Psychology,Conductor,4.611847031393342,6,2,2,1,2,0,2,2,4,0,3,1,4,0,Arts,Bachelors,31-35,13,1,9,Remote,Tier1_City,4,4,1,2,3,5,4,19.32,Healthcare,5,2,5,5,3,1,1,5,4,5,1,0,1,3,67.34
Music,Composer,3.9007019620455625,6,1,3,0,7,1,0,4,4,1,2,0,3,0,Arts,Bachelors,25-30,3,0,0,Hybrid,Tier3_City,1,2,2,2,2,4,2,39.91,Other,2,1,2,3,3,0,5,2,1,5,0,1,3,3,45.56
Finance,Surgeon,3.344580538611787,7,2,3,0,1,0,1,3,2,3,2,3,0,0,Commerce,Bachelors,18-24,1,0,0,Hybrid,Tier1_City,5,4,3,1,3,4,5,34.4,Education,3,5,5,2,4,3,3,2,3,3,0,1,3,4,47.57
Physics,Legal Analyst,4.758967396316118,8,1,3,1,3,1,0,2,4,1,1,2,4,1,Science,High School,18-24,8,0,0,Hybrid,Tier2_City,4,2,1,5,1,0,3,3.25,Education,3,5,4,4,3,0,5,5,2,1,1,0,2,2,40.54
Law,Surgeon,3.5202659954403246,2,1,3,1,1,1,2,1,3,2,4,2,4,1,Arts,Masters,25-30,1,0,0,Hybrid,Tier1_City,1,1,3,2,2,3,1,43.66,Tech,1,4,5,5,3,4,3,3,2,2,1,1,4,4,50.98
Architecture,Entrepreneur,4.073659433191029,5,0,4,0,1,1,2,4,3,1,4,1,4,0,Interdisciplinary,PhD,18-24,1,0,0,Flexible,Any,3,3,2,5,4,1,5,21.66,Tech,3,1,1,3,5,5,2,1,4,2,0,0,5,4,55.55
Music,Manager,2.7982182421835864,0,0,3,0,1,0,2,2,1,2,4,3,1,1,Arts,Bachelors,40+,1,0,0,Remote,Tier3_City,5,2,0,1,2,0,5,33.34,Education,4,2,5,5,5,4,4,2,4,1,0,1,4,5,43.57
Finance,Industrial-Organizational Psychologist,3.8993263686465913,3,2,4,0,7,0,1,1,1,1,2,3,2,0,Commerce,Bachelors,18-24,0,0,0,Remote,Tier1_City,5,1,5,5,4,4,4,21.65,Healthcare,2,3,4,2,4,3,3,2,5,2,0,1,4,5,38.51
Architecture,Curriculum Developer,3.3942495244759807,6,0,2,0,3,0,3,0,4,2,3,4,4,1,Interdisciplinary,High School,25-30,8,0,0,Hybrid,Any,4,1,3,3,1,5,2,44.42,Tech,2,1,4,4,1,3,2,1,3,2,1,0,3,2,55.27
Education,Nurse,3.152689530405106,1,2,3,0,7,1,4,1,4,4,4,4,4,1,Arts,Masters,25-30,7,1,8,Flexible,Any,1,1,2,5,4,0,4,33.59,Tech,1,4,1,3,4,3,4,5,4,3,0,0,1,3,75.72
Physics,Accountant,4.995605876626279,0,2,2,1,3,0,0,1,1,1,2,0,0,1,Science,Masters,25-30,1,0,0,Flexible,Tier2_City,2,4,3,2,3,3,4,30.23,Finance,1,5,3,5,2,0,1,1,3,2,0,0,4,5,41.03
Physics,Pharmacist,4.008306743717827,3,1,0,0,6,1,1,4,2,3,1,4,4,1,Science,Bachelors,25-30,1,0,0,Hybrid,Tier1_City,3,1,3,1,0,2,5,49.07,Manufacturing,2,1,3,2,3,0,4,4,5,2,0,0,4,3,44.03
Law,Astronomer,3.38481239307744,0,0,0,0,3,0,1,2,0,1,0,2,3,0,Arts,Bachelors,18-24,4,0,0,Remote,Tier3_City,5,4,0,2,3,2,2,16.19,Finance,1,4,5,1,0,3,2,4,1,1,0,0,4,2,28.4
Architecture,Artist,4.448664315814894,1,0,2,1,0,1,0,2,0,0,3,2,1,1,Interdisciplinary,Masters,31-35,11,0,0,Hybrid,Tier1_City,2,5,5,3,5,1,2,6.07,Healthcare,3,2,4,1,4,0,3,2,5,2,1,0,2,2,54.77
Physics,Marketing Specialist,2.7848105991130296,3,1,3,0,8,1,4,0,0,4,3,4,1,0,Science,Masters,25-30,12,0,0,Flexible,Tier2_City,2,3,1,2,3,1,2,27.25,Manufacturing,3,3,2,2,1,4,1,4,3,1,0,1,3,5,59.79
Biology,Construction Manager,3.032726292543736,8,2,0,0,7,1,4,1,1,3,1,0,1,0,Science,High School,25-30,13,0,0,Hybrid,Tier1_City,2,1,3,2,2,3,1,22.93,Education,4,2,2,4,1,1,5,1,4,3,1,1,3,1,53.12
Finance,School Psychologist,4.719444474564392,4,0,3,1,5,1,2,3,4,3,0,0,3,1,Commerce,Masters,31-35,11,0,0,Office,Tier2_City,2,5,4,2,1,5,2,24.35,Healthcare,1,2,4,5,3,2,1,2,5,1,1,0,2,4,62.44
Marketing,Music Teacher,4.004088068336431,9,1,1,1,9,1,1,1,1,4,0,2,1,0,Commerce,Bachelors,36-40,13,1,21,Remote,Tier1_City,4,1,0,4,5,1,5,32.14,Healthcare,2,3,2,5,4,3,4,4,2,2,0,1,2,3,52.92
Psychology,Counselor,3.3260747271363504,8,0,3,1,9,0,0,3,0,2,1,1,4,0,Arts,Bachelors,36-40,3,0,0,Remote,Tier2_City,5,5,4,3,5,2,1,31.91,Finance,5,1,1,2,4,4,2,5,3,1,1,0,2,4,33.51
Engineering,Entrepreneur,3.0095905885301004,1,1,1,1,6,1,3,3,3,0,0,2,3,0,Science,Masters,31-35,1,1,59,Hybrid,Tier1_City,2,1,0,2,5,3,3,21.44,Manufacturing,2,3,5,5,5,0,1,4,4,3,0,1,2,2,53.16
Psychology,Psychologist,4.452329441014501,9,1,2,0,6,1,3,1,2,2,3,3,0,0,Arts,Masters,25-30,7,1,58,Office,Tier2_City,2,3,0,2,0,3,4,43.56,Healthcare,5,4,4,4,2,2,1,5,1,1,0,0,3,1,52.22
Biology,Surgeon,3.756593959671867,2,0,3,1,2,1,2,4,3,2,4,0,1,1,Science,Bachelors,25-30,7,0,0,Flexible,Tier3_City,1,1,5,2,4,3,2,33.62,Manufacturing,5,2,5,2,5,3,3,4,4,5,1,0,2,3,65.47
Medicine,AI Researcher,4.731151940000075,3,2,2,0,7,1,3,3,2,2,4,0,1,0,Science,PhD,31-35,12,0,0,Office,Tier1_City,5,4,1,1,2,0,3,44.83,Other,4,3,1,1,4,0,4,5,3,2,0,1,3,1,65.17
Physics,Music Teacher,4.247945019381323,4,1,1,1,9,1,2,4,4,3,1,0,0,0,Science,Bachelors,36-40,3,0,0,Hybrid,Tier3_City,3,1,4,4,1,5,2,45.92,Education,5,5,2,1,5,0,3,1,2,3,0,0,1,3,41.97
Psychology,Electrical Engineer,2.7485722729608884,9,2,0,0,0,0,1,1,2,2,2,3,4,0,Arts,Masters,18-24,13,0,0,Hybrid,Tier1_City,2,2,3,1,0,5,4,10.86,Manufacturing,3,3,4,3,2,2,3,1,4,3,0,0,4,4,59.19
Architecture,Doctor,4.117051740431907,5,1,1,0,4,1,1,4,0,3,2,0,3,1,Interdisciplinary,Bachelors,25-30,3,0,0,Office,Tier2_City,4,4,0,4,3,1,5,34.99,Finance,3,3,1,1,1,0,4,3,4,4,1,1,5,3,44.33
Computer Science,Fluid Mechanics Engineer,4.655915058687439,7,0,1,1,0,0,1,1,4,4,1,0,1,0,Science,Masters,31-35,8,0,0,Remote,Tier2_City,2,5,5,2,1,5,5,17.92,Finance,4,4,1,5,4,2,1,1,3,5,0,1,3,1,63.11
Physics,Marketing Manager,4.568925163828682,8,1,3,1,3,0,2,1,0,0,3,0,2,1,Science,PhD,25-30,3,1,18,Flexible,Tier2_City,2,1,4,3,5,4,4,42.31,Healthcare,2,2,5,4,5,4,2,4,3,2,1,1,3,1,45.41
Physics,Doctor,4.173694862387229,3,1,3,0,8,1,4,2,3,0,3,3,4,1,Science,Bachelors,25-30,14,0,0,Hybrid,Tier1_City,2,1,4,5,1,2,3,37.44,Manufacturing,2,4,4,4,5,3,2,2,2,3,1,1,5,2,61.07
Architecture,Software Developer,4.205550986777154,7,1,0,0,4,0,2,2,0,1,2,0,4,1,Interdisciplinary,PhD,25-30,9,0,0,Flexible,Tier1_City,5,1,1,5,1,1,1,12.34,Finance,2,4,5,3,3,0,4,5,4,1,0,1,1,3,50.73
Business,Quantum Physicist,4.442888419670864,1,1,1,1,7,1,4,0,1,4,1,2,2,0,Commerce,Masters,31-35,10,0,0,Office,Tier1_City,5,2,4,2,3,5,1,47.12,Tech,2,5,5,5,2,1,4,1,2,2,0,0,1,4,59.82
Psychology,Web Developer,4.12955221640829,3,0,0,0,3,0,0,1,1,2,1,4,3,0,Arts,Masters,40+,8,0,0,Remote,Any,2,3,3,1,4,2,2,35.12,Finance,3,4,1,2,2,2,2,2,3,3,1,0,4,5,50.55
Architecture,Advertising Manager,2.826576390547306,4,1,3,1,8,0,0,1,4,3,0,0,3,0,Interdisciplinary,Bachelors,25-30,2,1,49,Remote,Tier2_City,4,3,4,3,2,1,4,47.59,Education,3,4,5,3,3,4,2,5,2,2,1,0,2,3,35.21
Psychology,Musician,2.838669709693377,6,0,2,0,1,0,3,4,0,2,4,2,2,0,Arts,Masters,18-24,1,0,0,Hybrid,Any,3,4,1,4,5,4,4,12.49,Tech,4,5,2,5,0,5,5,5,3,5,1,1,4,5,61.35
Chemistry,Architectural Technologist,3.98036566773231,6,1,3,1,2,0,3,0,1,0,0,1,3,0,Science,Masters,18-24,14,0,0,Remote,Any,1,4,0,2,4,2,1,43.88,Manufacturing,4,1,2,2,3,1,4,5,1,5,1,0,5,5,51.24
Computer Science,Landscape Architect,4.515826874521221,5,2,3,0,8,1,2,0,3,1,4,1,2,1,Science,Bachelors,18-24,10,1,59,Hybrid,Any,3,2,4,3,0,4,3,34.4,Other,4,4,1,1,2,3,3,1,2,3,0,1,2,2,53.65
Finance,Nuclear Physicist,3.9380038937249457,5,1,0,0,6,1,2,3,0,3,0,4,2,1,Commerce,PhD,25-30,7,1,33,Hybrid,Tier2_City,4,2,4,3,5,2,4,28.96,Healthcare,2,3,5,1,3,4,1,5,4,5,1,1,2,3,64.91
Business,Physical Chemist,4.079117038568308,9,0,3,0,4,1,4,3,3,3,4,4,0,0,Commerce,High School,25-30,11,1,28,Hybrid,Tier1_City,4,2,2,4,2,0,5,41.56,Tech,2,4,2,2,2,2,1,3,4,5,0,1,5,5,70.41
Music,Advertising Manager,4.968160023714212,8,1,1,0,8,0,4,1,1,1,3,4,2,1,Arts,Bachelors,18-24,2,1,17,Remote,Any,3,5,3,3,0,0,5,32.74,Finance,3,2,3,3,5,4,5,1,4,4,1,0,3,2,52.2
Finance,Composer,3.016939241739004,6,1,2,0,0,0,1,4,4,3,3,1,0,0,Commerce,Bachelors,31-35,12,0,0,Flexible,Tier1_City,3,2,5,1,3,2,4,34.47,Healthcare,3,3,3,2,0,5,4,2,4,2,0,1,4,2,61.08
Law,Inorganic Chemist,3.3653243756386964,8,1,4,0,7,0,3,2,3,4,1,4,4,0,Arts,Masters,31-35,1,0,0,Hybrid,Tier2_City,2,2,3,1,4,2,3,14.92,Other,1,3,5,5,4,4,1,3,1,2,1,0,5,5,53.71
Medicine,Illustrator,4.874635740690968,5,0,2,1,5,1,2,3,4,3,1,1,4,0,Science,Masters,25-30,12,0,0,Flexible,Any,3,2,5,1,5,4,5,41.4,Other,1,1,1,2,1,4,1,3,4,2,0,1,5,4,67.84
Finance,Financial Controller,4.560924537335187,0,2,3,1,9,0,2,3,2,2,4,2,4,0,Commerce,High School,25-30,10,0,0,Remote,Tier2_City,3,2,5,3,1,5,3,33.56,Healthcare,2,2,2,5,0,3,1,1,2,2,0,1,4,4,53.45
Engineering,Architect,3.6814239045147374,9,1,3,0,0,1,4,4,0,2,1,2,1,0,Science,PhD,40+,7,0,0,Office,Tier1_City,2,3,3,1,2,3,1,42.69,Healthcare,3,2,4,5,4,1,2,5,3,4,0,0,5,5,65.91
Education,Credit Analyst,3.798280506317209,5,1,3,1,7,0,3,4,4,0,1,0,0,1,Arts,High School,25-30,14,1,27,Remote,Tier1_City,4,1,5,4,5,2,2,19.52,Healthcare,2,2,4,1,5,4,5,3,3,2,1,0,3,1,52.75
Biology,Music Therapist,3.681263893201337,8,2,3,0,3,0,2,3,2,0,2,0,1,0,Science,Bachelors,31-35,7,0,0,Office,Any,5,1,4,3,1,1,1,18.59,Manufacturing,5,4,2,5,3,0,3,4,3,5,0,1,4,3,54.15
Architecture,Physician Assistant,3.0583617061599284,1,1,2,1,3,0,3,1,0,2,3,2,4,1,Interdisciplinary,High School,25-30,4,1,20,Office,Any,2,3,3,5,5,1,2,4.12,Manufacturing,1,4,5,4,2,4,2,2,3,5,0,1,5,5,51.51
Music,Quantum Physicist,4.045722926263128,1,2,1,0,9,1,1,3,4,4,2,0,1,1,Arts,Masters,31-35,8,0,0,Flexible,Tier3_City,3,2,3,3,0,1,5,39.12,Manufacturing,4,3,3,1,5,4,4,4,2,5,1,0,2,3,56.87
Computer Science,Analytical Chemist,3.564579946088226,9,2,1,0,0,0,2,4,0,4,2,2,4,0,Science,PhD,31-35,10,0,0,Hybrid,Any,1,5,2,4,1,0,2,18.52,Finance,2,1,3,1,5,3,5,1,4,3,0,1,4,1,67.31
Finance,Advertising Manager,3.4985849386588423,6,0,2,0,0,1,4,2,4,3,3,4,3,1,Commerce,Masters,31-35,5,0,0,Remote,Tier1_City,3,5,1,5,1,5,2,18.38,Manufacturing,5,4,2,2,0,3,2,3,5,5,1,0,5,4,74.24
Architecture,Music Teacher,2.634697933271017,3,0,4,0,8,0,1,1,2,1,3,1,1,1,Interdisciplinary,Masters,36-40,4,0,0,Flexible,Tier1_City,1,4,1,3,5,4,4,35.37,Healthcare,4,4,3,5,3,3,2,5,4,1,0,1,3,2,51.1
Medicine,School Counselor,3.5421164430091494,6,1,1,1,5,0,0,0,2,1,3,4,2,1,Science,High School,36-40,11,0,0,Hybrid,Tier1_City,2,1,0,1,3,5,2,14.88,Tech,5,1,2,2,5,5,5,5,5,4,0,0,2,5,54.11
Marketing,Forensic Psychologist,3.5577611241758422,2,2,0,1,0,0,2,4,1,0,3,2,3,0,Commerce,Bachelors,25-30,2,0,0,Remote,Tier1_City,5,4,5,2,3,0,4,45.72,Tech,3,2,1,5,4,3,4,3,1,1,1,1,3,4,41.41
Computer Science,Biochemist,3.2197148371136484,9,2,4,0,4,1,4,1,2,2,3,2,3,1,Science,Bachelors,18-24,6,0,0,Hybrid,Tier1_City,5,2,5,2,4,5,2,28.29,Other,3,3,3,1,5,4,5,3,3,5,0,0,5,3,56.73
Biology,Web Developer,3.2562884826372818,9,2,0,1,8,0,4,2,1,3,0,1,0,1,Science,Bachelors,25-30,13,1,36,Remote,Tier1_City,1,4,5,1,0,5,4,48.57,Tech,3,4,5,4,1,4,5,5,1,4,0,0,2,2,49.58
Medicine,Zoologist,4.320513499595115,3,2,4,0,8,1,1,3,3,4,4,1,3,1,Science,Bachelors,31-35,14,0,0,Remote,Tier2_City,4,2,5,2,3,1,5,6.6,Tech,4,1,3,1,0,2,4,2,3,4,1,1,4,3,63.65
Medicine,Lawyer,4.352624798421745,9,1,2,1,5,1,0,3,0,1,2,1,1,1,Science,Masters,31-35,8,0,0,Hybrid,Tier1_City,1,4,2,2,5,2,5,18.83,Tech,4,1,2,3,1,3,2,1,5,2,1,0,2,2,55.91
Education,Physician Assistant,3.182643960194604,9,1,3,0,2,1,3,2,0,1,4,0,4,1,Arts,Bachelors,18-24,3,0,0,Remote,Tier1_City,1,3,5,1,3,1,2,20.93,Other,3,2,4,2,3,2,4,2,3,4,1,1,3,3,46.4
Engineering,Physicist,4.037053162957101,6,1,0,0,1,1,4,4,3,1,3,2,0,1,Science,Masters,18-24,10,0,0,Hybrid,Any,2,2,5,1,4,5,3,37.33,Education,4,5,3,4,4,1,3,5,3,5,1,0,1,2,73.83
Engineering,Game Developer,3.9303324098690418,0,1,1,1,5,1,3,2,4,4,2,2,3,1,Science,Bachelors,31-35,6,1,30,Hybrid,Tier1_City,3,5,4,3,2,2,5,13.01,Tech,3,5,2,2,5,3,4,1,4,1,1,1,5,3,55.39
Law,Sound Engineer,3.0190427982324315,0,1,2,0,1,0,0,3,3,3,1,3,2,1,Arts,Bachelors,25-30,11,1,13,Office,Tier1_City,4,2,5,3,4,4,1,20.64,Tech,2,5,3,5,0,5,3,1,4,4,1,0,1,2,63.41
Business,Interior Designer,4.617509328979788,7,1,3,1,3,0,3,1,1,4,4,1,0,1,Commerce,Masters,25-30,2,1,17,Flexible,Tier1_City,1,5,5,1,1,3,1,45.8,Tech,3,5,3,2,5,5,5,5,4,2,0,1,5,5,52.56
Chemistry,Animator,4.999666647818125,2,1,2,0,5,0,1,4,4,2,4,1,1,0,Science,Bachelors,31-35,10,0,0,Remote,Tier3_City,2,5,0,4,1,2,4,8.38,Other,1,4,3,1,4,1,1,5,1,5,0,0,1,2,59.84
Education,Musician,4.005099393277483,3,0,4,1,4,1,0,3,3,0,4,1,1,0,Arts,Masters,25-30,1,0,0,Office,Tier2_City,4,4,3,2,3,0,3,38.03,Finance,2,1,4,1,2,5,5,3,2,2,1,1,2,2,40.32
Marketing,Financial Controller,4.752706379823046,9,2,1,1,9,1,2,3,0,0,0,0,4,1,Commerce,Masters,18-24,12,1,20,Flexible,Tier2_City,5,1,0,3,3,1,4,36.02,Education,3,3,2,2,4,0,3,3,5,2,1,0,2,5,54.05
Marketing,Financial Advisor,3.175388190909457,5,0,1,1,7,0,4,4,2,4,3,2,4,1,Commerce,Bachelors,18-24,10,1,45,Office,Tier1_City,5,1,1,2,4,1,2,9.13,Tech,1,4,1,5,4,4,4,3,1,4,1,0,4,5,69.29
Business,Financial Analyst,3.3265623715972765,9,0,2,1,1,0,1,0,1,4,0,0,2,0,Commerce,PhD,18-24,0,1,37,Flexible,Tier2_City,2,1,0,5,4,5,5,35.36,Other,3,5,5,5,5,4,3,5,4,2,0,1,2,5,42.16
Marketing,Physician Assistant,2.652598568364552,6,1,2,0,9,0,0,2,3,4,4,2,1,1,Commerce,Bachelors,25-30,5,1,59,Hybrid,Tier1_City,4,5,0,1,5,5,3,29.78,Other,2,3,4,4,4,2,1,2,4,4,1,0,2,3,59.33
Engineering,Lawyer,3.424039213269898,1,0,2,0,6,1,1,0,1,2,4,3,3,1,Science,Bachelors,25-30,4,0,0,Office,Tier1_City,3,1,5,4,0,5,4,16.51,Manufacturing,3,3,5,1,5,4,5,1,2,2,1,0,1,2,37.36
Business,Astronomer,4.193117907733779,2,0,3,0,8,1,2,4,3,4,4,4,2,1,Commerce,Masters,25-30,1,0,0,Office,Tier2_City,2,2,2,5,5,5,4,17.62,Finance,4,5,5,2,0,1,3,2,1,3,1,1,5,4,59.34
Psychology,Data Scientist,4.064163481430995,8,0,0,1,8,0,2,3,2,2,0,4,1,0,Arts,Bachelors,18-24,12,1,59,Hybrid,Any,3,2,3,5,1,1,1,42.15,Other,3,3,1,4,0,4,2,4,4,5,1,1,2,5,63.13
Medicine,Social Media Manager,3.39172473930678,8,2,4,1,6,0,2,3,1,4,0,3,3,1,Science,Masters,18-24,12,1,26,Office,Tier1_City,1,2,4,5,5,2,2,13.86,Other,2,4,3,3,0,3,5,2,3,4,0,0,2,3,63.87
Marketing,Financial Advisor,4.541795379613525,0,0,4,1,0,1,0,3,1,0,0,1,3,1,Commerce,Masters,18-24,2,1,27,Hybrid,Tier3_City,3,5,5,1,4,4,4,27.1,Education,5,2,1,4,1,0,5,4,5,4,0,1,3,3,44.15
Business,Organic Chemist,3.2212250428946088,7,1,4,1,6,0,0,2,1,4,3,0,3,0,Commerce,PhD,40+,8,0,0,Remote,Tier1_City,2,5,4,3,5,2,1,35.01,Manufacturing,3,4,5,3,5,2,3,4,1,5,1,1,1,2,60.4
Business,School Counselor,2.8291764756595192,1,2,1,1,9,0,0,0,0,2,0,2,2,0,Commerce,Bachelors,25-30,2,0,0,Remote,Tier1_City,4,1,2,1,2,0,3,9.11,Manufacturing,4,4,4,3,3,2,3,1,3,4,0,1,2,5,32.91
Medicine,Investment Banker,3.8793032321074703,2,1,0,0,5,1,3,4,4,4,1,1,2,1,Science,Bachelors,36-40,6,0,0,Office,Tier1_City,3,4,5,3,0,1,4,46.82,Finance,2,2,5,4,3,2,1,1,1,5,1,0,2,2,59.78
Education,Psychologist,3.957007762945473,3,1,0,0,7,1,4,4,4,0,4,1,0,1,Arts,Masters,36-40,0,0,0,Office,Any,1,5,2,5,4,2,1,15.25,Other,1,5,5,1,4,3,2,4,1,1,0,0,4,1,44.71
Biology,Sound Engineer,3.350885119925336,2,1,2,1,5,1,4,3,0,1,1,1,1,1,Science,Bachelors,25-30,6,0,0,Hybrid,Tier1_City,4,3,5,5,3,1,2,17.99,Manufacturing,5,5,1,4,1,4,3,5,4,3,0,1,3,5,53.3
Finance,Market Research Analyst,3.505502573728952,5,1,2,1,4,1,4,4,0,0,0,1,2,1,Commerce,Bachelors,31-35,8,1,59,Hybrid,Tier2_City,5,2,5,4,5,0,5,34.31,Healthcare,3,2,2,4,3,3,1,4,2,4,1,0,5,4,51.79
Business,Astronomer,3.0204758297126566,8,0,2,1,9,1,3,1,0,0,1,2,3,1,Commerce,Bachelors,18-24,11,0,0,Remote,Tier1_City,5,2,4,3,4,3,3,6.68,Finance,2,4,5,1,0,1,3,3,3,1,0,0,1,3,43.3
Chemistry,Sound Engineer,4.097129449178789,2,0,2,1,4,0,4,3,3,0,3,2,1,1,Science,Bachelors,31-35,10,0,0,Hybrid,Tier2_City,4,1,5,5,3,3,4,32.5,Finance,4,1,2,1,2,5,5,1,4,3,0,0,5,3,60.48
Architecture,Entrepreneur,4.681144345315424,7,2,3,1,9,1,3,3,3,2,2,2,1,0,Interdisciplinary,Bachelors,25-30,7,0,0,Flexible,Tier2_City,2,4,0,2,3,3,1,46.05,Healthcare,4,3,3,1,5,4,5,2,5,2,1,1,2,5,56.68
Biology,Clinical Psychologist,3.792459688486221,4,2,4,0,9,0,3,4,0,4,0,4,0,1,Science,Masters,36-40,6,0,0,Flexible,Tier1_City,3,2,3,4,1,1,4,14.71,Finance,2,3,5,1,2,3,5,1,4,3,0,1,4,1,58.7
Engineering,Legal Secretary,2.8915979305150623,6,1,1,0,1,0,3,0,4,2,2,3,3,1,Science,Masters,18-24,9,0,0,Office,Tier3_City,3,5,4,1,1,2,5,20.01,Manufacturing,4,3,1,1,3,1,5,5,1,4,1,0,3,4,56.42
Chemistry,Market Research Analyst,3.280539466318996,0,0,3,0,7,1,3,1,3,3,1,4,2,1,Science,Bachelors,31-35,13,1,30,Flexible,Tier3_City,4,4,0,4,4,1,4,13.92,Manufacturing,5,1,3,1,1,1,4,3,3,2,0,1,1,3,59.48
Physics,Architect,2.8388145894672814,0,0,4,1,9,1,4,0,1,3,4,4,2,1,Science,Bachelors,18-24,7,0,0,Flexible,Tier1_City,3,2,0,2,4,4,4,41.48,Manufacturing,1,4,4,4,3,3,5,5,5,2,0,1,3,2,62.2
Physics,Inorganic Chemist,3.7929757218572338,4,2,1,1,3,0,2,3,0,4,0,2,0,0,Science,Bachelors,36-40,12,0,0,Remote,Tier2_City,5,1,1,3,2,2,1,10.88,Healthcare,4,5,5,2,0,3,2,2,4,1,0,1,3,2,52.36
Chemistry,Lawyer,2.753245259013902,6,0,2,1,2,0,3,3,0,0,0,3,3,1,Science,Masters,25-30,3,1,36,Hybrid,Tier1_City,4,1,2,1,0,0,5,19.29,Manufacturing,4,2,1,2,1,0,5,1,1,5,0,1,3,2,43.85
Business,Sound Engineer,4.252622707190115,7,0,0,0,0,0,2,1,3,4,3,4,2,1,Commerce,Bachelors,31-35,14,0,0,Remote,Tier3_City,3,1,5,1,0,5,3,31.25,Healthcare,1,3,5,2,2,3,4,2,5,1,1,0,5,3,59.33
Art,Architectural Technologist,3.489204883491098,1,0,1,1,8,1,0,2,0,0,0,4,4,1,Arts,Masters,25-30,1,0,0,Hybrid,Tier2_City,1,5,5,3,4,3,1,22.01,Healthcare,5,1,1,4,5,2,3,3,1,2,1,1,3,2,31.56
Medicine,Data Scientist,3.2157406299462323,5,2,2,0,3,0,3,1,4,1,2,4,2,0,Science,Bachelors,25-30,13,0,0,Office,Tier1_City,2,1,4,4,1,2,5,6.08,Healthcare,5,2,1,1,4,4,3,2,4,3,0,1,2,3,58.79
Computer Science,Organic Chemist,3.03768732714926,9,1,0,0,6,0,4,0,2,4,1,2,4,1,Science,Masters,31-35,13,0,0,Remote,Tier3_City,1,3,4,5,5,2,5,47.54,Finance,5,4,2,3,0,1,4,4,4,4,0,0,2,5,69.36
Business,Data Scientist,4.867556262690195,7,2,2,1,2,1,1,2,3,3,0,3,2,0,Commerce,Bachelors,36-40,10,0,0,Flexible,Tier1_City,1,5,5,4,2,3,4,18.88,Education,4,1,5,1,1,2,5,3,1,1,0,1,2,2,45.59
Law,Legal Consultant,3.206965445280523,3,1,2,0,2,1,2,3,2,0,3,0,4,1,Arts,Masters,18-24,8,0,0,Hybrid,Tier1_City,3,3,3,2,0,0,2,23.95,Other,4,1,1,5,4,5,1,5,3,2,1,1,4,2,51.28
Law,Animator,3.098669793007628,4,0,1,0,5,0,3,3,3,1,3,0,2,0,Arts,Bachelors,36-40,14,1,46,Office,Tier3_City,4,1,5,5,4,1,2,10.87,Healthcare,5,2,1,1,0,2,2,5,3,3,0,0,4,3,57.2
Computer Science,Principal,3.110709978268764,4,1,0,1,9,0,2,1,3,4,3,4,0,1,Science,Masters,31-35,2,0,0,Remote,Tier1_City,5,4,5,4,1,1,3,43.67,Manufacturing,4,2,3,2,5,1,5,2,2,2,0,1,3,3,50.18
Finance,Legal Consultant,3.509375958975698,1,1,3,1,6,0,3,4,3,3,4,2,2,1,Commerce,Bachelors,36-40,13,0,0,Remote,Tier1_City,4,5,4,3,1,5,4,16.7,Healthcare,3,3,5,1,5,5,4,3,4,1,1,1,1,3,65.37
Music,Brand Manager,2.6360241198969643,7,0,2,1,6,1,1,4,0,2,3,0,3,1,Arts,Masters,25-30,10,0,0,Hybrid,Tier1_City,3,3,0,2,1,2,2,3.93,Other,4,4,3,1,2,4,5,2,3,5,1,0,4,4,60.98
Education,Astronomer,2.6343707165349355,6,1,3,1,5,1,4,1,0,3,3,4,4,1,Arts,Masters,25-30,3,0,0,Office,Tier3_City,3,5,0,2,5,3,1,17.87,Tech,5,2,2,5,1,0,4,4,1,2,1,1,5,5,55.73
Computer Science,Quantum Physicist,4.896422547397722,1,1,1,1,3,1,2,3,2,4,0,4,4,1,Science,Bachelors,36-40,6,0,0,Flexible,Tier1_City,5,3,3,2,3,4,3,49.25,Finance,2,3,2,3,3,0,5,3,3,3,1,1,2,2,52.37
Law,AI Researcher,4.496089578303247,3,2,1,0,3,0,2,0,0,4,2,0,1,1,Arts,Masters,25-30,1,1,46,Office,Tier1_City,1,5,0,5,5,0,4,9.9,Manufacturing,5,3,1,3,1,5,1,1,5,2,0,1,3,3,44.1
Computer Science,Inorganic Chemist,4.8547167837612495,0,1,3,1,1,0,4,1,0,3,4,1,2,1,Science,Masters,25-30,13,0,0,Remote,Tier1_City,1,2,0,1,1,1,1,4.47,Finance,2,2,1,2,1,2,1,5,5,1,1,0,5,3,62.09
Biology,Biochemist,3.3295610074175697,9,0,0,1,2,1,2,2,1,3,0,1,0,0,Science,Bachelors,18-24,14,0,0,Remote,Tier1_City,4,3,4,5,4,0,2,30.17,Finance,4,1,1,3,0,2,2,2,1,4,0,1,5,3,54.33
Marketing,Art Therapist,3.758129122382256,4,1,1,1,0,0,3,1,0,2,4,1,3,1,Commerce,Bachelors,18-24,7,1,38,Flexible,Tier3_City,2,3,2,4,2,0,2,20.47,Tech,4,1,5,2,3,3,2,4,1,4,0,1,1,2,47.47
Architecture,Software Developer,3.8966919891443696,2,0,2,0,3,1,0,0,0,2,4,1,2,1,Interdisciplinary,Bachelors,31-35,11,0,0,Remote,Tier2_City,3,5,4,1,5,5,2,40.36,Healthcare,2,1,5,4,2,0,4,5,4,2,0,1,2,3,53.91
Education,Ecologist,4.613970477399538,9,1,4,1,5,0,1,4,1,1,3,1,3,0,Arts,Masters,31-35,9,0,0,Office,Tier3_City,5,4,1,4,4,0,2,37.4,Manufacturing,5,3,4,5,4,0,1,3,5,4,0,0,2,4,66.93
Education,Legal Analyst,3.895025167103692,4,2,2,1,7,1,0,0,1,2,0,2,2,1,Arts,Masters,25-30,7,0,0,Hybrid,Tier2_City,4,2,3,1,1,3,5,11.71,Education,1,1,1,1,2,4,2,5,3,4,0,0,4,4,42.24
Business,Judge,2.7936130679671547,0,1,1,1,7,1,3,0,3,4,2,1,4,1,Commerce,Bachelors,18-24,11,0,0,Hybrid,Tier1_City,5,3,5,5,2,5,3,29.54,Finance,1,4,3,5,3,3,4,5,2,4,0,1,4,3,60.6
Computer Science,Physical Chemist,3.462236844895303,2,1,3,1,4,1,2,0,3,4,3,1,2,0,Science,Bachelors,25-30,4,0,0,Hybrid,Tier2_City,1,1,0,2,0,3,3,4.52,Other,5,1,4,3,5,1,2,1,1,1,1,1,5,5,39.62
Computer Science,Human Resources Specialist,3.0339596205180306,1,0,0,0,2,1,1,3,3,0,0,1,0,0,Science,Masters,25-30,8,0,0,Flexible,Tier3_City,1,1,4,3,0,5,2,23.66,Education,4,1,5,1,4,1,1,1,5,5,1,1,5,4,56.74
Education,Web Developer,3.874570284689496,1,2,3,1,4,0,3,3,0,4,1,0,0,1,Arts,PhD,25-30,7,0,0,Flexible,Tier2_City,4,5,4,2,4,3,3,36.56,Education,2,3,5,5,1,4,5,4,1,1,1,0,5,2,55.43
Art,Brand Manager,4.420049034880793,8,1,4,0,4,0,1,4,3,3,3,0,1,1,Arts,Bachelors,36-40,0,0,0,Flexible,Any,2,4,5,5,2,5,1,22.5,Healthcare,2,5,1,5,4,1,3,4,3,1,1,1,2,1,44.63
Medicine,Architect,3.315434326223872,4,1,1,0,0,1,1,4,4,4,1,3,0,1,Science,PhD,31-35,8,1,52,Hybrid,Any,1,2,5,1,4,5,1,8.54,Education,5,4,3,2,1,0,1,2,3,5,1,0,5,1,70.73
Chemistry,Cybersecurity Analyst,4.0464842496118045,3,2,3,1,2,1,0,4,1,4,3,2,0,1,Science,Bachelors,18-24,12,0,0,Remote,Tier3_City,5,3,0,2,2,2,3,5.89,Manufacturing,5,3,3,4,5,2,2,1,5,3,0,0,2,4,64.35
Engineering,AI Researcher,2.592904965719541,3,1,0,0,5,1,0,2,1,3,0,2,2,1,Science,Bachelors,36-40,13,0,0,Flexible,Any,3,1,3,5,2,3,2,43.12,Healthcare,3,4,2,5,3,3,3,3,4,3,0,1,4,5,52.3
Engineering,Construction Manager,2.6723899461326703,5,1,2,1,9,0,4,0,2,4,1,4,3,0,Science,Masters,25-30,13,0,0,Remote,Tier2_City,3,3,4,4,4,2,4,44.89,Other,2,4,1,1,2,1,1,2,4,5,0,0,1,4,72.56
Marketing,Legal Secretary,4.338177875875877,0,2,1,1,1,0,1,1,1,2,3,4,0,1,Commerce,Bachelors,31-35,4,0,0,Hybrid,Tier1_City,2,1,2,3,2,5,2,19.13,Education,3,1,5,4,0,1,2,3,2,1,0,1,4,2,42.55
Physics,Mechanical Engineer,3.465982719489676,5,1,3,0,7,0,2,1,4,0,0,2,1,1,Science,Bachelors,18-24,8,0,0,Remote,Tier2_City,4,5,5,2,5,1,5,10.72,Healthcare,4,4,1,4,4,1,1,1,3,5,1,0,2,5,57.39
Physics,Legal Consultant,4.473212233425766,5,0,0,1,5,1,2,1,0,3,4,3,3,1,Science,Bachelors,31-35,8,0,0,Hybrid,Tier1_City,2,5,0,1,1,5,4,48.99,Manufacturing,2,1,1,1,0,1,4,3,1,3,1,0,2,2,50.5
Biology,Investment Banker,4.481930470212672,7,1,3,0,5,0,2,4,3,1,0,1,4,0,Science,Masters,18-24,9,0,0,Hybrid,Tier1_City,5,3,3,4,2,1,5,28.66,Finance,5,4,2,4,5,2,2,3,3,5,1,0,4,3,64.78
Biology,Music Therapist,3.4273557067369995,0,0,2,0,7,0,4,0,2,3,0,2,2,0,Science,Masters,25-30,9,0,0,Flexible,Tier2_City,2,5,1,5,5,1,3,25.4,Tech,5,5,2,3,0,2,3,1,5,5,0,1,4,3,71.56
Art,Risk Analyst,3.014113102017699,0,0,1,0,5,1,2,0,2,0,2,1,0,1,Arts,Bachelors,18-24,2,0,0,Flexible,Tier1_City,3,2,5,3,2,1,5,37.86,Healthcare,4,4,4,4,4,5,1,1,2,3,1,0,2,3,38.19
Psychology,Digital Marketing Specialist,4.4749710462035175,9,1,2,0,7,1,0,1,1,3,4,4,3,1,Arts,Bachelors,18-24,7,1,26,Hybrid,Tier1_City,1,5,0,1,5,1,3,10.94,Other,1,2,1,2,0,4,2,5,4,4,1,1,3,3,60.39
Architecture,Teacher,2.9789099467901394,7,1,2,0,4,1,4,3,0,3,4,2,4,0,Interdisciplinary,Bachelors,18-24,6,0,0,Remote,Tier2_City,1,2,1,5,4,3,5,30.26,Tech,3,1,5,4,0,0,5,3,4,5,1,1,4,3,65.41
Architecture,Forensic Psychologist,4.166947782096827,8,1,0,0,3,1,1,3,3,4,0,3,0,0,Interdisciplinary,Masters,18-24,14,1,51,Office,Tier1_City,4,5,0,5,0,4,4,44.84,Finance,5,5,2,5,0,1,2,2,3,2,0,1,5,5,62.82
Chemistry,Game Developer,3.7016154772493497,4,1,1,0,3,1,1,3,1,4,1,2,1,1,Science,Bachelors,18-24,6,1,30,Hybrid,Tier1_City,5,3,4,2,3,3,5,4.08,Other,2,1,4,4,2,4,1,4,4,3,0,1,4,2,53.67
Physics,Risk Analyst,3.899546814790652,1,0,1,0,6,1,2,2,2,1,0,0,4,0,Science,Masters,31-35,11,1,11,Flexible,Tier3_City,4,2,3,2,2,4,2,34.63,Manufacturing,2,5,4,2,1,0,5,5,1,3,1,0,1,5,50.09
Art,Judge,2.9848192700241887,1,2,1,0,3,1,4,2,4,0,1,3,3,1,Arts,Bachelors,18-24,9,1,21,Remote,Tier1_City,2,4,2,1,3,3,3,28.92,Other,2,1,4,2,2,2,3,4,2,2,1,1,2,4,57.31
Architecture,Biochemist,2.956782068497263,7,0,1,0,8,0,4,3,4,4,3,1,0,1,Interdisciplinary,Bachelors,31-35,1,0,0,Remote,Tier3_City,2,3,1,5,2,1,1,47.69,Finance,4,2,5,4,5,1,5,2,3,3,0,0,1,5,54.92
Chemistry,Analytical Chemist,2.7568683162093217,3,2,1,0,0,0,1,0,1,1,2,1,3,0,Science,Bachelors,18-24,1,0,0,Office,Any,2,2,1,2,4,0,5,15.16,Tech,1,2,2,3,5,2,1,2,2,1,0,0,1,3,33.2
Art,Counselor,4.595773886226624,9,0,4,1,1,0,3,0,1,1,2,2,1,0,Arts,Bachelors,36-40,1,0,0,Office,Tier3_City,5,1,0,3,4,5,3,43.37,Manufacturing,3,5,3,4,2,5,5,1,2,3,0,0,3,3,43.07
Business,Legal Analyst,3.1843232421190857,4,1,3,0,9,0,1,0,2,4,1,2,2,1,Commerce,PhD,36-40,12,1,38,Hybrid,Tier1_City,1,1,1,3,5,4,1,17.52,Other,2,3,5,1,5,1,1,3,3,2,0,0,4,1,57.23
Art,Analytical Chemist,4.466562843666488,2,1,3,1,3,1,1,2,4,4,1,2,4,1,Arts,Bachelors,18-24,10,0,0,Remote,Tier3_City,3,4,0,5,2,0,3,23.2,Education,2,1,1,2,1,2,5,1,4,3,1,0,5,5,60.12
Physics,Music Therapist,3.4314251300720766,7,0,3,0,4,0,2,3,3,2,1,1,0,1,Science,Bachelors,31-35,1,0,0,Hybrid,Tier1_City,3,1,0,2,4,1,3,13.02,Education,5,3,3,4,1,4,4,3,2,4,1,0,4,2,49.24
Medicine,Mechanical Engineer,2.777811656697456,3,2,4,0,5,1,1,2,4,1,3,0,0,1,Science,Bachelors,18-24,13,0,0,Hybrid,Tier2_City,2,3,1,1,4,4,1,43.59,Healthcare,1,4,5,3,5,4,3,5,5,3,1,1,2,1,59.91
Music,School Counselor,2.709980778080199,1,0,4,1,1,0,4,2,3,0,4,1,4,1,Arts,Bachelors,36-40,3,0,0,Remote,Tier2_City,2,2,1,1,2,0,1,12.18,Education,5,2,2,3,0,2,3,1,5,1,0,1,4,5,50.73
Law,Chemical Engineer,4.614502922095944,1,2,0,0,4,0,2,4,0,4,4,2,0,1,Arts,High School,25-30,6,0,0,Flexible,Tier2_City,2,3,4,1,5,3,4,43.37,Other,4,1,4,3,2,2,3,1,4,1,0,0,3,2,55.13
Law,Credit Analyst,3.610921183432732,3,0,4,1,9,1,0,0,0,1,3,1,1,1,Arts,Bachelors,18-24,1,0,0,Remote,Tier3_City,5,5,4,3,5,1,5,24.41,Tech,4,2,5,5,4,3,4,2,5,3,0,1,5,1,42.4
Physics,Ecologist,2.936909467083588,1,1,1,0,8,0,2,2,1,1,2,3,0,1,Science,Bachelors,25-30,4,1,43,Hybrid,Tier2_City,3,5,5,2,5,3,5,42.25,Education,3,4,1,5,4,1,3,3,2,5,1,0,2,1,54.71
Law,Aerospace Engineer,4.057877738822704,3,2,0,0,5,0,4,3,4,3,4,0,4,1,Arts,Masters,18-24,13,1,35,Office,Tier2_City,4,1,4,2,5,3,3,15.43,Healthcare,4,5,1,5,0,3,5,2,5,4,1,0,2,1,83.91
Engineering,AI Researcher,3.821095716547408,7,1,4,1,5,1,4,0,2,2,1,1,4,1,Science,Bachelors,25-30,6,1,19,Remote,Tier1_City,1,4,3,3,0,1,2,9.24,Manufacturing,3,1,1,1,2,2,2,1,1,3,0,1,1,5,39.14
Chemistry,Teacher,4.079831018945758,0,1,1,1,2,1,1,4,4,2,2,0,3,0,Science,Bachelors,31-35,8,1,55,Flexible,Tier2_City,4,4,2,1,2,4,2,29.08,Education,5,1,3,1,0,4,4,3,5,4,0,1,2,1,57.93
Finance,Electrical Engineer,3.791086668489119,7,0,0,1,6,0,3,3,3,2,3,4,0,1,Commerce,PhD,25-30,7,0,0,Office,Tier2_City,1,5,4,1,0,5,3,26.94,Healthcare,2,1,4,4,2,1,4,3,1,1,1,0,3,3,61.23
Chemistry,Electrical Engineer,3.3480770256036982,4,0,1,0,2,0,0,1,3,2,4,1,4,1,Science,Bachelors,25-30,8,1,6,Remote,Tier2_City,5,4,4,5,4,2,4,19.76,Education,2,5,5,5,0,4,1,5,5,5,0,0,1,5,64.31
Psychology,Zoologist,4.553910626723648,1,2,4,0,0,1,0,2,1,4,4,0,1,0,Arts,Bachelors,18-24,6,0,0,Flexible,Tier2_City,1,4,0,4,0,2,1,34.15,Education,1,2,3,5,1,2,4,2,2,3,1,0,4,1,46.13
Marketing,Ecologist,4.0538153710356255,6,1,1,0,4,0,0,2,1,1,0,1,4,1,Commerce,Bachelors,18-24,2,1,50,Hybrid,Tier1_City,5,1,2,2,5,5,3,7.47,Other,4,5,5,1,4,3,3,5,5,4,1,1,5,4,41.84
Chemistry,Astronomer,4.8353388782960085,2,0,3,1,1,1,0,2,4,2,0,4,0,0,Science,Bachelors,18-24,0,0,0,Office,Tier1_City,3,3,1,2,4,1,5,32.23,Tech,1,2,2,3,5,1,4,2,5,2,0,1,5,2,47.97
Psychology,Education Administrator,4.321890361884073,1,1,2,0,9,1,2,3,3,4,4,1,2,0,Arts,Masters,36-40,9,0,0,Flexible,Tier2_City,1,3,3,2,0,2,2,12.95,Healthcare,1,1,2,3,0,5,4,2,5,3,0,1,2,2,66.84
Business,Legal Secretary,3.7976225262531553,5,0,3,0,0,0,0,0,3,3,3,1,1,1,Commerce,Bachelors,18-24,6,1,9,Flexible,Tier2_City,2,2,1,4,0,5,2,9.06,Healthcare,2,5,5,2,2,3,5,3,2,2,1,0,5,1,42.79
Law,Sound Engineer,4.129164955478046,5,1,0,1,3,1,3,4,0,0,2,1,2,1,Arts,Masters,25-30,12,0,0,Hybrid,Tier1_City,2,3,0,5,2,0,2,45.75,Finance,4,4,3,4,5,1,5,3,4,1,1,1,4,4,57.86
Music,AI Researcher,4.484675235786769,7,1,0,1,4,1,1,0,2,1,1,0,2,0,Arts,High School,25-30,10,0,0,Remote,Tier1_City,5,3,3,4,0,5,4,24.61,Finance,2,5,1,4,5,5,4,4,4,5,0,1,5,2,50.21
Education,Forensic Psychologist,3.621073758372436,3,0,3,0,6,1,0,0,4,1,1,2,1,1,Arts,Bachelors,18-24,5,0,0,Remote,Tier2_City,3,1,4,1,4,4,5,38.88,Healthcare,1,2,3,5,5,5,3,1,1,5,1,0,1,4,48.31
Computer Science,Investment Banker,3.0127274945211377,5,2,3,1,9,1,4,1,0,1,3,4,3,1,Science,Masters,31-35,1,0,0,Office,Tier3_City,5,1,2,1,5,5,4,7.19,Other,4,1,3,1,4,4,5,5,5,3,0,0,2,3,55.55
Engineering,Urban Planner,3.505251708213284,5,1,0,1,4,0,4,2,1,3,0,4,1,0,Science,Bachelors,25-30,0,0,0,Flexible,Tier1_City,4,3,2,2,2,3,1,5.7,Tech,2,2,5,4,0,0,2,4,2,5,0,1,3,5,44.12
Finance,Surgeon,3.665683748510836,1,1,1,1,3,0,0,4,2,0,1,3,1,1,Commerce,Masters,25-30,11,0,0,Remote,Tier2_City,4,2,4,3,0,3,3,26.26,Education,3,3,3,3,3,1,5,5,3,3,0,1,5,4,55.47
Architecture,Composer,3.921475774193718,7,0,0,0,1,0,4,1,2,2,2,2,2,0,Interdisciplinary,Bachelors,25-30,9,0,0,Remote,Any,4,3,1,2,2,1,3,17.83,Manufacturing,3,1,2,1,4,2,1,5,1,4,1,1,5,1,51.38
Medicine,Pharmacist,3.301382676637669,2,0,4,1,6,1,0,4,4,1,1,3,0,1,Science,Masters,25-30,3,0,0,Office,Tier1_City,2,3,1,3,3,3,2,3.23,Other,5,4,5,5,5,1,1,1,3,4,0,1,2,1,56.79
Engineering,Legal Secretary,3.519497008450851,6,1,1,0,4,0,1,1,1,0,2,1,3,1,Science,Bachelors,25-30,13,0,0,Hybrid,Tier1_City,4,5,4,4,2,0,2,11.61,Education,5,4,5,5,3,5,4,5,2,4,1,0,1,1,52.17
Marketing,Software Developer,2.849722918181669,3,2,0,0,5,0,2,0,2,0,2,4,2,1,Commerce,Masters,25-30,3,0,0,Remote,Any,1,2,4,1,5,5,1,13.28,Manufacturing,4,3,5,4,2,2,4,5,5,3,1,1,2,4,55.39
Law,Physician Assistant,4.256001270161121,1,1,3,1,9,1,3,0,4,4,3,3,3,0,Arts,Bachelors,31-35,5,0,0,Remote,Tier1_City,4,3,2,3,3,0,4,16.56,Tech,5,2,3,4,1,0,3,3,4,2,0,0,3,2,60.47
Education,Social Media Manager,3.2059217440619543,6,2,4,0,7,1,2,3,0,0,0,4,1,1,Arts,Masters,18-24,10,0,0,Hybrid,Tier2_City,2,1,1,4,3,1,5,44.24,Finance,4,4,4,2,1,0,2,3,5,1,0,0,2,5,58.13
Chemistry,Nuclear Physicist,4.707892153524927,9,0,3,0,4,1,2,1,3,3,0,3,3,1,Science,Bachelors,25-30,4,0,0,Flexible,Tier2_City,1,3,5,1,2,3,1,22.77,Healthcare,1,2,1,4,2,4,3,3,2,2,1,1,2,4,47.3
Computer Science,Surgeon,3.239902439937868,8,1,4,0,8,1,4,0,2,4,4,3,3,0,Science,Masters,18-24,8,0,0,Flexible,Tier1_City,3,4,3,3,4,2,3,34.93,Tech,3,1,1,4,3,4,3,1,2,2,1,1,5,2,63.46
Law,Electrical Engineer,2.55834964384236,9,2,0,1,0,1,4,2,1,3,0,1,4,0,Arts,Bachelors,18-24,7,1,9,Hybrid,Tier1_City,5,5,3,2,5,5,3,3.86,Manufacturing,4,5,2,3,5,0,1,3,1,5,1,1,3,3,52.05
Finance,Illustrator,3.733105575186073,0,0,3,0,6,1,2,3,2,3,4,0,1,0,Commerce,PhD,25-30,8,1,54,Flexible,Tier2_City,5,5,0,2,4,2,4,41.25,Other,1,1,5,3,1,1,2,4,1,2,1,0,4,3,61.71
Art,Physicist,3.97856595221436,9,1,1,0,2,1,1,1,3,4,3,4,3,0,Arts,Bachelors,36-40,9,1,23,Remote,Tier3_City,1,5,0,2,5,4,1,14.3,Healthcare,3,2,1,1,5,5,2,4,2,3,1,0,1,4,59.81
Art,Landscape Architect,3.193182317187578,1,2,3,0,6,0,3,1,4,3,3,3,3,1,Arts,Bachelors,36-40,6,0,0,Flexible,Tier1_City,1,2,0,4,5,1,5,17.52,Manufacturing,2,3,3,4,1,1,5,4,2,5,0,1,2,5,62.49
Chemistry,Market Research Analyst,2.910623985492008,6,1,1,0,7,1,3,1,3,2,2,0,4,1,Science,Bachelors,18-24,8,0,0,Remote,Tier2_City,5,5,1,2,4,4,1,5.13,Education,1,1,3,4,3,4,4,1,2,5,0,0,4,5,56.21
Architecture,Legal Analyst,4.308928002114251,4,0,4,1,7,0,1,3,4,2,1,3,1,0,Interdisciplinary,Bachelors,25-30,2,0,0,Office,Tier2_City,5,3,3,5,1,2,1,22.26,Education,2,4,3,5,0,1,4,2,1,2,0,0,5,2,41.31
Medicine,Urban Planner,3.3270108578412776,6,2,0,1,3,1,2,4,4,2,3,1,1,0,Science,Bachelors,25-30,8,0,0,Hybrid,Tier1_City,1,2,1,1,3,2,4,43.07,Other,5,1,2,3,1,1,1,2,1,3,1,1,3,4,60.24
Architecture,Biochemist,2.5984985413384,2,0,4,1,3,0,1,1,0,0,2,0,2,1,Interdisciplinary,PhD,18-24,1,1,22,Remote,Tier2_City,5,4,4,4,2,2,5,20.8,Education,4,1,5,5,1,1,1,4,2,5,0,0,3,5,42.77
Architecture,Music Therapist,4.844327392616843,9,1,1,0,3,0,4,2,2,2,2,0,2,1,Interdisciplinary,PhD,31-35,8,0,0,Flexible,Tier1_City,3,1,2,2,4,4,3,45.7,Healthcare,3,1,1,4,0,1,5,2,3,4,1,1,5,1,64.86
Chemistry,Quantum Physicist,2.611385658010846,7,1,4,0,7,0,0,4,1,2,4,3,4,1,Science,Bachelors,31-35,12,0,0,Remote,Tier2_City,4,5,5,1,4,1,2,43.77,Finance,5,3,5,3,3,2,5,5,5,5,1,1,5,1,68.19
Chemistry,Special Education Teacher,3.043052658597077,4,0,4,1,3,0,4,1,3,3,4,4,3,1,Science,PhD,36-40,5,0,0,Flexible,Tier2_City,4,3,0,3,2,5,5,5.91,Finance,1,2,5,4,3,4,3,1,3,1,1,1,1,4,63.13
Law,Cybersecurity Analyst,3.254364896731971,8,2,3,0,6,0,4,1,3,3,3,0,4,0,Arts,Bachelors,18-24,3,0,0,Remote,Tier2_City,3,2,4,2,3,5,3,17.35,Manufacturing,5,3,3,2,0,0,4,4,1,2,1,0,4,1,43.8
Art,Surgeon,2.820722141880024,2,0,1,1,4,1,4,4,4,2,1,4,4,1,Arts,Bachelors,18-24,11,0,0,Remote,Tier1_City,4,3,4,1,2,0,4,45.79,Finance,2,4,1,5,1,0,5,4,1,4,1,0,2,3,67.06
Education,Curriculum Developer,4.759853948529784,5,1,3,0,9,1,3,3,0,2,3,3,3,0,Arts,Masters,36-40,13,0,0,Flexible,Tier3_City,4,5,5,5,5,0,5,4.4,Finance,2,2,2,3,0,2,2,4,3,2,0,1,5,4,66.85
Physics,Dentist,2.7680352988258257,2,0,2,1,6,0,1,4,0,4,4,0,4,1,Science,Masters,31-35,11,0,0,Hybrid,Tier2_City,4,1,2,3,1,2,5,38.99,Manufacturing,4,4,5,3,2,4,3,5,3,1,0,0,3,5,53.76
Law,Surgeon,3.654424938229513,0,1,2,1,5,0,4,3,1,3,0,0,1,1,Arts,PhD,36-40,12,0,0,Hybrid,Tier2_City,2,2,3,5,5,1,3,45.6,Manufacturing,5,2,4,4,5,5,3,3,4,2,0,0,5,1,68.33
Chemistry,Principal,3.603605108201503,6,2,1,1,1,0,4,1,0,4,3,1,1,1,Science,Bachelors,18-24,10,0,0,Remote,Any,3,3,3,1,1,1,3,39.21,Manufacturing,3,2,3,4,0,2,4,4,3,4,0,0,5,3,57.76
Physics,Actuary,3.532357364183205,7,0,2,0,3,1,4,1,3,2,2,3,1,1,Science,Masters,25-30,1,1,44,Hybrid,Any,5,2,4,5,2,3,1,37.96,Healthcare,2,1,4,1,5,4,4,2,3,1,1,1,3,2,43.88
Biology,Landscape Architect,3.14245932294406,1,1,3,0,5,0,3,2,0,3,3,1,1,1,Science,Bachelors,25-30,12,1,48,Hybrid,Tier2_City,1,5,2,1,5,3,1,42.64,Manufacturing,1,1,2,1,4,2,4,3,4,4,1,0,3,4,61.48
Finance,Physicist,3.515138457511383,5,0,3,1,3,0,1,3,1,0,3,1,2,1,Commerce,Bachelors,18-24,9,1,53,Hybrid,Tier1_City,3,5,3,1,3,4,5,34.29,Healthcare,5,3,2,5,3,1,1,5,5,1,0,1,3,5,56.43
Psychology,Quantum Physicist,2.9537924341044257,4,0,0,0,8,0,4,2,3,1,0,3,1,1,Arts,High School,25-30,2,0,0,Hybrid,Tier3_City,3,4,0,5,5,3,2,22.89,Healthcare,3,2,2,3,1,2,4,4,3,1,0,0,5,4,42.33
Finance,Composer,4.811134894750631,7,1,4,0,5,1,4,0,4,1,0,0,3,0,Commerce,PhD,31-35,4,0,0,Hybrid,Tier1_City,2,4,1,1,4,5,4,5.95,Healthcare,3,4,2,4,1,2,1,3,3,5,0,1,2,4,60.45
Engineering,Quantum Physicist,4.6365136626911925,2,1,3,0,5,0,2,0,4,3,4,0,1,1,Science,Masters,18-24,8,1,42,Flexible,Tier2_City,2,5,2,2,1,5,3,40.03,Manufacturing,3,1,1,5,2,3,5,4,1,4,1,1,3,4,56.96
Music,Financial Analyst,3.4922072479414985,6,0,4,1,3,1,1,2,0,3,1,3,0,1,Arts,Masters,25-30,6,0,0,Office,Tier2_City,4,2,5,1,1,4,1,45.55,Finance,3,4,4,3,1,4,2,4,5,1,0,1,1,3,51.58
Psychology,Risk Analyst,2.692520101310285,9,2,3,1,2,0,3,4,4,0,0,0,0,1,Arts,Bachelors,31-35,10,0,0,Hybrid,Any,2,3,4,4,3,0,4,27.04,Other,2,1,3,4,2,1,2,5,3,1,1,0,1,4,53.14
Medicine,Human Resources Specialist,4.652982334333148,3,0,0,0,9,0,4,0,4,1,1,1,3,0,Science,Bachelors,25-30,11,0,0,Hybrid,Any,5,3,1,1,1,2,5,28.03,Other,4,2,4,1,2,2,3,2,3,3,0,0,2,1,52.02
Finance,Actuary,3.1132365732128773,7,2,0,0,6,0,2,0,3,0,4,4,3,1,Commerce,Bachelors,36-40,12,0,0,Hybrid,Tier3_City,5,2,3,4,1,1,3,21.95,Finance,5,4,1,3,3,1,3,5,3,4,1,0,2,2,57.76
Marketing,Astronomer,2.829974056201304,5,2,0,0,6,1,2,0,4,0,4,3,3,0,Commerce,Bachelors,25-30,10,0,0,Remote,Tier2_City,4,1,3,1,3,0,3,43.27,Manufacturing,2,3,5,4,2,5,3,5,2,3,0,0,5,4,62.1
Computer Science,Sound Engineer,2.6205963102460013,4,1,1,1,9,1,2,4,0,3,3,1,1,0,Science,Bachelors,25-30,2,1,46,Hybrid,Tier2_City,2,2,5,1,5,5,1,3.7,Finance,4,3,2,5,3,4,2,2,2,1,0,1,1,3,44.31
Medicine,Credit Analyst,4.728865841671878,0,2,4,0,8,0,4,0,4,0,2,2,0,0,Science,Masters,40+,12,0,0,Office,Tier1_City,4,5,2,5,2,0,2,32.35,Manufacturing,3,3,5,5,5,0,3,3,5,3,0,0,2,2,69.99
Business,Ecologist,4.1681424447576365,4,1,2,1,5,0,0,1,3,1,0,3,0,0,Commerce,Bachelors,36-40,3,0,0,Flexible,Tier3_City,1,5,1,2,5,4,3,45.65,Healthcare,1,1,2,2,5,3,1,5,1,2,0,1,4,1,36.47
Marketing,Dentist,4.179248014735304,7,2,3,0,3,1,4,1,4,3,0,1,1,0,Commerce,Bachelors,18-24,13,0,0,Hybrid,Tier3_City,2,4,3,2,4,2,2,7.85,Education,3,1,3,3,2,3,3,4,5,4,1,1,1,5,67.53
Psychology,Brand Manager,3.9504128971798806,1,2,4,0,0,0,1,3,1,2,2,2,2,0,Arts,High School,31-35,11,0,0,Hybrid,Tier3_City,2,3,2,3,4,5,4,48.08,Tech,4,3,2,5,5,4,5,5,4,4,0,1,5,2,61.94
Education,Acoustics Specialist,3.1127796505991068,3,0,0,1,7,0,0,2,3,0,4,2,3,0,Arts,Bachelors,18-24,10,0,0,Hybrid,Tier1_City,2,4,1,5,1,4,3,48.48,Other,4,4,2,3,0,3,3,2,3,2,0,1,2,4,54.17
Music,Organic Chemist,3.262396669839878,4,1,3,0,6,1,2,0,2,4,2,2,4,0,Arts,Bachelors,18-24,1,0,0,Hybrid,Tier1_City,2,3,4,5,4,0,3,46.7,Manufacturing,1,1,5,5,3,0,1,3,5,2,1,1,5,5,50.05
Computer Science,Financial Analyst,3.449840278374644,4,2,0,0,7,0,2,3,1,3,3,0,1,0,Science,PhD,25-30,13,0,0,Office,Tier2_City,5,2,4,2,2,1,2,24.74,Healthcare,2,3,5,3,4,1,2,2,3,3,1,1,4,3,64.83
Engineering,Geneticist,3.16079804647659,3,2,0,0,7,0,2,2,0,4,4,3,1,1,Science,Masters,25-30,7,1,57,Office,Tier1_City,4,1,3,5,1,3,1,21.0,Education,1,1,5,3,0,2,2,4,5,2,1,1,3,1,61.23
Business,Special Education Teacher,4.341038411957979,2,1,3,0,7,0,1,0,3,3,2,1,1,0,Commerce,Masters,36-40,5,0,0,Remote,Tier1_City,5,3,2,2,4,4,5,36.18,Healthcare,3,5,1,3,2,4,2,3,4,1,0,1,4,5,53.53
Finance,Inorganic Chemist,3.9161238964088825,3,1,3,1,9,1,0,1,4,2,1,2,3,1,Commerce,Bachelors,31-35,2,0,0,Office,Tier1_City,4,1,0,5,0,5,4,17.98,Tech,5,4,2,2,4,5,1,5,3,2,0,0,1,5,36.15
Education,Financial Analyst,4.792524599457089,2,1,1,1,6,0,3,2,2,4,2,3,1,1,Arts,Bachelors,40+,12,0,0,Office,Any,1,1,3,1,0,0,3,6.21,Other,2,2,5,1,3,5,2,3,2,3,0,1,3,4,53.61
Finance,Biochemist,4.66162988931549,0,1,0,1,0,0,4,0,0,0,4,1,1,1,Commerce,Bachelors,31-35,4,0,0,Remote,Tier3_City,2,1,0,2,0,3,1,45.37,Finance,5,4,1,3,4,4,4,5,3,5,1,1,1,2,44.72
Psychology,Clinical Psychologist,4.204423528523392,8,0,2,1,1,0,2,1,3,3,4,2,3,1,Arts,Masters,25-30,4,0,0,Remote,Tier2_City,3,2,1,2,0,3,3,32.84,Finance,5,2,3,1,4,3,3,5,2,4,1,1,2,4,54.52
Medicine,Risk Analyst,3.822473789844783,5,2,1,0,1,1,1,1,2,1,1,1,0,0,Science,Masters,31-35,11,0,0,Office,Tier1_City,5,1,2,4,5,0,4,12.74,Healthcare,2,3,3,1,2,2,1,1,1,2,0,1,2,3,51.2
Engineering,School Counselor,3.568654560732285,2,1,1,1,1,0,3,0,3,2,4,4,4,0,Science,Bachelors,40+,0,1,30,Hybrid,Tier1_City,3,1,5,5,0,2,5,3.87,Tech,3,1,2,1,0,3,3,5,2,5,1,1,5,2,44.09
Music,Conductor,4.263494915924495,3,2,0,0,5,1,1,4,0,4,3,4,3,1,Arts,Bachelors,31-35,12,0,0,Office,Tier1_City,1,5,3,5,1,0,3,37.01,Healthcare,4,3,5,5,4,3,5,5,5,2,1,1,1,5,61.73
Architecture,Biotechnologist,3.480809620194081,7,2,0,0,2,0,2,3,4,2,3,3,3,0,Interdisciplinary,Bachelors,31-35,4,0,0,Remote,Tier2_City,3,5,4,2,3,5,2,43.08,Finance,3,2,2,4,0,1,3,5,3,1,0,0,3,5,51.08
Psychology,Music Therapist,3.6053381735326,4,1,1,1,6,0,0,2,1,2,0,1,4,0,Arts,Masters,36-40,5,0,0,Remote,Tier3_City,1,3,1,1,5,1,1,22.07,Healthcare,4,5,2,1,5,1,1,1,3,4,0,0,3,4,44.74
Medicine,School Psychologist,3.1915563170989607,8,1,0,1,8,0,1,0,1,2,4,1,4,0,Science,PhD,18-24,9,1,13,Remote,Tier1_City,5,5,5,1,3,5,5,6.8,Education,4,2,2,3,4,3,4,3,5,4,1,1,3,2,63.98
Chemistry,Biotechnologist,4.810881041931836,3,2,1,0,9,1,3,3,1,2,4,4,1,0,Science,Masters,31-35,9,0,0,Hybrid,Tier1_City,1,3,1,1,1,3,3,33.49,Tech,2,1,1,4,3,0,4,1,3,5,1,1,2,4,69.56
Engineering,Legal Analyst,4.365648856314264,3,0,0,0,1,0,1,1,2,4,2,0,0,0,Science,Bachelors,36-40,10,0,0,Hybrid,Tier1_City,5,1,1,5,1,1,5,16.96,Finance,2,5,2,5,2,4,2,2,4,2,1,0,4,2,54.5
Engineering,Risk Analyst,4.010819457923408,5,2,2,1,3,0,1,3,4,3,0,2,2,1,Science,Bachelors,40+,10,1,58,Flexible,Tier3_City,5,5,0,4,2,4,2,9.77,Other,1,1,3,2,4,5,4,5,3,1,1,0,2,4,52.97
Music,Artist,3.8870807566150014,4,2,2,1,1,0,3,1,3,4,0,1,3,1,Arts,Bachelors,18-24,10,0,0,Office,Any,3,4,0,2,5,3,3,26.99,Other,5,5,5,1,2,0,5,1,3,1,0,0,3,4,55.72
Finance,Conductor,3.6274224156006527,7,1,0,0,3,1,3,2,4,2,3,4,1,1,Commerce,Bachelors,25-30,12,0,0,Flexible,Tier3_City,4,2,5,3,3,2,5,25.65,Healthcare,5,1,4,1,5,4,5,1,1,3,1,0,5,2,61.66
Engineering,Dentist,4.19944623237451,7,0,4,0,2,0,2,1,2,3,0,1,0,0,Science,High School,31-35,1,0,0,Remote,Tier2_City,4,5,1,4,0,0,3,27.29,Tech,5,2,4,5,5,2,3,3,3,3,1,1,3,5,32.69
Physics,School Counselor,2.729748322667302,9,2,1,0,9,1,4,1,0,1,2,1,0,1,Science,Masters,18-24,2,1,43,Remote,Tier1_City,4,2,3,3,1,4,3,41.72,Healthcare,5,2,4,3,0,2,5,3,3,1,1,0,3,4,41.84
Architecture,Architect,2.7558066130831333,2,1,4,1,3,0,1,1,1,3,2,1,2,0,Interdisciplinary,Masters,31-35,9,1,23,Remote,Tier3_City,2,5,0,4,0,5,5,25.77,Finance,1,2,5,3,4,0,1,3,4,1,0,1,4,3,52.15
Computer Science,Composer,4.342996656186921,2,1,0,1,0,1,3,1,2,3,3,3,0,0,Science,Bachelors,25-30,4,1,32,Hybrid,Tier1_City,3,5,2,1,3,1,3,45.33,Tech,4,2,2,4,3,3,2,4,2,5,0,0,5,1,58.18
Chemistry,Biochemist,3.21827531935135,5,2,4,0,9,0,1,1,2,1,4,1,4,1,Science,Masters,25-30,13,1,20,Remote,Tier1_City,1,4,4,5,5,4,2,42.57,Finance,1,5,5,4,1,5,5,3,2,3,1,0,5,5,61.1
Physics,Ecologist,2.6643653140733385,2,1,2,0,4,1,1,3,4,1,3,2,2,1,Science,Bachelors,25-30,12,0,0,Office,Tier1_City,4,1,3,3,4,2,5,33.6,Education,2,4,5,3,0,3,2,5,3,2,1,0,4,5,59.85
Art,Teacher,3.801819377963701,8,2,4,0,6,1,1,4,4,0,4,2,2,0,Arts,Bachelors,25-30,2,0,0,Remote,Tier1_City,3,3,5,4,4,0,5,5.67,Education,3,4,1,2,2,2,2,1,2,2,1,0,1,1,45.02
Education,Web Developer,3.0761894966766468,5,0,4,0,1,1,0,2,3,1,3,2,2,0,Arts,Bachelors,25-30,4,0,0,Remote,Tier1_City,2,5,5,5,1,4,2,43.65,Other,4,3,5,3,0,3,3,2,1,3,0,1,4,1,44.44
Chemistry,Legal Secretary,3.090600597733636,5,0,4,0,2,0,1,4,4,1,4,4,2,0,Science,Bachelors,25-30,4,1,13,Hybrid,Tier3_City,3,5,2,3,2,5,2,45.56,Manufacturing,4,4,1,2,3,1,1,2,1,2,0,0,3,5,51.96
Chemistry,Financial Advisor,2.9414276960905696,7,1,3,1,7,0,0,2,1,4,4,0,4,0,Science,Bachelors,25-30,7,0,0,Hybrid,Tier1_City,1,2,5,2,0,1,2,20.63,Tech,1,3,3,5,5,2,3,2,2,5,1,0,2,2,51.33
Law,Education Administrator,3.2118817095828347,1,1,4,0,7,1,2,3,1,2,1,3,3,1,Arts,Bachelors,18-24,9,1,48,Office,Tier3_City,4,1,5,4,1,4,3,27.73,Education,2,2,1,2,2,4,5,5,1,2,0,1,3,1,45.6
Architecture,Clinical Psychologist,4.538094321729848,5,2,2,1,1,1,2,1,4,1,2,1,3,0,Interdisciplinary,Bachelors,18-24,8,0,0,Office,Any,1,5,0,2,2,0,3,16.21,Manufacturing,2,1,4,5,2,5,5,1,3,5,1,0,5,5,56.95
Education,Chemist,4.438124881117174,7,2,4,0,7,0,0,2,1,3,4,0,4,1,Arts,PhD,18-24,7,1,53,Remote,Tier2_City,2,5,4,1,0,5,4,3.69,Other,4,4,1,1,2,4,2,4,2,2,1,0,4,3,50.56
Art,School Psychologist,3.159279359065541,2,2,4,1,9,1,0,0,0,2,4,0,0,0,Arts,Bachelors,25-30,11,0,0,Office,Tier1_City,1,3,1,2,3,4,3,25.53,Tech,1,4,3,3,1,3,4,4,4,4,1,1,5,1,54.62
Biology,Teacher,4.673025992706805,3,1,1,0,3,0,0,0,4,0,4,2,3,0,Science,Bachelors,31-35,2,1,32,Hybrid,Tier2_City,2,1,4,2,4,1,2,9.08,Finance,5,2,5,4,5,4,2,3,3,2,0,0,5,4,46.06
Music,Marketing Specialist,4.228152466569117,5,1,4,0,9,1,2,1,0,4,3,2,3,0,Arts,Bachelors,18-24,14,0,0,Hybrid,Tier3_City,1,1,1,4,2,0,4,11.62,Healthcare,4,2,4,1,5,4,1,4,3,2,0,0,3,5,50.21
Biology,Biochemist,3.090440831030065,0,0,4,0,4,0,3,3,2,4,2,3,2,0,Science,Masters,18-24,0,0,0,Remote,Tier1_City,2,5,5,1,0,2,2,25.59,Healthcare,5,4,1,4,1,0,4,1,3,3,0,1,5,1,49.07
Architecture,Microbiologist,2.786406620633908,5,1,4,1,6,1,0,1,3,0,4,0,4,1,Interdisciplinary,Bachelors,31-35,13,0,0,Office,Tier3_City,3,1,2,2,1,2,1,43.75,Finance,3,2,2,2,2,0,4,3,2,2,0,1,1,3,48.52
Art,Graphic Designer,3.802571905467085,9,1,3,1,9,0,0,3,3,4,4,0,3,0,Arts,Masters,25-30,14,0,0,Remote,Tier2_City,3,1,2,5,0,3,5,42.7,Education,2,4,5,3,1,4,4,5,4,5,1,0,3,4,68.79
Architecture,Web Developer,2.5972721466909983,7,1,0,0,1,0,0,4,0,0,1,2,3,0,Interdisciplinary,Bachelors,40+,2,0,0,Remote,Any,3,3,3,3,1,4,1,48.36,Healthcare,4,1,4,3,2,2,5,2,4,5,1,1,2,3,40.47
Finance,Physicist,4.852098418849634,2,2,0,1,5,0,0,2,2,0,1,1,2,1,Commerce,Bachelors,31-35,0,1,25,Remote,Tier3_City,3,4,2,2,4,1,2,25.69,Finance,3,1,4,3,3,5,1,2,4,5,1,1,3,3,40.93
Medicine,Conductor,3.3659018479955285,8,0,0,1,6,1,4,4,0,0,3,3,2,0,Science,Masters,25-30,12,0,0,Hybrid,Tier1_City,1,3,0,1,4,4,3,28.94,Manufacturing,5,3,1,1,2,4,5,3,2,5,1,1,5,1,65.18
Music,Software Developer,4.638466138279469,8,2,4,1,7,1,2,1,4,2,1,3,3,0,Arts,Bachelors,25-30,10,0,0,Hybrid,Tier2_City,5,4,0,2,0,0,5,41.64,Manufacturing,4,4,5,5,1,5,2,3,1,4,0,1,2,2,56.57
Chemistry,Physicist,3.5032888786687293,8,0,3,0,8,0,4,1,4,2,4,0,3,0,Science,Bachelors,25-30,8,0,0,Flexible,Tier1_City,2,3,4,3,0,3,3,35.88,Finance,3,1,5,2,3,1,2,3,3,1,0,1,3,1,52.51
Business,Nuclear Physicist,3.1712168653161514,7,2,0,0,4,0,2,0,0,3,2,1,2,0,Commerce,Bachelors,18-24,11,0,0,Office,Tier1_City,2,5,5,1,1,1,3,11.59,Tech,4,1,2,1,3,2,2,1,3,3,0,1,5,4,50.91
Education,Art Director,2.9630584640589683,4,2,1,0,3,1,2,3,3,2,3,2,1,0,Arts,Masters,18-24,12,1,18,Flexible,Tier3_City,5,3,1,4,1,4,5,21.71,Education,3,5,2,1,1,5,2,3,1,3,0,1,1,2,57.43
Marketing,Geneticist,3.695372964515005,0,1,4,0,4,1,2,0,3,4,4,2,0,0,Commerce,Bachelors,18-24,2,1,27,Office,Any,2,1,5,1,2,1,5,46.67,Education,3,1,4,5,2,1,5,1,2,1,1,0,5,4,45.34
Art,Physical Chemist,3.622658571798757,6,2,0,1,4,0,0,2,1,0,2,1,2,1,Arts,Bachelors,31-35,13,1,31,Remote,Any,2,1,4,4,2,0,1,9.87,Finance,5,3,4,4,1,5,4,3,4,5,0,1,1,5,57.34
Engineering,Data Scientist,4.918724411349347,1,2,3,0,7,1,2,0,0,2,2,1,4,0,Science,PhD,25-30,7,0,0,Hybrid,Tier1_City,3,2,3,1,2,3,2,12.84,Healthcare,2,1,3,4,0,1,1,1,2,1,0,0,4,4,44.98
Music,Principal,3.4094826841242254,7,1,1,0,6,1,4,0,3,0,2,4,1,1,Arts,High School,18-24,5,0,0,Hybrid,Tier1_City,2,5,5,3,0,1,3,21.83,Other,1,2,4,3,1,3,3,1,1,5,1,1,5,4,47.94
Computer Science,Special Education Teacher,4.065804899213081,0,1,0,0,0,1,4,2,1,1,1,4,3,1,Science,Masters,31-35,2,0,0,Hybrid,Tier2_City,2,1,3,3,5,0,2,47.17,Education,3,5,2,1,3,0,3,4,5,3,1,1,5,4,53.4
Art,Music Teacher,4.849772762445763,0,1,0,0,4,0,2,0,0,2,1,3,1,1,Arts,Masters,25-30,8,0,0,Hybrid,Tier1_City,4,5,5,1,5,2,2,8.35,Education,2,4,1,5,2,3,2,4,5,5,1,1,1,4,65.02
Physics,School Psychologist,3.659468294545112,9,0,3,1,6,1,4,3,2,4,0,3,3,0,Science,Bachelors,25-30,7,1,23,Office,Tier1_City,2,3,0,2,5,1,4,34.63,Manufacturing,1,3,3,5,4,5,5,3,1,4,1,0,1,1,59.07
Marketing,Composer,3.21069779479231,8,1,0,0,1,1,3,1,2,0,4,0,2,0,Commerce,Bachelors,18-24,2,0,0,Remote,Tier3_City,5,1,3,3,5,3,1,9.21,Manufacturing,5,1,4,4,2,1,2,3,1,5,1,1,3,4,49.98
Medicine,Fluid Mechanics Engineer,4.3757454464729975,4,1,0,1,7,1,1,2,0,4,3,1,0,0,Science,Bachelors,25-30,6,0,0,Office,Tier3_City,2,5,5,4,2,5,3,27.65,Manufacturing,4,4,2,5,3,3,5,1,4,4,1,0,1,2,57.46
Business,Paralegal,3.267365017725087,5,2,2,0,8,0,2,2,2,3,4,0,1,0,Commerce,Masters,40+,4,1,7,Remote,Any,5,3,0,4,0,5,5,28.22,Other,2,1,3,4,5,3,4,1,3,4,1,0,2,1,52.93
Architecture,Doctor,3.7751458335439176,4,2,0,0,9,0,0,2,3,4,0,3,3,0,Interdisciplinary,Masters,18-24,1,0,0,Remote,Tier2_City,2,4,1,5,5,1,5,5.0,Education,4,5,1,4,2,2,1,4,4,1,0,1,5,3,50.3
Physics,Nuclear Physicist,3.8905151675566354,6,1,0,1,8,1,3,1,1,1,1,0,1,1,Science,Masters,25-30,13,0,0,Hybrid,Tier2_City,5,2,4,4,4,1,2,47.84,Education,4,4,1,1,3,3,2,5,3,1,0,0,2,1,47.89
Architecture,Civil Engineer,4.999273562225014,6,1,2,1,6,0,2,0,2,4,1,2,1,0,Interdisciplinary,PhD,18-24,7,1,52,Hybrid,Tier3_City,2,3,5,5,3,0,1,40.91,Other,1,2,2,2,4,2,1,2,4,2,0,1,4,2,57.97
Music,Clinical Psychologist,4.226749775595752,2,2,0,0,8,0,3,1,1,0,2,4,1,1,Arts,Masters,18-24,0,0,0,Remote,Tier1_City,2,4,3,1,4,4,1,17.23,Education,2,2,5,3,5,3,4,2,2,1,1,1,4,1,37.61
Architecture,Architectural Technologist,4.006787554754104,2,1,0,1,6,0,3,2,2,2,0,3,4,1,Interdisciplinary,Bachelors,25-30,3,1,59,Hybrid,Tier3_City,4,5,1,1,0,5,3,9.14,Healthcare,3,4,2,2,5,5,3,5,3,5,1,1,2,5,46.44
Architecture,Accountant,3.484057657929327,5,0,4,0,2,0,1,4,0,0,2,2,2,1,Interdisciplinary,Bachelors,36-40,10,0,0,Hybrid,Tier1_City,4,4,3,1,0,4,3,19.24,Healthcare,1,2,2,5,1,3,2,5,4,2,0,0,4,5,49.49
Art,Human Resources Specialist,3.9913530920107023,4,0,4,1,4,0,1,0,0,3,2,2,0,1,Arts,Masters,36-40,12,0,0,Remote,Tier3_City,2,1,2,2,3,5,2,45.03,Healthcare,2,3,2,2,5,1,3,2,1,4,0,0,5,3,53.45
Chemistry,Actuary,4.1015402764039655,2,2,2,0,9,0,0,1,0,1,3,3,1,1,Science,Bachelors,18-24,10,0,0,Office,Tier3_City,4,5,3,2,1,1,2,9.24,Tech,3,5,5,2,0,1,1,4,4,1,1,0,5,4,47.79
Music,Interior Designer,4.800903758596861,4,1,3,0,5,1,4,0,4,3,4,1,4,1,Arts,Bachelors,25-30,11,0,0,Remote,Tier1_City,1,2,1,5,1,3,2,19.42,Education,4,3,4,4,2,4,1,2,2,2,1,1,3,1,58.21
Architecture,Human Resources Specialist,4.127088970037801,1,1,3,1,5,0,4,3,3,0,1,2,2,1,Interdisciplinary,Masters,31-35,12,0,0,Office,Tier3_City,1,2,3,4,1,3,4,26.23,Other,5,4,4,1,4,4,3,5,1,1,0,1,3,2,53.64
Psychology,Biologist,2.5987176621775463,5,2,0,0,2,0,1,3,3,4,4,0,0,0,Arts,Bachelors,25-30,3,0,0,Hybrid,Tier1_City,3,5,2,4,2,5,1,4.55,Education,5,3,1,5,2,2,4,2,3,5,0,1,1,3,55.4
Marketing,Game Developer,3.348422400708113,0,0,4,0,4,0,1,3,2,4,3,2,2,1,Commerce,PhD,25-30,12,0,0,Hybrid,Tier2_City,3,1,3,1,1,5,2,15.6,Other,1,5,4,3,0,1,1,2,1,3,1,1,1,1,62.05
Business,Urban Planner,3.0373247231486777,9,1,3,1,8,1,4,4,3,2,4,4,3,0,Commerce,Masters,18-24,9,0,0,Flexible,Tier3_City,1,5,1,3,2,0,1,30.99,Finance,3,5,2,4,0,4,5,5,4,2,1,0,4,3,71.26
Chemistry,Zoologist,4.493805579067829,6,2,2,0,6,0,3,3,0,3,2,3,2,0,Science,Bachelors,25-30,13,0,0,Office,Tier3_City,3,5,0,2,2,1,5,18.23,Finance,3,4,4,3,0,5,1,4,2,1,1,0,3,1,55.1
Computer Science,Biomedical Engineer,4.234724304365713,0,2,0,1,3,1,3,3,4,0,1,1,0,0,Science,PhD,25-30,4,0,0,Office,Any,2,5,1,2,1,1,5,43.91,Tech,5,3,5,1,4,3,1,2,4,2,1,1,1,2,53.32
Medicine,Nuclear Physicist,3.3488864771108595,6,2,3,0,9,1,1,0,2,1,1,3,2,0,Science,Bachelors,31-35,3,1,22,Remote,Tier1_City,2,3,0,1,1,4,1,47.03,Finance,3,5,4,2,5,1,5,3,4,3,0,1,3,5,42.79
Marketing,Artist,4.884588591319613,3,1,1,1,0,1,3,3,0,4,1,2,4,1,Commerce,Bachelors,31-35,0,1,6,Remote,Tier2_City,3,2,0,2,3,0,5,23.75,Healthcare,2,4,2,2,0,5,1,3,5,1,1,0,4,1,41.97
Biology,Forensic Psychologist,2.5340948183862384,6,0,3,0,4,0,0,4,0,4,4,4,4,0,Science,Bachelors,18-24,13,0,0,Hybrid,Any,1,2,4,1,5,2,5,28.0,Tech,2,5,4,1,0,5,4,2,2,2,1,1,4,4,57.52
Art,Legal Analyst,4.115614882271874,1,0,1,0,6,0,1,2,4,3,3,3,2,1,Arts,Bachelors,18-24,6,0,0,Hybrid,Tier2_City,5,1,5,5,3,3,5,32.65,Tech,5,1,1,5,5,3,5,5,1,5,1,0,4,5,59.59
Business,Art Therapist,3.272352428505497,8,0,1,0,2,0,0,0,1,3,1,0,3,0,Commerce,Bachelors,36-40,9,0,0,Flexible,Any,2,2,1,4,2,3,3,34.23,Tech,4,1,4,4,0,3,1,3,5,1,0,1,3,4,46.0
Finance,Advertising Manager,2.549311921609542,5,0,1,1,4,1,2,0,1,3,4,0,1,0,Commerce,Bachelors,25-30,10,0,0,Hybrid,Tier2_City,4,1,4,3,3,1,3,5.97,Manufacturing,4,5,1,2,0,5,5,2,1,5,1,1,1,2,54.22
Finance,Interior Designer,2.6325493036227727,5,0,1,1,0,0,4,2,1,0,4,0,2,0,Commerce,Bachelors,36-40,1,0,0,Hybrid,Tier3_City,5,1,0,4,2,0,1,5.52,Finance,4,4,3,1,5,2,1,5,1,2,0,0,4,3,35.27
Medicine,Counselor,3.0513801074321614,8,2,2,0,1,0,0,3,4,1,4,2,3,1,Science,Bachelors,18-24,9,0,0,Hybrid,Any,4,2,3,4,0,2,1,43.68,Education,5,1,5,4,4,1,1,3,3,1,1,0,1,5,53.72
Art,Industrial-Organizational Psychologist,2.881888780269991,7,0,4,1,6,0,3,0,2,4,4,3,3,0,Arts,Masters,25-30,2,0,0,Office,Tier3_City,2,5,0,5,2,3,4,13.33,Manufacturing,1,5,1,4,2,3,2,4,3,1,0,0,3,2,54.94
Biology,Inorganic Chemist,3.765858196920206,2,0,1,0,0,0,0,4,4,0,4,0,0,0,Science,Masters,25-30,4,0,0,Remote,Any,3,5,1,2,2,0,3,30.45,Other,3,2,3,1,4,2,1,5,2,1,0,1,2,5,45.37
Art,Software Developer,2.9776096601236497,2,1,4,0,8,0,0,4,4,1,0,1,2,1,Arts,Bachelors,36-40,7,1,41,Flexible,Tier1_City,4,3,1,3,3,2,1,32.36,Healthcare,2,3,3,2,5,0,2,3,2,5,0,1,1,4,53.3
Chemistry,Brand Manager,4.453178131470441,3,0,0,0,1,1,0,4,2,2,0,2,0,0,Science,Bachelors,18-24,9,0,0,Hybrid,Tier2_City,1,1,1,2,5,5,3,10.73,Manufacturing,2,5,2,5,4,0,1,1,4,3,0,1,2,1,58.26
Business,Special Education Teacher,4.607111341989292,5,2,4,1,0,1,0,2,4,1,2,0,1,0,Commerce,Bachelors,18-24,7,0,0,Office,Tier1_City,4,4,1,4,0,1,4,38.8,Healthcare,1,1,3,2,0,3,4,1,2,5,0,1,2,5,48.27
Education,Risk Analyst,4.493461623349932,3,0,1,0,7,0,1,4,3,0,1,0,0,1,Arts,Bachelors,25-30,13,1,10,Hybrid,Tier1_City,1,4,3,1,4,4,1,43.7,Education,3,5,5,2,1,3,3,5,2,3,0,1,4,3,49.04
Physics,Counselor,4.508460821895001,4,1,1,0,2,0,0,2,2,3,2,2,2,1,Science,Masters,36-40,1,1,35,Office,Tier2_City,5,2,4,4,4,3,1,16.41,Education,4,4,5,2,5,0,2,3,3,5,0,0,1,4,48.88
Biology,Special Education Teacher,3.949317748659333,3,0,1,1,1,1,2,3,0,3,0,4,2,1,Science,Masters,36-40,8,0,0,Remote,Any,5,2,2,2,5,3,1,44.26,Finance,2,1,5,2,2,4,3,4,5,1,1,1,1,3,59.89
Business,Cybersecurity Analyst,4.826774855799027,9,2,4,0,6,1,1,4,2,3,4,3,0,1,Commerce,Bachelors,40+,5,1,42,Office,Tier2_City,3,4,4,4,4,2,1,6.81,Other,4,4,5,3,2,2,3,5,3,4,1,1,4,1,59.19
Biology,School Counselor,4.788058946776305,8,2,1,1,4,1,1,2,3,0,4,2,1,1,Science,Bachelors,40+,8,0,0,Hybrid,Any,1,3,0,1,0,4,2,40.62,Manufacturing,4,4,2,1,1,3,4,5,2,5,0,0,3,1,54.18
Law,Interior Designer,4.0553418232937535,9,0,0,0,8,1,1,0,0,3,0,4,4,1,Arts,Bachelors,18-24,13,0,0,Hybrid,Any,3,1,1,5,1,5,3,33.09,Education,5,4,4,5,2,0,4,4,4,1,0,1,1,1,46.09
Business,Doctor,3.3265015718104864,9,2,3,1,1,0,0,2,2,3,4,2,0,1,Commerce,Masters,18-24,3,0,0,Remote,Tier1_City,4,1,1,2,0,0,3,30.41,Healthcare,5,5,1,5,5,0,4,2,4,3,0,1,2,3,53.85
Education,Marketing Specialist,4.733005937291864,8,0,1,0,6,0,4,1,2,2,3,3,0,1,Arts,Bachelors,18-24,2,1,59,Office,Tier1_City,3,2,2,4,3,1,3,13.82,Education,3,1,2,3,0,0,3,2,4,5,1,1,5,3,59.93
Engineering,Musician,4.549151929101347,4,1,0,0,7,1,2,0,3,1,3,3,1,0,Science,PhD,25-30,13,0,0,Remote,Tier1_City,4,2,4,2,2,0,4,20.01,Finance,2,4,2,5,0,0,1,4,3,3,1,0,5,5,68.62
Architecture,Illustrator,3.873201614697439,7,2,3,1,1,0,1,1,1,4,3,1,1,1,Interdisciplinary,Masters,36-40,13,0,0,Remote,Tier2_City,5,5,0,5,2,2,2,45.78,Healthcare,5,2,1,3,0,0,5,4,4,5,0,0,2,1,66.28
Business,Special Education Teacher,3.9533489541121822,5,0,4,0,0,1,2,4,3,4,2,3,0,1,Commerce,Bachelors,36-40,4,0,0,Remote,Tier1_City,3,3,1,4,3,3,3,24.89,Tech,3,3,1,3,0,0,4,3,2,1,1,1,2,4,50.81
Computer Science,Paralegal,3.7329955651413664,9,0,3,1,9,1,0,2,4,0,1,3,1,1,Science,Masters,18-24,4,0,0,Remote,Tier3_City,5,1,5,4,3,5,3,30.94,Other,1,5,4,5,3,3,2,4,3,1,0,1,1,1,46.53
Engineering,Art Therapist,3.3266900156090404,7,0,4,1,9,0,2,1,3,4,0,3,3,0,Science,PhD,31-35,3,0,0,Office,Tier1_City,4,5,2,2,2,3,1,46.99,Finance,4,2,4,5,0,5,1,1,2,3,0,1,3,2,54.32
Physics,Entrepreneur,4.024793819508863,6,1,1,1,3,0,0,2,1,0,4,1,0,1,Science,Masters,36-40,12,0,0,Remote,Tier1_City,1,4,2,2,5,0,1,24.92,Finance,2,1,5,2,3,5,4,1,5,3,0,0,3,3,61.42
Engineering,Inorganic Chemist,3.358741106053051,9,0,1,1,9,1,4,0,2,4,4,3,1,1,Science,Bachelors,25-30,6,0,0,Remote,Tier1_City,2,5,5,1,1,5,1,21.25,Tech,2,3,4,3,5,2,4,2,2,5,0,0,1,1,61.2
Law,Chemical Engineer,4.730625819884823,4,1,2,1,6,1,1,0,4,2,3,1,1,0,Arts,Bachelors,18-24,7,0,0,Hybrid,Tier2_City,4,4,0,5,1,1,3,44.98,Other,3,4,4,4,2,0,4,1,5,2,0,1,4,3,52.06
Medicine,Graphic Designer,2.6279153426756423,3,1,3,0,9,0,4,2,0,2,1,4,4,1,Science,Masters,25-30,14,0,0,Hybrid,Any,4,4,2,1,1,2,1,45.81,Education,5,2,1,1,2,0,5,1,5,5,1,1,5,5,65.8
Marketing,Composer,3.339830128633115,8,2,1,0,4,1,2,4,2,2,4,1,1,0,Commerce,Masters,25-30,4,1,43,Hybrid,Any,2,1,5,4,3,1,3,19.67,Finance,4,2,3,2,3,5,1,3,1,2,1,1,2,4,52.47
Chemistry,Web Developer,2.8052249180636983,2,1,4,0,4,0,3,4,0,0,4,2,0,1,Science,Masters,25-30,14,0,0,Hybrid,Any,2,5,2,2,2,2,4,30.82,Tech,4,4,5,3,2,0,4,2,1,4,0,1,3,5,57.47
Architecture,Doctor,2.6631555098422925,5,1,4,1,3,0,0,1,2,2,3,4,1,1,Interdisciplinary,Masters,25-30,8,0,0,Hybrid,Tier1_City,5,1,4,4,5,1,4,48.3,Other,2,4,5,2,4,0,1,3,2,1,0,0,4,2,55.26
Music,Civil Engineer,3.994085344148244,3,2,3,0,0,0,4,3,2,3,1,4,4,1,Arts,Masters,18-24,6,1,30,Hybrid,Tier2_City,4,3,1,4,2,0,5,5.61,Tech,2,2,2,2,1,0,1,5,5,3,0,0,5,3,61.74
Education,Principal,3.35301726076684,7,1,1,0,0,1,2,2,4,2,3,0,2,1,Arts,PhD,40+,12,0,0,Office,Tier2_City,4,3,4,3,2,4,2,4.87,Other,4,1,4,1,4,1,3,1,3,3,1,0,2,2,66.66
Engineering,Software Developer,4.550459887955588,6,1,2,0,4,0,4,3,3,4,4,0,2,1,Science,Bachelors,25-30,12,0,0,Remote,Tier1_City,3,3,2,3,5,5,1,27.28,Finance,1,5,4,5,3,1,1,1,3,3,0,0,1,3,74.52
Art,Surgeon,3.8124899068678975,5,2,0,0,0,0,1,3,1,4,2,0,0,1,Arts,Bachelors,25-30,6,0,0,Flexible,Tier2_City,2,3,3,4,0,2,1,16.69,Manufacturing,3,1,1,5,1,0,5,3,4,4,0,1,4,3,54.4
Chemistry,Physician Assistant,3.073861812795468,4,0,3,0,0,1,3,4,4,0,1,1,3,1,Science,Masters,40+,7,0,0,Remote,Tier1_City,1,4,0,2,5,0,2,30.35,Finance,1,1,4,1,5,0,5,5,4,4,1,1,2,2,63.54
Chemistry,Credit Analyst,4.386739019955879,1,1,4,1,7,1,2,3,4,3,3,0,1,0,Science,Masters,18-24,11,0,0,Office,Tier1_City,4,3,2,4,0,3,2,37.04,Other,5,5,2,2,3,4,5,1,3,2,0,0,1,2,58.54
Psychology,Human Resources Specialist,4.873282092476392,5,0,1,1,6,0,4,3,2,1,4,0,1,1,Arts,Masters,18-24,3,0,0,Hybrid,Tier1_City,3,1,2,3,4,3,5,6.25,Manufacturing,1,1,1,3,0,4,5,4,1,3,1,0,2,5,49.76
Finance,Biochemist,4.710463256592847,5,1,0,0,6,0,3,2,4,2,3,3,0,1,Commerce,Bachelors,36-40,9,0,0,Remote,Any,1,5,5,2,0,1,2,44.47,Education,1,3,5,5,1,2,4,3,5,2,0,1,1,1,64.84
Engineering,Social Media Manager,2.537301333524556,4,2,3,1,5,1,3,2,0,4,0,2,4,0,Science,Masters,25-30,12,0,0,Hybrid,Tier3_City,5,5,4,4,1,3,3,16.01,Tech,5,4,4,4,3,1,1,2,2,4,1,0,1,5,57.72
Medicine,Legal Consultant,4.702927631535431,7,0,0,1,9,0,3,1,3,4,0,2,2,0,Science,Masters,31-35,12,0,0,Office,Tier1_City,3,1,0,5,1,4,1,20.92,Healthcare,3,2,4,3,0,3,3,5,3,4,1,1,5,3,61.41
Chemistry,Architect,3.4698101414334266,2,0,3,0,3,0,3,1,1,0,1,1,4,0,Science,Bachelors,25-30,5,1,26,Hybrid,Any,1,2,5,5,5,2,2,18.84,Finance,4,5,2,2,2,2,4,1,3,1,0,0,4,2,40.24
Finance,Surgeon,4.928573895190692,3,0,3,0,3,1,0,2,1,0,4,3,4,1,Commerce,Bachelors,18-24,4,1,36,Hybrid,Any,4,2,1,4,1,1,3,42.47,Healthcare,1,1,2,4,3,2,2,1,1,3,1,1,3,5,39.82
Education,Musician,2.524540646280112,1,0,4,0,3,1,0,4,4,0,1,1,2,1,Arts,Bachelors,25-30,0,0,0,Remote,Tier3_City,3,2,0,2,1,2,2,11.02,Education,3,2,1,3,5,0,4,2,4,1,0,1,5,4,33.42
Music,Sound Engineer,3.5469302162394394,5,1,0,0,5,1,4,2,4,0,2,2,4,0,Arts,Bachelors,18-24,14,0,0,Flexible,Tier2_City,2,2,2,4,4,2,3,4.35,Finance,5,3,5,1,1,0,4,1,5,4,0,1,3,5,66.86
Architecture,Web Developer,4.481515626751618,6,0,3,1,2,1,1,0,4,0,0,0,4,0,Interdisciplinary,High School,31-35,13,0,0,Office,Tier1_City,1,4,4,4,1,0,4,48.67,Healthcare,3,1,2,4,2,3,4,4,2,2,0,0,5,4,39.99
Architecture,Financial Analyst,3.505409525808324,7,2,2,0,1,1,3,1,1,1,1,0,0,0,Interdisciplinary,Bachelors,31-35,12,0,0,Hybrid,Tier2_City,4,4,3,3,3,3,3,49.09,Education,1,1,2,2,3,4,4,4,1,5,1,1,1,1,51.54
Architecture,Physician Assistant,4.782804744158665,0,2,4,0,4,1,2,1,4,2,3,4,4,1,Interdisciplinary,Bachelors,36-40,8,1,54,Office,Tier2_City,3,5,2,5,3,5,5,15.11,Manufacturing,4,1,5,4,3,0,3,5,4,4,1,0,5,5,66.55
Music,Chemist,2.6625849445170995,5,2,4,1,9,0,1,1,3,1,1,3,0,1,Arts,Masters,31-35,1,0,0,Hybrid,Any,1,5,0,3,3,2,3,3.44,Education,5,3,3,1,2,1,5,4,2,1,1,1,1,4,39.75
Music,Web Developer,3.38350417413374,7,2,4,0,9,0,0,3,4,0,3,3,0,1,Arts,Masters,18-24,5,0,0,Office,Tier3_City,5,4,5,3,0,4,2,33.36,Finance,5,4,1,5,5,3,1,5,2,3,0,1,4,4,52.02
Education,Cybersecurity Analyst,4.412321677258218,2,0,3,1,1,1,2,3,1,0,3,2,0,0,Arts,Masters,36-40,14,0,0,Hybrid,Tier1_City,5,4,5,4,5,4,4,33.48,Other,1,2,3,5,5,5,5,5,1,1,0,0,2,2,54.83
Engineering,Teacher,2.835943706516411,4,0,1,0,4,0,3,4,4,3,4,3,3,0,Science,Bachelors,31-35,14,0,0,Hybrid,Tier2_City,2,5,0,3,5,5,4,47.2,Other,3,1,5,5,0,3,3,3,2,1,1,1,1,4,66.74
Music,Software Developer,4.678476774923931,5,0,0,0,6,1,2,4,1,4,0,2,2,0,Arts,Bachelors,31-35,7,0,0,Remote,Tier2_City,3,1,3,5,2,3,3,17.03,Other,4,1,4,1,1,0,3,1,4,4,1,0,3,1,53.82
Marketing,Lawyer,3.4157650083864306,0,1,3,0,2,0,2,2,4,4,1,3,3,0,Commerce,Masters,36-40,2,0,0,Flexible,Tier3_City,3,4,0,3,4,3,2,11.91,Finance,5,3,1,3,5,3,4,1,3,5,0,1,1,1,57.48
Art,Chemist,2.989476886034028,0,1,1,0,5,1,3,0,1,3,3,3,2,0,Arts,Bachelors,25-30,4,0,0,Office,Tier1_City,2,1,5,5,3,1,4,31.97,Finance,1,3,5,1,0,4,4,4,4,1,0,1,1,4,46.56
Law,Conductor,2.9310803418717275,1,2,2,0,7,1,1,0,4,3,0,4,1,1,Arts,PhD,25-30,13,1,38,Office,Tier3_City,3,3,0,3,3,1,3,29.49,Education,1,2,5,4,1,0,1,1,1,3,0,1,3,5,64.45
Marketing,Acoustics Specialist,3.6163958330507127,1,2,4,0,5,1,0,1,4,0,4,4,3,0,Commerce,Masters,31-35,6,0,0,Hybrid,Tier1_City,5,1,5,5,1,1,3,36.73,Finance,2,2,1,3,2,4,4,5,2,2,1,1,1,5,52.06
Psychology,Art Therapist,4.373390683773692,7,0,3,1,7,1,4,0,2,2,3,2,0,1,Arts,Bachelors,25-30,3,1,28,Remote,Tier1_City,5,1,4,3,3,3,3,44.6,Education,2,1,3,5,0,4,1,5,3,2,0,0,1,5,50.94
Chemistry,Chemist,2.754204243626155,3,2,0,0,6,1,2,0,4,1,3,2,4,1,Science,PhD,18-24,13,1,31,Hybrid,Tier3_City,2,4,0,3,1,2,4,29.31,Other,3,1,4,1,5,5,3,2,5,2,1,0,3,3,67.03
Biology,School Counselor,4.3400302724999,1,1,1,0,8,0,0,0,4,0,1,3,2,1,Science,Bachelors,31-35,11,0,0,Office,Tier1_City,4,3,1,2,1,0,1,10.05,Tech,1,1,3,2,4,1,1,1,4,1,0,1,2,3,45.39
Business,Education Administrator,3.878062016843431,1,2,2,1,1,0,3,1,0,1,1,0,0,1,Commerce,Bachelors,18-24,4,0,0,Flexible,Tier3_City,2,2,3,5,2,5,2,31.11,Tech,3,1,2,5,4,0,1,1,5,4,0,0,4,4,47.97
Engineering,Advertising Manager,4.340551654431531,3,1,2,0,7,1,1,0,1,3,0,3,3,1,Science,Masters,18-24,0,0,0,Remote,Tier1_City,5,1,2,5,0,5,5,20.58,Tech,3,1,3,2,3,1,2,4,1,1,0,0,1,1,27.25
Architecture,Digital Marketing Specialist,2.917826703050971,1,0,3,0,7,1,1,0,3,4,1,4,3,0,Interdisciplinary,Bachelors,18-24,3,0,0,Hybrid,Any,2,3,3,5,1,5,5,24.28,Healthcare,4,3,2,3,0,1,4,4,1,2,1,1,1,1,40.85
Computer Science,Marketing Manager,3.124030489674704,3,0,2,1,9,0,4,2,0,4,0,4,2,1,Science,PhD,31-35,13,0,0,Office,Tier3_City,5,3,5,1,1,1,2,48.1,Tech,2,4,1,5,5,3,5,3,5,2,1,1,2,4,66.94
Biology,Nuclear Physicist,2.7551431574821272,8,2,2,1,5,0,1,4,1,2,3,1,3,1,Science,Bachelors,25-30,13,0,0,Remote,Tier1_City,4,4,2,3,5,0,1,29.08,Tech,3,2,2,1,3,2,2,4,3,4,0,1,2,2,58.74
Architecture,Art Therapist,4.951077609391605,2,0,3,0,8,0,4,2,4,4,0,1,3,0,Interdisciplinary,Bachelors,31-35,6,0,0,Hybrid,Tier3_City,5,3,4,5,2,4,2,10.03,Education,4,3,5,2,5,0,2,5,2,1,0,1,4,1,49.81
Psychology,Pharmacist,3.8310024409456966,0,1,1,1,3,1,3,2,4,2,4,2,2,1,Arts,Masters,25-30,11,1,46,Remote,Tier1_City,3,2,0,1,1,3,3,23.83,Education,4,5,2,1,0,4,2,5,5,1,1,0,1,4,66.52
Physics,Microbiologist,3.488593862506101,4,0,3,1,6,0,4,4,4,0,1,1,0,1,Science,Masters,25-30,9,1,40,Office,Tier2_City,1,4,5,2,4,4,2,13.74,Other,2,5,5,5,1,5,5,1,3,1,1,0,4,1,64.46
Chemistry,Chemist,2.759205684015739,1,0,4,1,9,0,2,3,0,3,4,3,1,0,Science,Bachelors,25-30,6,0,0,Flexible,Tier1_City,4,1,2,5,0,1,2,9.37,Finance,2,5,5,1,1,3,5,2,2,5,0,1,2,3,52.43
Education,Graphic Designer,4.043282595986116,0,0,2,0,8,0,2,3,3,0,3,2,1,0,Arts,Bachelors,31-35,9,0,0,Flexible,Tier1_City,1,4,2,5,4,2,4,36.48,Finance,1,2,3,5,2,1,2,1,5,3,1,0,2,4,63.6
Medicine,Animator,3.265246096878802,4,0,0,1,8,1,0,3,3,3,2,0,1,0,Science,Masters,25-30,9,1,50,Office,Any,4,1,4,1,3,1,5,32.54,Finance,3,1,4,4,4,5,3,2,5,4,0,1,1,2,63.96
Finance,Cybersecurity Analyst,3.985417871633049,8,0,4,0,0,1,3,0,3,2,2,4,1,0,Commerce,Bachelors,40+,3,0,0,Hybrid,Tier1_City,4,4,5,3,0,0,5,26.4,Other,4,5,3,1,4,1,2,4,1,4,1,1,3,4,45.45
Education,Accountant,4.26122970108419,5,1,1,1,1,1,0,3,1,0,1,1,4,0,Arts,Masters,36-40,11,0,0,Office,Tier2_City,4,3,3,2,3,1,3,22.89,Education,1,5,3,4,2,0,1,3,1,3,0,1,5,5,48.69
Architecture,Interior Designer,2.507353411752267,1,2,2,0,6,1,0,0,0,4,3,4,2,0,Interdisciplinary,Masters,36-40,5,0,0,Flexible,Tier1_City,4,2,5,5,5,5,3,18.14,Education,3,4,5,2,2,3,1,3,4,1,0,1,2,2,50.2
Medicine,Web Developer,3.2719489595329696,5,2,3,1,3,1,4,0,4,1,1,1,2,1,Science,Masters,36-40,12,1,57,Hybrid,Tier2_City,5,4,3,3,1,2,4,7.14,Tech,3,3,4,1,2,5,5,3,2,4,1,1,1,2,59.74
Chemistry,Doctor,3.2409242203714954,0,2,3,1,3,0,0,0,1,0,1,4,2,0,Science,Masters,25-30,4,0,0,Hybrid,Tier1_City,3,5,3,2,2,2,3,17.07,Manufacturing,1,2,5,1,5,5,1,4,2,5,0,1,3,1,40.9
Physics,Market Research Analyst,3.786595470958634,9,2,0,0,3,0,3,3,3,2,0,0,3,1,Science,Bachelors,25-30,0,0,0,Flexible,Tier1_City,5,3,0,4,4,3,1,42.4,Education,4,2,4,2,2,4,4,2,2,1,0,0,4,2,37.64
Marketing,Principal,2.774872863916974,7,0,4,1,7,1,1,4,4,3,0,4,3,1,Commerce,Masters,31-35,7,0,0,Office,Tier1_City,5,4,4,4,3,3,4,39.83,Other,1,4,2,1,0,1,4,1,3,2,0,1,4,1,55.55
Law,Paralegal,3.888592874705293,8,1,1,1,8,0,1,0,2,1,1,4,2,1,Arts,Masters,31-35,11,1,14,Flexible,Tier1_City,3,3,2,2,1,5,4,48.7,Manufacturing,3,5,5,5,2,3,2,3,5,4,1,0,4,4,61.04
Engineering,Quantum Physicist,4.064242816493866,4,1,2,1,9,0,0,0,3,0,4,0,1,0,Science,Bachelors,36-40,6,1,18,Flexible,Any,4,5,3,1,4,2,2,33.84,Education,1,4,3,4,3,4,4,1,4,5,0,0,3,3,53.3
Biology,Pharmacist,3.398356698520357,5,0,3,0,2,0,0,0,1,2,4,3,0,1,Science,PhD,31-35,14,0,0,Hybrid,Any,3,3,3,2,4,5,2,29.02,Other,1,1,5,3,2,3,4,3,2,5,1,0,5,5,67.5
Business,Judge,3.516807522841795,5,1,2,0,0,0,0,0,4,4,2,1,1,0,Commerce,Bachelors,40+,4,1,39,Flexible,Any,1,3,3,2,5,2,1,16.91,Education,3,5,1,5,0,1,2,2,4,5,1,1,3,2,59.1
Biology,Interior Designer,4.262143398621852,3,0,4,0,6,0,0,2,2,4,0,2,1,0,Science,Bachelors,25-30,12,0,0,Hybrid,Tier1_City,3,4,1,1,5,0,4,6.61,Healthcare,2,2,1,3,4,1,4,4,3,2,1,0,3,3,55.42
Physics,Chemist,4.512262137983711,4,1,0,0,6,0,2,0,2,1,3,0,4,1,Science,Bachelors,36-40,9,0,0,Remote,Tier1_City,5,3,0,1,3,1,4,32.05,Manufacturing,4,3,1,2,4,4,3,2,1,3,1,1,2,3,45.05
Chemistry,Data Scientist,2.657027075704059,0,2,1,0,6,0,2,2,4,2,4,1,3,0,Science,PhD,31-35,9,1,6,Hybrid,Tier2_City,4,4,3,3,1,3,2,25.94,Healthcare,3,4,3,2,4,3,4,2,4,2,1,0,1,1,69.28
Computer Science,Cybersecurity Analyst,2.938280848657252,1,0,4,0,0,1,2,0,3,2,2,0,4,1,Science,Bachelors,31-35,6,0,0,Hybrid,Any,5,2,5,3,2,0,5,38.68,Tech,2,4,3,1,0,1,5,5,5,5,1,1,3,1,51.24
Law,Ecologist,4.612642104205593,7,1,2,0,9,1,4,0,1,2,2,4,1,1,Arts,Masters,25-30,14,0,0,Remote,Tier2_City,1,5,1,1,3,1,5,22.36,Healthcare,1,2,1,5,2,3,3,3,3,1,1,0,4,5,59.06
Engineering,Counselor,3.4218715895944087,1,0,3,1,4,1,0,0,0,0,3,4,3,1,Science,Masters,31-35,9,0,0,Flexible,Tier1_City,4,1,4,4,4,3,2,49.32,Healthcare,2,5,3,3,1,0,2,2,3,5,0,1,2,4,56.91
Computer Science,Nurse,2.8897030069928635,0,1,0,0,4,0,3,0,0,0,4,2,0,1,Science,Bachelors,36-40,2,1,51,Remote,Tier3_City,2,5,2,4,4,5,3,21.69,Other,3,5,3,4,4,4,2,5,4,2,0,1,4,1,44.85
Chemistry,Chemical Engineer,3.127483439847301,1,2,2,0,8,1,1,3,0,3,2,3,0,1,Science,Bachelors,18-24,7,1,31,Flexible,Tier1_City,5,3,3,2,0,0,4,18.65,Tech,3,5,3,5,4,2,3,1,2,2,0,1,1,4,48.77
Education,Surgeon,3.511687387677142,6,0,4,1,1,0,4,2,2,2,2,1,3,1,Arts,Masters,31-35,4,1,39,Remote,Any,5,4,0,5,1,4,1,43.94,Manufacturing,1,3,1,2,1,4,2,2,3,2,1,0,2,4,50.8
Law,Fluid Mechanics Engineer,4.005960716120555,1,0,1,1,1,1,4,2,1,3,2,1,1,0,Arts,Bachelors,25-30,1,0,0,Hybrid,Any,3,1,3,2,0,4,5,21.59,Finance,3,3,2,5,2,1,5,4,1,2,0,1,1,3,41.49
Psychology,AI Researcher,3.5177548209426623,1,2,4,0,3,1,0,2,1,0,2,2,3,0,Arts,Masters,40+,1,1,26,Hybrid,Any,4,1,0,2,5,3,3,43.93,Education,5,5,2,4,4,3,1,5,3,5,0,1,3,2,48.34
Business,Digital Marketing Specialist,4.843164955525791,4,2,4,1,3,0,4,2,0,1,4,1,2,0,Commerce,Bachelors,25-30,3,0,0,Office,Tier1_City,5,3,1,5,2,0,4,4.29,Other,2,3,4,5,2,5,1,4,5,2,1,0,2,3,48.77
Business,Quantum Physicist,4.40391770401742,5,2,1,0,1,1,4,0,3,3,1,0,2,1,Commerce,Bachelors,18-24,6,0,0,Remote,Tier2_City,1,1,0,1,3,1,3,35.55,Manufacturing,5,4,5,1,3,4,2,5,1,2,1,0,1,5,43.4
Chemistry,Investment Banker,3.062986057727446,9,2,4,0,2,0,2,2,0,0,4,3,3,0,Science,Masters,25-30,13,1,17,Flexible,Tier2_City,4,4,5,4,4,1,4,6.38,Tech,5,5,2,4,1,2,5,3,4,5,0,0,4,2,70.13
Computer Science,Civil Engineer,3.04167647055568,6,1,1,1,5,1,2,2,0,0,2,4,3,1,Science,Bachelors,31-35,9,0,0,Office,Tier1_City,4,3,4,2,1,0,4,9.97,Healthcare,2,3,4,3,0,0,2,1,2,4,1,1,3,3,51.06
Psychology,Graphic Designer,4.320758315502424,7,0,4,1,6,1,1,4,0,0,3,1,2,0,Arts,Bachelors,18-24,3,0,0,Office,Tier2_City,3,5,0,5,4,4,2,35.9,Finance,3,4,2,2,2,1,1,4,1,5,1,0,2,5,40.68
Law,Entrepreneur,3.407179709400101,5,1,0,1,9,0,4,0,0,3,2,2,0,1,Arts,Bachelors,31-35,8,0,0,Remote,Tier2_City,5,3,5,3,5,0,2,16.62,Healthcare,2,4,1,5,1,3,5,2,4,1,1,0,3,2,56.95
Business,Musician,2.835921224806372,0,0,3,1,4,0,3,2,2,1,1,1,1,0,Commerce,Bachelors,36-40,1,0,0,Hybrid,Tier1_City,5,3,2,2,0,4,1,12.89,Education,1,3,4,4,1,0,2,1,1,3,1,0,2,4,37.38
Marketing,Dentist,4.067954511306163,8,1,1,1,8,0,1,2,4,1,4,3,1,0,Commerce,Bachelors,36-40,5,0,0,Flexible,Tier1_City,2,1,1,4,0,4,1,40.67,Tech,5,5,1,1,1,1,4,1,2,4,1,1,2,5,52.07
Medicine,Graphic Designer,2.9423414817068325,4,1,1,1,1,0,3,1,1,3,0,1,1,0,Science,Masters,18-24,3,0,0,Remote,Tier1_City,2,2,0,1,3,5,3,47.47,Finance,5,5,1,1,5,4,1,2,5,1,0,0,5,4,43.73
Law,Legal Secretary,3.155911180411919,2,2,2,1,6,0,4,2,2,4,3,2,2,0,Arts,Bachelors,40+,5,0,0,Remote,Any,4,1,3,2,1,5,2,13.92,Manufacturing,3,3,4,3,0,4,1,4,3,5,1,1,2,2,61.11
Biology,Music Teacher,2.582238869977427,1,1,1,0,7,1,4,3,0,1,0,0,2,0,Science,Bachelors,31-35,9,0,0,Hybrid,Tier3_City,5,2,4,2,5,1,4,17.91,Manufacturing,2,3,4,2,5,2,5,4,3,4,0,0,1,5,55.09
Computer Science,Physician Assistant,4.7113369635715685,2,2,2,0,4,0,0,0,2,2,0,4,3,1,Science,Masters,18-24,8,1,34,Flexible,Tier3_City,3,3,2,5,1,3,2,36.56,Tech,4,1,2,1,4,5,4,3,2,1,0,1,1,5,41.4
Chemistry,Zoologist,4.747599973191026,1,0,2,1,9,1,0,3,2,3,3,3,4,1,Science,Bachelors,18-24,9,0,0,Hybrid,Tier1_City,5,3,0,3,3,2,4,41.32,Tech,3,4,2,2,3,0,4,5,2,5,0,1,1,3,59.08
Engineering,Counselor,3.267152672622946,9,1,4,1,4,1,0,4,3,0,4,2,1,1,Science,Bachelors,18-24,11,0,0,Hybrid,Tier2_City,3,5,0,3,5,0,2,49.96,Other,3,5,5,4,4,4,3,1,1,1,0,1,3,4,54.62
Architecture,Geneticist,4.625155528414293,4,0,2,0,3,1,3,4,2,4,3,2,3,0,Interdisciplinary,PhD,36-40,8,0,0,Office,Tier1_City,2,1,2,1,5,4,4,15.85,Healthcare,3,2,2,5,2,2,1,1,3,2,1,1,5,4,73.5
Psychology,Social Media Manager,4.66284548266348,5,0,4,0,6,0,1,2,1,0,4,1,1,1,Arts,Masters,18-24,8,1,54,Flexible,Tier2_City,1,5,2,4,0,0,3,29.16,Finance,2,4,4,3,1,3,3,3,3,2,0,1,1,5,48.82
Business,Clinical Psychologist,2.589853940237586,2,0,3,1,7,0,3,4,3,2,1,3,1,0,Commerce,Masters,18-24,8,0,0,Remote,Tier2_City,5,4,0,1,0,3,2,9.3,Education,3,5,2,1,4,3,4,5,2,3,0,0,4,5,55.14
Chemistry,Market Research Analyst,2.5590402186773185,0,2,0,0,9,0,4,1,4,1,0,3,1,1,Science,Masters,31-35,2,0,0,Remote,Any,2,3,3,2,0,3,5,18.55,Tech,1,1,4,5,0,0,5,5,4,1,0,1,3,1,47.31
Computer Science,Counselor,3.680461611508559,5,0,1,1,8,0,2,1,3,0,1,2,3,0,Science,High School,25-30,11,1,50,Remote,Tier1_City,1,5,3,2,4,2,5,5.11,Finance,1,4,5,1,0,3,2,5,4,5,0,0,5,3,55.71
Business,Sound Engineer,3.0397758961640906,5,2,0,0,8,1,0,3,0,3,3,1,2,0,Commerce,Masters,31-35,10,0,0,Remote,Tier1_City,1,4,3,3,2,2,4,12.91,Other,5,4,4,3,5,4,2,2,5,1,0,0,3,4,58.48
Marketing,Art Director,4.22732004338726,1,2,4,1,0,0,4,3,2,1,2,1,1,0,Commerce,Bachelors,31-35,13,1,50,Hybrid,Any,2,2,0,4,0,4,3,26.81,Tech,5,5,5,1,5,3,1,3,2,1,0,1,5,4,51.33
Engineering,Aerospace Engineer,3.285899307560214,1,0,2,1,5,0,0,4,1,2,3,4,3,1,Science,Bachelors,18-24,8,0,0,Remote,Any,2,1,1,5,2,5,4,10.7,Tech,2,2,5,3,3,4,4,2,5,2,0,0,3,5,60.05
Finance,Principal,3.933677896467138,7,1,0,1,1,1,3,0,2,1,2,0,2,0,Commerce,Bachelors,36-40,2,0,0,Hybrid,Tier2_City,2,4,0,4,2,2,3,44.8,Manufacturing,4,3,5,5,4,2,3,5,2,5,0,1,3,4,44.86
Computer Science,Fluid Mechanics Engineer,4.1205641611279775,3,1,2,0,6,0,4,3,2,1,0,3,4,0,Science,Bachelors,18-24,9,0,0,Hybrid,Tier1_City,3,1,1,2,1,5,1,36.38,Finance,5,2,1,4,5,4,5,2,2,5,1,0,1,2,60.94
Art,Industrial-Organizational Psychologist,2.762185614588556,7,1,0,1,8,1,0,1,3,2,1,0,2,1,Arts,Bachelors,25-30,2,0,0,Hybrid,Tier2_City,4,3,3,5,3,5,2,4.3,Manufacturing,5,1,3,3,5,4,2,1,2,5,1,0,1,5,39.48
Law,Financial Analyst,2.771965672700847,8,1,3,0,8,0,0,0,4,3,0,2,1,1,Arts,PhD,31-35,4,1,56,Flexible,Tier2_City,4,2,0,4,4,4,3,44.2,Other,5,4,4,4,0,0,2,2,3,1,0,1,1,4,49.57
Business,Organic Chemist,3.9799222073598433,8,1,3,0,4,1,3,2,0,1,1,0,0,1,Commerce,Bachelors,18-24,5,1,12,Remote,Tier3_City,4,3,5,4,2,1,4,48.93,Manufacturing,5,5,2,2,5,3,2,2,3,3,1,0,4,2,39.74
Engineering,Interior Designer,4.995042445574468,6,0,3,0,8,1,0,2,0,0,2,1,2,1,Science,Bachelors,40+,8,1,48,Hybrid,Tier3_City,3,4,3,5,4,5,1,26.59,Other,3,4,3,5,0,4,3,4,5,4,0,0,2,5,51.4
Architecture,Brand Manager,2.980129554649716,6,0,1,1,9,1,2,3,3,1,2,2,2,0,Interdisciplinary,Bachelors,25-30,0,1,28,Remote,Tier1_City,2,2,0,2,1,4,4,17.79,Finance,5,3,3,3,5,0,1,3,1,4,1,1,2,1,41.68
Engineering,Aerospace Engineer,4.444319537383803,6,0,3,1,7,0,3,4,4,1,1,0,0,1,Science,High School,18-24,14,1,6,Hybrid,Tier3_City,4,4,3,4,0,2,5,15.38,Other,2,2,1,5,3,0,1,5,1,4,0,1,5,4,51.75
Education,Composer,2.905504242855836,1,0,4,1,9,1,2,1,3,2,2,4,3,0,Arts,Masters,36-40,7,0,0,Office,Tier1_City,3,1,2,5,5,0,5,7.11,Other,3,2,4,4,2,0,5,3,1,2,1,1,4,3,57.56
Biology,Actuary,2.5107173800684883,7,2,1,1,9,0,4,2,0,3,0,0,1,1,Science,Bachelors,25-30,13,1,8,Office,Tier1_City,3,3,5,2,2,2,2,26.11,Manufacturing,3,1,4,4,4,1,3,1,5,4,1,0,5,2,56.85
Finance,Judge,4.276387942850621,9,1,2,0,4,0,3,1,2,2,1,0,0,1,Commerce,Bachelors,31-35,13,0,0,Hybrid,Tier1_City,2,1,0,5,3,3,2,5.36,Healthcare,2,5,2,5,2,0,1,5,5,4,0,1,5,5,60.24
Psychology,Advertising Manager,2.8323744566337936,6,1,3,1,1,1,2,4,1,0,4,4,0,0,Arts,Bachelors,25-30,3,0,0,Flexible,Tier1_City,1,2,1,5,5,2,1,26.68,Education,4,3,1,5,1,0,4,1,2,1,1,0,4,4,48.51
Music,Data Scientist,3.206100221676934,5,0,1,0,0,1,1,3,3,1,4,1,4,0,Arts,Masters,36-40,9,0,0,Office,Tier3_City,3,5,3,4,1,1,5,14.87,Education,5,3,3,4,2,4,3,2,5,5,1,1,4,4,68.7
Business,Animator,4.455213066431253,2,0,2,1,4,0,4,3,3,0,3,0,1,1,Commerce,Bachelors,18-24,6,1,36,Remote,Tier2_City,5,1,5,2,4,4,3,25.39,Healthcare,1,5,4,5,0,0,2,4,3,5,0,0,4,4,60.45
Psychology,Biologist,2.624805043966503,1,0,2,0,4,1,1,3,1,3,2,2,3,1,Arts,Bachelors,25-30,5,0,0,Remote,Tier2_City,3,2,5,4,0,5,5,22.66,Tech,4,1,1,4,0,0,2,5,5,1,1,1,2,1,49.0
Art,Judge,3.060379719203322,2,2,0,1,8,1,3,2,3,0,2,1,0,1,Arts,Bachelors,25-30,14,1,32,Office,Tier2_City,1,2,5,1,4,3,2,17.34,Manufacturing,5,3,5,2,2,1,3,1,4,3,1,0,5,4,56.95
Law,Education Administrator,3.7069603524925263,0,1,0,0,8,0,1,4,4,3,4,3,3,1,Arts,Bachelors,18-24,5,0,0,Flexible,Any,1,4,4,1,3,4,4,24.09,Education,1,1,4,4,2,1,3,2,2,1,1,1,2,3,55.83
Finance,Physician Assistant,4.236572964913727,0,0,2,1,2,0,3,0,1,0,0,2,2,1,Commerce,Bachelors,31-35,6,1,20,Hybrid,Any,5,1,1,2,2,4,1,25.28,Finance,3,5,3,1,1,0,3,5,3,3,0,1,4,3,37.83
Education,Chemist,3.098314656911821,5,0,0,1,9,1,1,1,3,0,1,4,0,1,Arts,Masters,25-30,3,1,41,Remote,Tier3_City,4,3,4,5,3,5,5,42.18,Other,3,5,5,4,5,0,2,5,1,5,0,0,4,1,51.76
Biology,Software Developer,4.34661547671936,2,0,4,0,7,0,1,0,0,3,1,4,2,0,Science,Masters,25-30,5,0,0,Flexible,Tier1_City,3,1,3,4,4,2,3,34.29,Other,3,5,5,2,1,4,5,3,4,2,0,1,3,1,49.61
Computer Science,Teacher,4.852263375104109,5,2,2,0,4,0,4,0,2,1,3,3,0,0,Science,Masters,18-24,2,1,8,Remote,Tier1_City,2,4,5,4,4,0,3,23.36,Tech,5,3,5,4,4,4,1,5,5,1,0,1,3,2,55.35
Marketing,Judge,3.6624933226157177,8,0,4,1,2,1,2,4,0,3,4,2,3,0,Commerce,Bachelors,31-35,4,0,0,Office,Tier2_City,2,2,0,2,5,3,3,45.55,Education,2,5,3,5,0,1,3,1,4,2,1,0,2,4,57.96
Engineering,School Counselor,4.658937845216238,7,2,4,1,5,1,2,2,4,0,3,0,2,1,Science,Bachelors,36-40,12,0,0,Remote,Tier2_City,5,3,0,2,3,5,1,38.52,Manufacturing,3,3,1,2,4,4,1,4,1,1,1,0,3,4,49.22
Psychology,Principal,4.528249905651029,2,2,4,0,3,1,3,2,1,4,4,0,3,0,Arts,Bachelors,25-30,12,1,37,Remote,Tier1_City,1,5,0,1,3,1,3,6.56,Education,3,1,4,3,4,3,4,5,2,4,1,1,3,5,59.0
Medicine,Interior Designer,3.069510879279915,6,0,0,0,8,0,2,4,0,3,2,4,4,1,Science,PhD,25-30,13,0,0,Hybrid,Tier1_City,4,3,4,3,3,1,3,10.23,Manufacturing,3,4,1,4,2,5,1,1,2,5,1,1,3,2,70.93
Biology,Biochemist,4.611024810261218,4,1,2,1,7,0,1,1,0,1,0,2,4,1,Science,Masters,18-24,14,0,0,Office,Tier2_City,3,1,5,2,0,0,5,6.84,Tech,5,1,3,5,0,2,1,2,2,3,0,1,1,1,49.41
Computer Science,Physician Assistant,4.220947211248067,6,0,2,1,7,0,4,0,0,2,1,3,1,1,Science,Masters,31-35,12,0,0,Remote,Tier2_City,3,3,3,3,4,0,1,17.99,Other,1,3,2,3,4,1,4,2,4,5,0,0,5,5,68.73
Architecture,Illustrator,3.189359179624439,7,2,2,1,6,1,3,3,3,3,3,2,3,1,Interdisciplinary,High School,18-24,1,0,0,Office,Tier2_City,3,1,2,2,1,2,4,23.48,Healthcare,4,2,4,3,2,1,4,5,3,5,1,1,5,1,49.1
Law,Quantum Physicist,4.705859014378951,8,2,3,1,6,1,1,2,0,4,4,4,4,1,Arts,Bachelors,25-30,2,0,0,Remote,Tier3_City,2,3,0,5,0,1,4,26.7,Other,3,2,4,3,3,4,3,4,5,4,0,0,5,3,53.16
Engineering,School Psychologist,4.235774731614681,3,2,0,0,7,0,2,4,2,4,2,3,0,1,Science,High School,31-35,12,0,0,Hybrid,Tier2_City,4,1,3,5,0,3,3,43.02,Manufacturing,4,4,2,1,1,2,4,5,1,1,0,1,5,3,50.4
Music,Data Scientist,4.203252745525549,8,0,4,1,4,0,2,3,4,0,2,3,1,0,Arts,Masters,36-40,8,1,46,Hybrid,Tier1_City,5,2,2,1,0,5,2,3.84,Manufacturing,2,5,5,5,2,2,4,3,4,1,0,1,4,1,59.53
Computer Science,Pharmacist,4.766841426958278,4,2,0,1,2,1,4,1,2,0,2,1,4,1,Science,PhD,25-30,5,0,0,Office,Tier2_City,2,2,2,1,5,0,1,23.13,Tech,2,1,4,1,2,0,2,5,1,3,1,1,3,3,54.16
Law,Social Media Manager,2.588105525006586,5,0,1,0,2,0,4,2,3,4,2,0,0,1,Arts,PhD,31-35,2,0,0,Office,Any,1,1,3,3,1,0,2,22.32,Tech,2,1,4,5,4,1,1,3,4,4,0,0,4,3,63.05
Finance,Fluid Mechanics Engineer,2.762965186403963,9,0,0,1,9,1,0,4,1,3,4,4,3,0,Commerce,Bachelors,25-30,1,1,16,Remote,Tier1_City,4,1,0,2,3,0,1,47.53,Finance,3,3,4,5,2,0,5,3,5,2,1,0,5,5,52.68
Computer Science,Manager,4.378628239286336,1,0,0,1,4,1,3,1,3,1,4,0,2,1,Science,Bachelors,36-40,4,1,15,Remote,Tier2_City,1,5,0,4,5,5,1,14.33,Other,4,4,3,2,5,4,1,3,4,3,0,0,5,1,54.72
Marketing,Investment Banker,4.021618674171389,0,2,3,1,9,1,3,0,0,3,0,4,0,1,Commerce,PhD,25-30,9,1,28,Flexible,Tier1_City,3,1,1,1,4,3,5,8.75,Other,1,5,2,3,2,2,5,3,2,2,1,1,2,5,59.43
Marketing,Psychologist,4.825292353632727,1,2,1,1,4,0,1,1,1,1,4,1,4,1,Commerce,Masters,25-30,13,0,0,Hybrid,Tier1_City,2,4,3,4,2,1,3,9.69,Tech,5,4,4,4,5,0,4,3,4,2,1,1,2,2,59.7
Medicine,School Psychologist,3.9916084079109257,1,2,2,0,3,1,4,0,1,1,0,0,4,0,Science,Bachelors,36-40,4,0,0,Hybrid,Tier2_City,4,1,5,4,5,3,5,27.45,Education,4,2,2,2,4,2,2,2,4,4,0,0,2,3,48.34
Music,Inorganic Chemist,4.273963932108793,6,0,1,1,8,1,3,4,0,4,3,0,3,0,Arts,Bachelors,18-24,0,0,0,Remote,Tier2_City,2,2,2,2,2,5,2,21.37,Manufacturing,5,4,5,4,2,5,1,5,5,1,0,0,4,1,48.21
Biology,Ecologist,4.712633820523917,8,2,0,0,6,1,2,3,1,0,3,0,4,1,Science,Bachelors,18-24,2,0,0,Flexible,Tier2_City,4,3,4,3,4,3,2,38.44,Healthcare,4,5,4,3,5,0,1,5,2,5,1,1,3,5,46.72
Education,Inorganic Chemist,4.722108213677231,7,0,0,1,9,1,0,1,0,3,0,2,1,1,Arts,Bachelors,18-24,6,1,32,Flexible,Tier1_City,3,2,4,2,1,2,4,18.19,Tech,3,5,1,5,1,0,5,3,5,2,1,0,3,3,46.03
Finance,Principal,4.39037609872457,7,1,3,0,3,1,0,4,2,1,4,1,4,0,Commerce,Bachelors,36-40,8,0,0,Remote,Tier2_City,4,4,5,1,2,5,5,9.01,Manufacturing,1,1,1,2,0,2,3,3,1,5,0,1,2,2,51.58
Finance,Financial Analyst,4.634571871973892,6,0,2,1,2,1,2,4,2,2,0,3,0,1,Commerce,Masters,18-24,4,0,0,Hybrid,Tier1_City,3,3,0,4,0,0,5,21.18,Healthcare,3,1,1,1,4,4,1,3,4,1,0,1,5,4,44.11
Art,Financial Advisor,4.662193086494426,8,0,1,1,8,0,3,3,1,4,0,1,1,1,Arts,Bachelors,36-40,3,0,0,Flexible,Tier1_City,2,2,1,2,5,1,5,44.5,Finance,2,5,1,5,3,5,4,5,5,5,0,0,5,2,57.98
Architecture,Music Teacher,4.582677242677073,5,2,0,0,4,0,4,4,4,0,2,1,2,0,Interdisciplinary,Bachelors,25-30,2,0,0,Hybrid,Tier1_City,2,1,5,2,2,2,4,22.06,Education,1,1,3,1,3,3,5,3,3,2,1,1,5,2,45.28
Marketing,Physical Chemist,4.0088563870996206,1,1,3,0,1,1,0,2,1,0,4,1,3,0,Commerce,Bachelors,18-24,9,0,0,Hybrid,Any,2,1,4,2,4,2,5,42.18,Finance,4,1,5,5,5,3,1,3,3,4,1,1,1,3,55.57
Chemistry,Geneticist,3.567126929246814,8,0,3,0,8,0,1,4,4,0,3,4,3,1,Science,Masters,25-30,12,1,31,Hybrid,Tier1_City,3,3,0,1,0,5,5,20.46,Tech,3,1,4,5,0,1,3,4,3,4,0,0,4,4,66.43
Law,Urban Planner,3.849159507724312,5,0,3,0,5,0,3,3,4,3,3,3,4,0,Arts,Masters,18-24,8,0,0,Remote,Tier1_City,1,5,1,3,2,4,5,16.23,Education,5,5,5,3,1,5,1,5,5,3,1,0,1,3,71.69
Education,Dentist,4.467076931679687,8,0,1,0,9,1,1,0,4,0,2,3,1,0,Arts,Bachelors,31-35,13,0,0,Office,Tier1_City,1,4,4,2,4,0,5,39.42,Finance,3,1,1,2,2,3,5,4,4,2,0,1,4,1,57.84
Chemistry,Legal Analyst,3.083009414563027,6,1,4,0,9,1,2,3,4,3,2,0,1,1,Science,PhD,31-35,6,0,0,Hybrid,Tier2_City,4,2,2,1,1,1,2,12.83,Manufacturing,3,2,5,4,5,5,3,1,3,3,0,1,5,3,59.14
Engineering,Physician Assistant,4.179068312722489,6,2,0,1,0,0,4,1,1,4,3,0,1,1,Science,PhD,25-30,11,0,0,Hybrid,Tier3_City,2,2,4,4,4,1,3,13.9,Tech,4,5,5,3,3,2,2,4,2,5,1,1,4,1,69.11
Art,Astronomer,2.927836408543276,2,1,0,1,3,1,4,3,2,2,2,0,0,0,Arts,Bachelors,18-24,6,0,0,Remote,Tier3_City,1,4,4,5,1,1,2,5.34,Other,4,4,3,4,2,1,1,4,3,3,0,0,4,5,52.46
Psychology,Special Education Teacher,4.221314377837867,6,1,3,1,2,1,3,1,4,0,3,1,0,0,Arts,High School,31-35,13,0,0,Office,Tier3_City,5,2,4,1,0,5,5,11.83,Finance,2,3,1,5,1,3,3,1,3,1,1,0,3,3,51.4
Psychology,Digital Marketing Specialist,4.615636855761313,3,0,0,0,7,1,1,3,1,4,2,3,0,1,Arts,Masters,36-40,12,0,0,Office,Tier1_City,2,3,4,5,4,0,1,20.8,Education,1,3,2,1,4,5,4,4,4,1,0,1,4,2,60.03
Music,Investment Banker,2.944715312826916,9,1,2,0,5,1,0,0,4,4,0,3,0,1,Arts,Masters,31-35,7,1,36,Hybrid,Any,5,5,0,2,3,5,1,21.78,Education,3,2,5,4,0,3,5,4,3,4,0,1,3,3,55.37
Marketing,Paralegal,4.75421225549421,5,2,1,0,7,1,2,0,2,2,4,1,4,0,Commerce,PhD,36-40,9,0,0,Flexible,Tier2_City,1,3,3,2,5,1,4,22.77,Other,5,5,5,1,5,0,3,3,3,3,1,0,5,4,64.41
Physics,Architectural Technologist,3.783550553434084,9,0,0,1,2,0,0,4,1,3,4,0,2,0,Science,Masters,18-24,0,0,0,Remote,Tier1_City,3,5,2,1,3,3,2,25.55,Healthcare,4,4,1,4,1,0,5,1,4,2,1,1,1,2,48.61
Psychology,Biomedical Engineer,3.306867499294809,3,1,2,1,1,0,2,2,0,4,3,2,2,1,Arts,Masters,36-40,10,0,0,Office,Tier2_City,5,1,3,5,3,3,4,29.88,Education,4,5,3,1,3,3,2,3,3,4,0,1,3,3,60.27
Medicine,Education Administrator,4.393964969858756,6,0,0,0,3,0,4,1,4,0,3,2,0,0,Science,Bachelors,25-30,3,0,0,Hybrid,Tier2_City,5,5,0,2,3,0,4,11.9,Education,2,4,4,3,3,5,5,2,5,5,1,0,1,2,57.17
Architecture,Brand Manager,3.422282285004472,1,1,4,1,1,1,4,2,1,1,2,0,1,0,Interdisciplinary,High School,18-24,12,0,0,Remote,Tier1_City,2,5,4,4,5,1,1,31.86,Tech,1,4,1,4,0,5,2,5,2,5,0,1,3,1,57.49
Music,Accountant,3.588684130972127,5,1,4,1,1,1,0,0,4,4,4,0,0,1,Arts,Bachelors,36-40,12,0,0,Remote,Any,4,5,1,3,3,5,2,18.82,Education,2,5,4,3,4,5,1,4,5,4,1,0,2,1,67.03
Physics,Art Therapist,2.5226316513148688,1,1,3,0,1,0,4,1,4,0,1,2,3,0,Science,Bachelors,36-40,4,0,0,Hybrid,Tier2_City,3,2,1,3,1,4,3,37.5,Healthcare,4,1,2,3,1,1,1,2,3,1,1,0,1,4,45.74
Music,Doctor,4.306781619707498,6,0,3,0,6,0,3,3,0,2,4,0,0,1,Arts,Masters,31-35,4,0,0,Flexible,Tier2_City,2,5,3,2,4,4,2,29.19,Education,5,3,4,1,3,2,1,1,2,1,0,1,3,3,46.18
Music,Chemist,3.561339431971483,8,1,3,0,8,0,3,3,3,2,1,3,1,1,Arts,Masters,18-24,0,0,0,Office,Tier1_City,2,4,5,5,0,4,4,29.05,Healthcare,2,1,5,4,5,5,4,2,1,5,0,1,3,2,48.02
Computer Science,Animator,3.0080064972241547,1,1,1,1,5,1,4,2,2,2,1,0,1,0,Science,Masters,25-30,2,0,0,Hybrid,Tier1_City,1,1,1,2,3,3,5,35.22,Manufacturing,3,3,3,4,3,3,1,1,2,1,0,1,2,1,41.07
Education,Surgeon,4.91740901523742,5,1,0,1,4,0,4,2,1,0,4,0,2,1,Arts,Bachelors,25-30,1,0,0,Remote,Any,4,1,3,5,3,5,4,18.65,Healthcare,4,1,2,2,4,2,4,1,4,5,1,0,3,4,51.2
Computer Science,Biomedical Engineer,2.656148036217599,8,1,0,0,3,0,0,2,0,0,0,0,4,1,Science,Masters,36-40,11,1,7,Flexible,Tier3_City,4,2,2,4,0,4,2,23.17,Tech,4,5,3,1,3,5,4,1,2,1,1,1,3,4,34.11
Psychology,Composer,4.176505987571176,0,2,2,0,7,1,4,4,1,2,2,4,0,0,Arts,Bachelors,18-24,6,0,0,Hybrid,Tier2_City,3,3,1,5,0,1,1,30.4,Finance,2,5,3,4,3,1,2,4,5,5,1,1,5,2,67.59
Finance,Inorganic Chemist,3.3019593746667937,8,0,0,0,0,0,3,1,4,4,2,1,3,0,Commerce,Bachelors,36-40,12,0,0,Hybrid,Tier2_City,3,4,5,2,3,1,2,22.81,Other,5,4,4,5,2,4,1,1,4,5,0,0,3,1,68.43
Finance,Brand Manager,3.7049718845040607,0,2,1,0,6,0,0,1,1,2,0,1,2,0,Commerce,Masters,25-30,13,1,27,Office,Tier3_City,4,3,4,4,1,4,3,23.88,Finance,2,2,3,2,0,1,4,4,5,5,0,0,2,4,58.25
Computer Science,Physicist,4.1186445162978025,5,0,4,1,0,0,4,2,1,3,3,4,4,1,Science,Masters,36-40,4,0,0,Remote,Tier2_City,5,5,0,1,0,2,5,15.81,Manufacturing,5,5,2,4,5,4,5,2,5,1,0,0,1,5,56.32
Law,Aerospace Engineer,2.897918308437132,2,0,1,0,6,0,1,1,3,2,3,1,3,1,Arts,PhD,36-40,2,0,0,Office,Tier1_City,5,3,2,3,4,4,5,16.51,Tech,4,3,3,1,2,0,2,2,1,2,0,0,5,2,48.07
Architecture,Data Scientist,4.813595380164557,3,0,3,1,2,1,0,4,4,3,2,0,3,0,Interdisciplinary,Bachelors,25-30,10,1,56,Remote,Tier2_City,2,4,1,2,4,2,4,35.85,Manufacturing,2,4,2,5,3,2,1,4,3,5,0,1,4,3,65.87
Medicine,Interior Designer,4.861117479354424,7,1,2,0,2,0,4,3,2,4,0,1,2,0,Science,Bachelors,25-30,7,0,0,Remote,Tier2_City,4,2,1,2,1,0,2,3.2,Manufacturing,1,3,5,4,4,0,4,2,1,1,1,1,1,5,45.39
Art,Paralegal,2.9456747372001084,2,0,0,1,0,1,1,1,2,0,1,3,3,1,Arts,Bachelors,36-40,0,1,41,Office,Any,2,2,3,2,5,0,1,7.48,Education,2,1,5,3,5,2,4,3,3,2,0,1,3,2,34.81
Art,Mechanical Engineer,4.388632107189285,9,1,2,1,5,1,4,0,1,2,3,0,1,1,Arts,Bachelors,25-30,0,0,0,Remote,Tier3_City,5,5,2,4,2,1,3,47.59,Education,2,2,4,3,0,1,2,2,5,5,1,0,4,4,46.08
Engineering,Forensic Psychologist,4.990038891805987,3,0,3,0,5,1,4,3,0,1,1,2,3,1,Science,Masters,31-35,13,0,0,Hybrid,Tier1_City,3,4,0,1,1,5,4,11.79,Tech,1,5,1,5,1,3,2,3,2,2,1,1,2,4,58.74
Law,Conductor,4.299298018821734,8,2,2,0,9,0,0,3,4,3,1,3,3,1,Arts,Masters,31-35,5,0,0,Remote,Tier1_City,4,2,0,5,3,3,2,22.65,Finance,1,1,5,5,1,3,2,2,3,3,1,0,4,3,57.03
Architecture,Ecologist,4.724446528184092,7,2,2,0,7,1,0,2,3,3,4,0,2,0,Interdisciplinary,Masters,18-24,0,0,0,Hybrid,Tier2_City,1,5,3,1,2,5,1,42.94,Healthcare,3,4,1,5,4,4,1,2,1,5,0,1,2,1,51.0
Music,School Psychologist,3.187878247798811,2,1,0,0,8,0,0,2,1,4,0,4,2,0,Arts,Bachelors,36-40,3,0,0,Remote,Tier2_City,2,3,3,4,3,1,2,3.0,Education,1,3,2,5,1,3,4,1,4,5,1,0,1,3,54.16
Chemistry,Nurse,3.665689866058954,0,1,0,1,2,0,3,2,1,1,0,1,2,1,Science,Masters,18-24,5,0,0,Office,Tier1_City,4,4,3,2,4,1,1,46.48,Tech,5,2,1,1,5,2,5,3,1,1,0,1,1,1,40.85
Marketing,Illustrator,4.503733095908691,6,1,2,1,2,1,4,4,0,3,2,3,1,0,Commerce,Bachelors,36-40,0,0,0,Remote,Tier2_City,1,2,1,3,0,5,2,5.51,Tech,3,5,3,3,2,3,5,4,5,3,1,0,5,5,50.31
Education,Illustrator,2.8445976667989585,9,0,3,1,5,0,2,2,3,2,2,3,0,1,Arts,Masters,25-30,12,0,0,Office,Tier3_City,2,4,2,2,3,3,2,11.03,Finance,5,3,2,4,3,0,5,1,5,1,1,1,5,5,68.01
Engineering,Entrepreneur,4.85950232430363,4,0,0,0,1,0,2,3,3,4,1,4,2,1,Science,Bachelors,31-35,8,0,0,Office,Tier1_City,5,2,0,5,4,1,4,4.37,Tech,3,5,3,4,1,5,2,3,1,4,0,1,3,4,59.6
Education,Artist,3.418430698593921,9,0,0,0,9,0,2,4,2,2,2,4,2,0,Arts,Bachelors,25-30,14,1,35,Hybrid,Tier3_City,2,2,4,3,1,3,2,27.42,Other,3,5,1,3,5,3,2,1,1,3,0,0,3,3,59.42
Art,Game Developer,2.6563937578423227,3,1,4,0,0,0,4,1,2,3,2,4,3,1,Arts,Bachelors,25-30,3,1,13,Flexible,Tier1_City,3,4,0,2,3,1,2,47.33,Tech,5,3,3,4,5,0,2,5,4,5,1,0,3,2,60.03
Biology,Urban Planner,4.89606329039993,7,0,3,0,1,1,4,4,2,0,3,2,2,1,Science,PhD,25-30,8,1,51,Remote,Tier1_City,2,2,5,3,4,0,4,42.43,Finance,4,5,2,3,5,4,1,1,3,5,1,1,4,2,74.02
Architecture,Social Media Manager,2.799903714222709,5,0,3,1,9,0,4,0,2,2,2,3,4,1,Interdisciplinary,High School,31-35,8,0,0,Remote,Tier1_City,2,3,2,1,0,2,4,33.07,Education,4,4,3,2,5,4,4,4,5,5,1,0,5,2,59.07
Law,Art Therapist,3.336507372991414,8,2,4,1,9,1,0,1,2,1,3,4,0,1,Arts,Bachelors,25-30,12,0,0,Remote,Tier2_City,4,5,3,4,3,1,5,11.72,Finance,2,2,1,3,2,1,5,5,3,3,1,1,1,2,58.36
Business,Sound Engineer,3.4500731697660294,1,1,0,1,3,0,1,2,4,2,4,3,0,1,Commerce,Masters,36-40,5,0,0,Hybrid,Any,4,1,1,2,5,2,5,43.87,Manufacturing,4,1,3,4,0,1,4,4,5,5,1,1,5,4,71.2
Physics,Financial Controller,4.134988168718846,4,0,0,0,1,1,3,2,0,1,2,4,0,0,Science,Bachelors,25-30,12,0,0,Flexible,Tier3_City,5,4,0,5,4,4,4,38.47,Education,2,2,3,2,4,1,5,4,5,4,0,0,5,2,62.1
Marketing,Physical Chemist,3.689288056821806,8,2,2,1,4,0,2,1,0,0,1,2,1,1,Commerce,Bachelors,31-35,6,0,0,Remote,Tier1_City,3,4,4,1,3,1,3,15.54,Manufacturing,4,1,4,4,5,0,4,3,1,2,0,0,5,4,40.46
Finance,Curriculum Developer,4.492724083759322,2,1,1,1,0,1,2,1,3,3,2,1,1,1,Commerce,Bachelors,31-35,14,0,0,Office,Tier1_City,3,5,1,2,0,0,1,40.84,Tech,2,4,2,1,0,1,2,2,1,3,1,1,1,2,46.79
Biology,Physical Chemist,2.7070905856678285,1,1,2,1,0,0,0,4,0,0,4,0,0,1,Science,Bachelors,18-24,12,0,0,Office,Tier2_City,5,3,0,1,3,3,4,44.23,Manufacturing,2,2,4,4,0,4,1,1,2,2,0,0,1,4,49.62
Computer Science,Mechanical Engineer,3.279940374631099,4,1,3,1,3,1,0,2,3,3,0,4,2,0,Science,PhD,25-30,0,0,0,Remote,Tier1_City,1,1,2,5,3,0,5,35.82,Finance,1,4,1,2,2,3,5,4,1,1,0,0,1,3,41.85
Business,Electrical Engineer,4.57646077382401,4,0,1,1,5,1,4,0,3,1,2,4,4,0,Commerce,Masters,25-30,4,0,0,Flexible,Tier3_City,2,3,0,2,5,2,2,7.72,Finance,2,3,5,3,5,0,3,5,2,1,1,1,1,5,54.76
Marketing,Financial Controller,4.5491809944698,8,2,1,1,5,1,1,3,0,1,4,4,1,1,Commerce,Bachelors,25-30,2,0,0,Flexible,Tier1_City,4,4,4,5,4,3,4,49.26,Healthcare,5,1,1,4,5,1,5,3,5,3,0,1,3,4,50.56
Computer Science,School Counselor,3.577716446208105,6,0,1,1,9,0,2,1,2,3,4,0,3,1,Science,PhD,25-30,9,0,0,Flexible,Tier1_City,5,1,1,3,2,0,4,6.57,Other,5,3,1,3,1,1,1,1,4,5,1,0,3,4,69.63
Business,Aerospace Engineer,2.9923718698923096,1,2,4,0,4,0,0,1,0,0,0,4,0,0,Commerce,Bachelors,31-35,9,0,0,Hybrid,Tier1_City,5,2,0,5,3,0,5,33.76,Tech,2,3,1,4,2,4,4,1,3,1,0,1,2,5,43.4
Physics,Entrepreneur,4.6499608840465205,4,2,3,1,9,0,3,1,3,4,0,4,3,0,Science,Bachelors,18-24,12,0,0,Remote,Tier3_City,4,4,4,3,2,0,5,8.19,Finance,5,2,1,5,1,3,5,3,3,1,1,0,3,4,61.2
Art,Psychologist,4.447841497230067,5,0,0,1,4,0,0,4,1,2,0,3,2,1,Arts,Bachelors,31-35,5,1,45,Hybrid,Tier1_City,4,3,0,2,1,5,3,45.55,Education,4,5,4,4,3,2,4,1,4,4,1,0,1,3,49.7
Business,Organic Chemist,4.193698953181255,9,0,3,0,0,0,0,2,3,2,2,0,3,1,Commerce,Bachelors,36-40,3,0,0,Hybrid,Tier1_City,1,5,0,3,3,3,5,19.45,Finance,5,5,1,5,4,3,2,2,4,1,1,1,2,1,41.76
Computer Science,Pharmacist,4.998176966710313,5,0,2,0,0,0,3,3,3,1,3,1,3,1,Science,Bachelors,25-30,14,1,22,Hybrid,Tier2_City,3,2,5,2,2,0,5,27.04,Education,1,4,3,4,3,1,1,2,1,1,1,0,2,5,51.57
Chemistry,Dentist,3.3688591671352848,0,2,3,1,5,0,4,2,0,4,0,0,1,0,Science,PhD,31-35,12,0,0,Office,Tier2_City,4,1,3,2,1,0,5,11.4,Tech,5,2,1,4,5,1,1,1,5,1,0,1,5,4,60.62
Music,Social Media Manager,3.4609577597512144,7,2,3,0,3,0,2,0,1,1,1,2,2,1,Arts,Masters,18-24,13,0,0,Office,Any,5,4,4,4,5,2,2,28.69,Other,4,3,5,5,1,3,5,1,3,5,1,0,4,3,60.69
Biology,Graphic Designer,2.533755363269708,5,2,2,0,6,1,3,0,0,3,1,3,0,0,Science,Bachelors,36-40,12,0,0,Remote,Tier1_City,2,5,0,2,4,0,4,47.13,Healthcare,4,4,2,1,1,3,4,3,4,1,1,0,5,2,52.88
Biology,Biochemist,3.5563201444928527,5,2,0,0,0,0,4,4,3,3,0,3,4,1,Science,Masters,25-30,8,1,59,Hybrid,Tier1_City,1,5,5,3,3,0,4,45.38,Healthcare,2,3,4,3,0,4,3,5,5,3,0,1,2,5,69.58
Computer Science,Chemical Engineer,4.130144982918273,5,1,3,1,3,1,2,1,3,0,3,2,3,1,Science,Masters,31-35,6,0,0,Flexible,Tier2_City,2,3,1,4,4,4,5,6.0,Manufacturing,3,4,4,2,1,2,4,4,3,5,0,0,3,2,57.8
Education,Organic Chemist,2.5217609662229195,4,0,2,1,7,0,1,0,2,4,3,4,0,1,Arts,PhD,40+,14,0,0,Remote,Tier1_City,2,5,2,4,1,3,3,20.78,Finance,4,1,4,4,0,0,4,4,5,4,0,0,4,3,73.71
Biology,Microbiologist,4.706397605370374,2,1,1,0,9,0,0,2,3,0,0,1,0,1,Science,Masters,25-30,13,0,0,Hybrid,Tier2_City,3,3,3,2,4,4,5,15.57,Tech,2,4,4,2,5,0,4,5,2,1,0,0,2,5,44.57
Psychology,Counselor,4.458418088643959,4,1,0,0,4,0,0,0,0,1,4,2,2,0,Arts,Bachelors,31-35,14,0,0,Remote,Tier1_City,2,1,5,5,4,5,3,25.62,Manufacturing,2,4,1,1,0,2,4,1,3,5,0,1,4,4,54.7
Law,Interior Designer,3.5513491577726275,9,0,3,0,5,0,0,3,4,0,0,3,0,0,Arts,Masters,25-30,3,0,0,Hybrid,Any,5,4,3,5,0,2,4,42.19,Tech,5,3,5,4,4,4,4,4,2,5,1,1,2,1,48.92
Architecture,Analytical Chemist,3.9488798724186,2,2,0,0,3,1,2,2,3,3,4,4,1,0,Interdisciplinary,Masters,18-24,12,0,0,Hybrid,Tier1_City,5,1,3,4,1,4,3,37.73,Tech,5,5,1,5,1,3,5,2,5,1,1,1,5,1,67.6
Law,Marketing Specialist,2.896873709434954,2,0,2,0,6,0,2,3,2,0,3,2,2,0,Arts,Masters,31-35,10,0,0,Remote,Tier3_City,4,3,2,2,4,5,3,19.17,Manufacturing,2,3,2,5,5,1,5,3,1,4,0,1,4,4,64.19
Medicine,Physicist,2.9124729326961525,7,2,0,1,8,1,4,1,0,0,2,3,2,1,Science,Bachelors,18-24,5,0,0,Remote,Any,3,1,4,5,2,1,1,20.99,Tech,1,2,2,4,3,2,3,5,4,1,0,1,2,3,44.94
Engineering,Lawyer,2.9611944266306205,3,0,0,1,0,1,3,1,3,4,2,0,2,1,Science,Bachelors,31-35,1,1,35,Hybrid,Any,4,4,1,2,1,3,3,33.75,Manufacturing,2,3,1,5,2,4,1,4,2,1,1,0,4,2,37.87
Psychology,Accountant,3.3335236494974327,3,2,3,0,3,0,2,1,1,1,1,1,3,1,Arts,Bachelors,18-24,13,0,0,Hybrid,Tier2_City,2,4,2,2,0,0,3,12.13,Other,5,5,1,1,0,5,1,5,1,3,0,0,2,3,41.47
Art,Construction Manager,4.555281720541465,3,2,0,0,2,0,4,3,1,1,3,2,0,0,Arts,Bachelors,36-40,2,0,0,Remote,Any,5,5,1,4,3,4,2,7.83,Finance,4,2,1,3,5,2,3,1,3,5,1,1,2,5,52.49
Biology,Financial Analyst,4.558778672384491,8,0,3,0,4,1,3,0,0,2,2,3,2,0,Science,High School,18-24,14,1,29,Flexible,Tier2_City,4,3,1,4,5,4,4,14.4,Manufacturing,1,5,5,3,2,1,4,4,4,2,1,0,4,1,54.55
Finance,Marketing Specialist,4.602450977813739,6,2,0,0,4,0,0,1,4,3,0,4,2,0,Commerce,Masters,25-30,10,0,0,Hybrid,Tier1_City,5,1,3,1,4,0,5,8.83,Finance,3,2,4,1,0,0,2,5,5,4,0,0,3,1,67.08
Architecture,Musician,3.505277609934382,8,2,0,0,5,1,0,1,3,1,3,4,4,1,Interdisciplinary,High School,25-30,6,0,0,Remote,Any,4,5,0,5,2,0,1,19.54,Healthcare,4,3,2,5,3,3,5,4,4,4,0,1,2,4,52.85
Medicine,Art Director,4.669337141273256,1,0,4,0,4,0,2,1,4,1,1,0,2,0,Science,Masters,25-30,10,0,0,Flexible,Tier2_City,1,5,1,5,0,2,3,47.07,Manufacturing,5,5,2,3,0,4,3,4,1,5,0,1,3,5,56.36
Psychology,Cybersecurity Analyst,4.6190595267911885,3,2,0,0,1,0,0,3,0,3,0,4,3,0,Arts,Bachelors,25-30,11,0,0,Remote,Tier1_City,3,1,1,5,1,4,2,8.65,Other,4,5,4,5,4,0,1,4,1,2,0,1,2,5,49.13
Physics,Art Director,3.783067968035536,8,2,1,0,8,1,4,2,0,0,0,0,4,1,Science,PhD,25-30,3,0,0,Remote,Tier3_City,4,3,1,3,5,4,2,41.46,Healthcare,4,1,4,5,0,1,4,5,3,2,0,1,2,1,46.01
Finance,Digital Marketing Specialist,4.258777048534396,2,2,1,1,0,1,1,4,3,3,1,1,1,0,Commerce,Bachelors,25-30,13,1,40,Flexible,Tier2_City,2,3,1,2,5,1,5,28.13,Manufacturing,5,1,2,2,1,2,4,3,5,2,1,1,2,2,59.73
Music,Construction Manager,3.116756729043473,6,0,0,0,0,0,4,0,4,1,1,1,4,0,Arts,Bachelors,25-30,11,0,0,Remote,Any,5,4,3,4,4,5,5,32.75,Tech,4,4,2,3,4,4,4,3,3,5,1,1,3,5,62.81
Engineering,Human Resources Specialist,4.7716486593096334,8,0,1,0,3,0,4,1,3,3,0,3,3,0,Science,Masters,25-30,9,0,0,Flexible,Tier3_City,5,3,1,5,0,1,4,10.99,Healthcare,2,1,5,5,0,5,2,5,5,1,0,1,2,3,64.22
Business,Web Developer,2.778003797455325,6,2,1,1,2,1,3,1,0,0,2,2,3,1,Commerce,Masters,25-30,6,1,51,Office,Tier1_City,3,5,0,1,0,4,3,10.11,Education,1,5,2,2,0,4,3,2,3,4,1,0,3,4,48.37
Physics,Manager,4.931521332891209,6,1,3,1,2,1,1,3,3,2,1,0,2,1,Science,PhD,18-24,8,1,32,Hybrid,Tier1_City,3,4,5,5,2,1,2,10.65,Education,5,4,1,1,2,0,5,1,4,2,1,0,5,3,54.68
Chemistry,Game Developer,4.645404062087884,1,2,1,1,6,0,3,4,1,3,3,3,2,1,Science,Bachelors,40+,13,0,0,Remote,Tier3_City,1,2,4,2,3,4,1,34.35,Education,1,3,1,3,0,0,5,5,5,1,1,1,4,5,67.35
Finance,Industrial-Organizational Psychologist,4.598243747403373,2,0,2,0,6,0,4,0,1,2,1,2,4,1,Commerce,Bachelors,25-30,12,1,6,Remote,Tier2_City,4,4,4,2,3,3,4,38.15,Healthcare,2,4,4,1,5,1,5,2,5,4,0,0,3,4,57.84
Psychology,Aerospace Engineer,3.1772672459026863,7,1,2,1,3,0,3,2,4,0,2,1,3,1,Arts,PhD,18-24,4,0,0,Remote,Tier1_City,1,5,1,4,3,2,3,46.25,Finance,5,2,4,1,5,5,4,5,5,4,1,0,1,1,63.72
Art,Financial Controller,4.769335056204571,1,1,4,1,2,1,4,0,2,2,2,1,2,0,Arts,Bachelors,25-30,13,1,19,Flexible,Tier1_City,4,1,3,3,5,1,5,21.72,Manufacturing,2,4,1,4,4,0,1,1,3,3,0,0,2,3,63.58
Education,Zoologist,4.905323845114775,6,1,0,0,9,0,2,2,4,1,4,3,1,1,Arts,Masters,36-40,0,1,15,Hybrid,Tier1_City,4,1,0,4,5,4,3,24.71,Tech,3,1,4,3,5,4,4,5,3,2,1,1,4,3,54.08
Engineering,Curriculum Developer,3.5640435129011068,4,1,3,0,2,1,2,2,4,4,4,3,0,0,Science,Bachelors,18-24,4,0,0,Remote,Tier2_City,3,1,0,5,1,1,5,25.07,Tech,3,3,1,1,0,5,4,4,3,5,1,0,4,3,57.58
Physics,Market Research Analyst,4.068504789799733,6,2,3,0,9,0,3,1,1,1,3,1,3,1,Science,High School,31-35,5,0,0,Hybrid,Tier1_City,3,5,1,1,5,5,3,15.69,Healthcare,3,2,5,1,2,3,2,5,1,1,1,1,5,3,36.66
Architecture,Landscape Architect,3.7996724719731385,1,2,3,0,9,0,4,3,3,1,0,2,3,0,Interdisciplinary,Bachelors,25-30,13,0,0,Remote,Tier1_City,4,4,3,4,5,2,1,18.43,Education,1,4,4,1,3,1,4,2,4,2,0,0,4,4,60.74
Engineering,Credit Analyst,3.530985913899686,2,2,0,1,0,1,4,1,0,2,1,1,0,0,Science,Bachelors,18-24,10,0,0,Remote,Tier2_City,3,1,4,3,0,3,4,42.8,Other,3,3,3,5,2,1,4,5,3,5,1,1,4,2,54.66
Biology,Quantum Physicist,3.749208946983522,3,2,0,1,2,1,3,2,4,0,3,3,3,1,Science,Masters,36-40,1,0,0,Remote,Tier1_City,4,3,5,4,1,0,5,19.15,Tech,3,1,2,3,2,3,2,3,4,1,0,1,1,4,52.53
Finance,Judge,3.382269548910974,0,1,4,1,9,0,3,0,0,1,4,0,0,0,Commerce,PhD,25-30,7,1,41,Office,Tier1_City,3,2,2,2,0,0,1,43.85,Other,2,3,1,3,0,1,4,5,2,1,0,1,1,5,50.16
Art,Chemist,3.3146666856825187,4,1,3,0,3,0,3,1,0,0,1,1,0,1,Arts,Bachelors,25-30,12,0,0,Remote,Any,2,1,1,5,2,1,2,17.35,Other,4,3,2,3,3,5,3,2,3,5,1,1,1,2,52.7
Architecture,Nuclear Physicist,4.580465181189718,9,1,1,1,3,1,4,1,1,0,4,2,0,0,Interdisciplinary,Masters,36-40,1,0,0,Hybrid,Tier2_City,4,1,1,5,2,4,1,18.97,Tech,4,2,2,3,5,1,3,5,5,5,1,1,1,3,58.4
Education,Financial Controller,4.98810299777081,8,2,1,1,1,1,0,0,1,1,2,3,3,1,Arts,Bachelors,31-35,14,1,47,Remote,Tier1_City,5,2,1,5,1,5,1,29.33,Finance,3,5,4,3,4,0,3,3,5,2,1,0,3,1,53.44
Business,Artist,3.7813290541308713,0,1,4,0,3,0,4,1,1,4,3,0,3,0,Commerce,Bachelors,36-40,13,0,0,Hybrid,Any,2,3,3,5,1,2,1,7.85,Tech,4,1,2,1,5,1,2,5,2,4,1,0,1,1,57.1
Physics,Principal,2.9449132356942225,9,0,3,1,7,1,2,2,1,3,4,2,0,0,Science,Bachelors,31-35,8,0,0,Hybrid,Tier1_City,1,2,2,5,5,3,5,46.34,Tech,3,2,3,2,4,4,5,1,3,1,1,0,4,1,55.44
Psychology,Legal Consultant,4.750799398810512,8,2,4,0,2,0,3,2,0,1,2,3,1,0,Arts,PhD,31-35,13,0,0,Remote,Tier2_City,3,1,3,5,2,3,2,41.56,Manufacturing,3,2,4,4,5,0,3,3,5,4,0,0,1,4,70.48
Architecture,Biotechnologist,4.954505743695052,7,1,0,0,6,1,2,4,3,1,1,3,3,1,Interdisciplinary,Masters,36-40,12,0,0,Hybrid,Tier1_City,1,1,1,1,4,3,4,34.51,Tech,1,2,1,3,1,2,1,1,5,2,0,1,2,5,67.45
Chemistry,Social Media Manager,4.530155056239558,9,0,0,1,0,0,3,2,0,3,2,4,4,0,Science,Masters,18-24,1,0,0,Hybrid,Tier3_City,5,4,2,3,3,0,1,49.44,Manufacturing,5,5,2,5,2,4,1,3,2,4,0,1,4,5,54.76
Architecture,Brand Manager,4.228632391075295,3,2,0,1,9,0,0,4,4,3,2,2,0,0,Interdisciplinary,Masters,31-35,2,1,12,Remote,Tier1_City,3,5,0,5,5,2,5,3.75,Education,4,5,2,2,2,2,4,2,5,2,1,0,3,2,54.33
Art,Music Teacher,4.17215172678079,5,0,3,0,7,1,2,2,0,2,0,2,1,0,Arts,Masters,31-35,7,0,0,Office,Tier1_City,1,4,0,3,3,0,5,22.32,Finance,3,4,5,5,1,5,5,5,4,5,0,0,1,1,58.47
Architecture,Legal Consultant,4.132451364790683,4,2,0,0,8,1,2,4,0,2,0,4,2,1,Interdisciplinary,PhD,18-24,10,0,0,Hybrid,Tier2_City,2,4,5,5,2,1,4,43.34,Other,4,4,1,1,0,0,4,5,4,3,0,0,4,1,59.92
Chemistry,Organic Chemist,4.086307783449959,4,1,2,0,5,1,3,3,1,4,0,0,1,1,Science,Masters,25-30,5,0,0,Office,Tier3_City,1,4,2,4,3,3,3,23.35,Tech,1,1,5,4,4,4,3,1,1,5,1,1,1,2,55.51
Psychology,Manager,4.1264052299720895,3,1,4,0,9,1,3,4,0,0,2,0,1,0,Arts,PhD,18-24,0,0,0,Hybrid,Tier2_City,3,4,1,5,4,2,2,3.25,Finance,1,1,1,1,5,0,1,3,1,2,1,0,2,3,38.21
Architecture,Marketing Manager,4.126344555759136,6,2,0,1,9,0,3,1,1,4,3,4,0,0,Interdisciplinary,Bachelors,31-35,14,0,0,Flexible,Tier3_City,2,4,3,2,4,3,2,10.41,Other,3,5,2,1,4,5,2,2,3,3,0,1,1,1,62.25
Computer Science,AI Researcher,4.270517054467531,2,2,0,1,0,0,3,2,1,4,0,2,3,0,Science,Bachelors,25-30,3,0,0,Hybrid,Tier2_City,5,3,1,1,0,0,1,23.4,Finance,4,5,2,3,1,2,5,3,1,1,0,0,2,3,36.5
Music,Musician,2.540803742523389,2,2,4,0,7,1,0,3,4,1,2,1,0,0,Arts,Bachelors,40+,4,1,12,Remote,Tier3_City,1,5,2,4,1,0,3,34.39,Other,4,5,3,5,1,3,4,4,5,2,0,1,4,4,47.48
Finance,Paralegal,4.660932826617144,3,2,0,0,5,1,3,0,2,2,4,3,3,1,Commerce,Bachelors,18-24,13,0,0,Office,Tier2_City,4,5,5,4,3,0,2,10.64,Other,4,2,4,3,5,5,1,1,5,3,1,1,2,3,67.26
Medicine,Brand Manager,2.9584997905758,1,2,0,0,6,1,0,1,3,1,2,2,2,1,Science,Masters,31-35,10,0,0,Office,Tier1_City,3,5,1,2,4,3,1,24.06,Finance,1,5,3,1,1,5,3,3,3,4,0,1,2,2,58.63
Marketing,Education Administrator,4.060638939999986,5,2,3,1,6,1,3,2,3,2,3,2,2,0,Commerce,Bachelors,18-24,2,0,0,Flexible,Any,4,3,1,5,1,2,3,3.6,Healthcare,2,2,1,4,3,5,3,1,1,3,1,0,5,3,43.4
Music,Human Resources Specialist,3.478940843062573,8,2,2,1,6,0,0,3,0,4,4,2,2,0,Arts,Masters,31-35,0,1,34,Remote,Tier3_City,4,3,0,1,1,2,5,25.44,Manufacturing,2,2,1,2,2,1,5,4,1,1,1,0,4,4,34.08
Finance,Risk Analyst,4.133283064364323,1,1,4,1,7,0,1,4,2,4,1,4,0,1,Commerce,High School,31-35,2,0,0,Hybrid,Any,1,3,4,4,0,1,1,45.11,Other,4,1,1,1,4,5,4,3,5,5,1,0,3,2,49.98
Chemistry,Judge,4.544499701969689,4,1,3,1,6,1,0,0,2,2,1,0,1,0,Science,Bachelors,31-35,12,0,0,Hybrid,Tier2_City,4,1,3,1,1,3,3,31.05,Other,4,3,1,1,0,3,3,3,4,4,1,0,2,1,47.59
Physics,Special Education Teacher,2.614190023264982,0,0,1,0,6,1,4,3,0,3,4,1,3,1,Science,Bachelors,36-40,8,0,0,Office,Tier2_City,2,5,5,4,1,1,4,23.71,Other,5,4,4,1,3,5,1,1,1,5,0,0,4,1,58.04
Law,Social Media Manager,4.743956258437557,5,0,3,1,6,1,0,4,2,0,0,4,4,1,Arts,PhD,36-40,1,0,0,Flexible,Any,5,2,1,5,5,5,2,10.63,Other,3,4,2,5,2,3,4,4,2,1,1,0,2,5,46.82
Business,Music Teacher,3.035186135634252,7,2,4,0,5,0,3,0,0,2,4,1,2,0,Commerce,Bachelors,18-24,0,0,0,Hybrid,Tier1_City,5,4,0,4,2,1,1,12.51,Finance,1,1,3,2,3,0,1,2,5,4,0,1,5,5,45.49
Biology,Special Education Teacher,3.3809568774416,8,0,1,1,4,1,4,4,4,0,4,2,2,0,Science,Bachelors,25-30,6,1,46,Office,Any,4,1,4,4,0,1,5,6.6,Other,5,1,2,4,2,0,3,5,3,1,1,1,3,1,57.34
Physics,School Counselor,3.288421949062482,1,0,4,1,5,1,0,1,4,0,3,3,3,1,Science,Masters,31-35,12,1,41,Hybrid,Tier1_City,3,1,0,3,0,1,1,37.89,Education,4,5,5,1,1,1,1,1,1,1,1,1,3,4,48.0
Physics,Accountant,2.7146754307165946,3,2,0,1,1,0,1,1,0,3,2,0,4,1,Science,Masters,25-30,6,0,0,Remote,Tier1_City,4,4,1,5,3,0,2,6.63,Tech,2,5,3,2,0,3,3,1,4,2,0,0,2,4,47.14
Computer Science,Lawyer,4.702822377605071,5,2,2,0,2,1,2,1,4,2,4,3,3,1,Science,Bachelors,18-24,4,0,0,Hybrid,Tier1_City,3,1,3,2,1,5,2,21.05,Other,2,5,1,1,1,5,2,5,5,4,0,1,4,1,60.54
Education,Financial Analyst,4.218678612001383,2,2,0,0,7,1,2,1,0,0,3,3,2,0,Arts,Bachelors,25-30,1,0,0,Remote,Tier2_City,5,3,4,2,3,1,3,38.24,Finance,5,2,1,2,4,4,4,3,1,2,1,0,1,4,35.73
Architecture,Aerospace Engineer,4.882269734752265,3,1,4,1,6,1,4,4,0,0,2,0,4,0,Interdisciplinary,Bachelors,25-30,13,0,0,Remote,Tier1_City,2,1,1,5,5,2,5,36.5,Other,2,2,5,2,4,0,1,1,4,1,0,0,1,2,52.57
Business,Graphic Designer,4.234772924152148,1,2,2,0,4,0,4,3,2,4,0,2,0,1,Commerce,PhD,25-30,0,0,0,Remote,Tier1_City,3,5,2,2,4,1,3,30.14,Finance,2,5,3,5,4,5,4,2,4,2,1,0,4,3,55.47
Computer Science,Nuclear Physicist,3.90242413188011,9,2,0,1,8,0,0,4,0,1,1,4,4,0,Science,Bachelors,36-40,12,0,0,Hybrid,Tier2_City,5,5,5,5,1,0,5,29.85,Other,3,2,4,5,4,3,1,4,5,5,1,0,4,2,60.0
Medicine,Animator,3.856104285648426,1,2,3,1,2,1,4,4,3,1,1,0,2,1,Science,Bachelors,25-30,4,0,0,Hybrid,Tier2_City,1,2,5,2,4,4,1,7.25,Tech,4,1,4,2,3,2,3,3,1,3,1,0,4,2,48.47
Law,Microbiologist,3.5743601700575662,1,0,0,1,5,1,3,4,0,3,3,0,4,1,Arts,High School,18-24,9,0,0,Office,Tier3_City,4,5,1,3,2,5,1,11.22,Other,5,5,1,3,0,5,3,1,3,2,0,0,2,4,53.62
Chemistry,Accountant,3.8566856717675138,2,0,1,1,6,0,0,4,1,3,2,2,4,0,Science,Bachelors,18-24,3,0,0,Hybrid,Tier1_City,3,4,0,2,5,4,3,28.13,Education,1,4,1,1,0,0,2,2,1,5,1,0,4,1,44.0
Biology,Lawyer,4.467042342857548,8,0,0,1,7,1,1,4,1,0,2,1,1,0,Science,Masters,36-40,8,0,0,Hybrid,Tier1_City,2,4,1,4,1,4,4,19.36,Other,1,4,1,5,4,1,1,5,2,1,0,1,1,1,51.14
Medicine,Digital Marketing Specialist,3.4307864175650447,7,1,2,0,6,1,0,4,0,1,4,3,1,0,Science,Bachelors,40+,4,0,0,Remote,Tier1_City,4,5,2,5,3,5,2,3.89,Other,4,2,5,2,2,3,2,3,3,2,1,0,3,1,44.11
Medicine,Dentist,2.6469866968665787,4,1,0,0,1,0,4,0,2,2,0,2,2,1,Science,Bachelors,31-35,10,0,0,Flexible,Tier2_City,5,3,5,1,3,3,3,40.51,Finance,1,4,5,3,1,0,1,2,5,2,0,0,3,3,56.56
Education,Market Research Analyst,2.6622836290073697,3,2,3,0,9,1,2,1,4,4,4,4,2,1,Arts,Bachelors,25-30,9,0,0,Remote,Tier1_City,5,5,2,1,1,2,3,33.73,Finance,2,5,2,2,4,1,2,1,2,5,0,1,4,1,66.12
Art,Counselor,2.722859902445526,3,2,1,0,7,0,3,2,1,0,1,1,4,1,Arts,High School,36-40,11,0,0,Flexible,Tier1_City,5,3,1,5,3,0,1,18.31,Other,3,4,5,4,2,1,4,5,2,1,0,0,1,1,41.41
Business,Conductor,4.573824246352059,3,2,4,1,7,0,0,2,1,0,4,0,1,0,Commerce,Bachelors,31-35,11,1,48,Hybrid,Tier2_City,3,4,2,3,1,5,2,7.62,Education,5,1,3,2,5,2,3,1,1,5,0,0,4,4,50.87
Music,School Psychologist,4.407926722963902,6,1,3,1,3,0,4,0,1,0,3,0,0,0,Arts,Masters,36-40,1,0,0,Remote,Tier3_City,1,5,0,2,0,4,3,30.79,Finance,5,2,5,4,0,1,1,4,4,4,1,0,4,5,43.2
Business,Human Resources Specialist,2.7429847399881275,8,2,3,1,9,0,2,3,1,2,0,1,4,1,Commerce,Masters,31-35,3,0,0,Hybrid,Tier1_City,1,2,2,3,3,0,1,19.38,Education,2,4,3,5,1,0,5,1,2,1,1,1,4,5,39.29
Physics,Art Therapist,4.622662680567053,5,1,1,1,3,1,2,1,2,0,0,2,4,0,Science,PhD,25-30,12,0,0,Remote,Tier2_City,5,4,5,1,1,0,1,15.0,Finance,4,2,4,5,0,0,5,5,5,1,0,0,4,4,61.24
Computer Science,Pharmacist,4.821935173449198,1,2,3,1,6,1,0,1,0,0,1,2,0,1,Science,Masters,25-30,11,0,0,Remote,Tier1_City,4,2,2,5,1,3,3,36.91,Tech,3,1,2,2,0,5,3,4,5,5,0,0,5,1,54.08
Art,Quantum Physicist,2.9727946340213034,9,0,1,0,6,0,1,1,1,0,3,3,0,0,Arts,Masters,18-24,8,0,0,Hybrid,Tier1_City,2,4,3,5,3,4,3,18.42,Education,1,4,5,5,3,4,5,4,4,5,1,1,2,5,61.07
Art,Doctor,4.72487435555,5,2,3,0,5,1,0,1,1,2,0,1,3,0,Arts,Bachelors,25-30,7,0,0,Hybrid,Tier1_City,4,1,0,3,0,1,1,9.39,Tech,5,5,4,2,1,3,5,3,2,3,0,0,1,1,35.32
Biology,Musician,3.757392805821689,4,1,4,0,2,1,0,2,4,3,2,2,0,1,Science,Masters,31-35,2,0,0,Remote,Tier2_City,3,1,5,3,3,0,3,25.64,Tech,5,3,3,2,3,3,5,1,4,5,0,1,4,2,55.96
Psychology,Financial Controller,4.753457528963524,8,0,2,0,5,1,0,2,1,2,1,3,3,0,Arts,Masters,36-40,7,0,0,Office,Tier2_City,1,1,2,2,1,4,2,41.94,Finance,4,4,2,4,5,2,2,3,2,4,1,1,2,3,53.2
Medicine,Art Therapist,4.098856572530713,4,0,3,1,3,1,4,0,3,4,1,1,0,0,Science,Masters,31-35,12,0,0,Office,Any,2,2,5,4,0,0,1,42.93,Education,3,1,4,1,4,3,2,5,1,4,1,1,5,1,58.31
Art,Animator,4.267890386570425,5,2,0,0,4,0,2,1,2,4,4,4,4,1,Arts,Bachelors,25-30,1,0,0,Hybrid,Any,5,3,1,4,4,3,1,42.92,Healthcare,1,3,3,2,1,1,1,3,5,5,0,1,2,4,57.62
Chemistry,Conductor,4.042163072084839,3,0,4,0,6,0,3,3,0,1,1,1,0,1,Science,Bachelors,18-24,2,0,0,Remote,Tier2_City,5,4,2,2,2,3,3,22.78,Tech,5,4,2,1,2,0,2,3,4,3,0,1,5,4,39.47
Psychology,Clinical Psychologist,4.896331898836545,2,2,0,1,6,0,3,3,1,4,2,3,2,1,Arts,Masters,18-24,13,0,0,Remote,Tier1_City,3,1,4,4,3,1,3,40.17,Tech,5,2,1,3,0,1,4,5,2,3,0,1,4,4,64.3
Chemistry,Physicist,2.6020425448122984,2,0,0,1,9,0,1,1,3,2,0,1,4,0,Science,Masters,25-30,4,1,47,Remote,Tier3_City,3,2,4,1,5,3,3,42.96,Tech,1,1,5,5,0,3,1,4,2,4,0,0,5,3,53.85
Architecture,Art Director,2.9096614071020084,1,2,0,0,5,0,4,2,3,0,3,0,0,0,Interdisciplinary,PhD,25-30,10,0,0,Office,Tier3_City,3,4,5,4,1,4,2,24.6,Finance,3,4,1,3,3,5,5,1,3,1,1,0,3,1,62.84
Art,Forensic Psychologist,4.3782785977003575,8,1,0,1,8,0,2,2,4,0,3,0,4,1,Arts,Bachelors,31-35,11,1,47,Hybrid,Tier3_City,3,1,0,2,0,5,1,17.98,Finance,3,1,1,3,5,5,5,3,3,2,0,1,4,5,52.94
Chemistry,Architectural Technologist,3.099071273377688,9,1,4,1,1,1,0,2,0,0,1,2,1,0,Science,Bachelors,18-24,13,0,0,Hybrid,Tier1_City,5,1,4,4,0,3,4,35.99,Tech,3,5,1,2,3,4,3,2,3,2,0,1,5,2,39.65
Computer Science,Nuclear Physicist,4.064903353107168,4,1,1,0,7,0,0,3,4,0,3,3,1,0,Science,Bachelors,40+,9,0,0,Remote,Tier3_City,5,1,4,5,4,5,2,45.51,Other,5,3,4,3,5,3,1,4,3,3,1,1,4,1,57.1
Art,Artist,4.129010946764813,4,2,2,1,0,1,2,4,0,4,1,2,3,0,Arts,Masters,25-30,9,0,0,Remote,Any,3,2,2,3,3,1,2,48.69,Finance,2,3,1,2,3,2,5,3,3,1,1,1,5,3,53.28
Chemistry,Legal Consultant,4.304574433217397,4,0,0,0,7,0,0,1,2,1,0,1,3,0,Science,Bachelors,36-40,7,0,0,Office,Tier2_City,5,3,0,1,5,2,1,16.64,Finance,5,5,1,5,1,0,2,2,3,4,0,1,2,1,48.08
Physics,Lawyer,2.958888523902791,2,2,3,1,7,1,0,2,2,4,1,1,3,1,Science,Bachelors,25-30,0,1,7,Hybrid,Tier3_City,3,1,3,5,0,0,4,47.94,Finance,4,3,4,5,0,1,5,5,5,3,1,0,1,2,42.42
Psychology,Legal Consultant,2.567126607978508,1,1,0,0,5,1,2,1,0,3,2,3,3,0,Arts,PhD,18-24,3,0,0,Flexible,Tier3_City,2,1,2,5,4,0,1,26.47,Manufacturing,4,3,5,3,5,3,5,3,2,3,1,0,3,3,49.94
Physics,Counselor,4.105850844692044,3,1,1,1,7,1,4,1,0,2,1,0,1,0,Science,High School,31-35,0,0,0,Flexible,Tier2_City,3,3,3,2,1,4,2,17.38,Education,5,5,2,2,5,0,3,1,5,2,1,1,4,5,34.24
Psychology,Chemical Engineer,2.761529495613357,1,1,0,0,2,1,4,3,0,0,3,2,2,0,Arts,Masters,31-35,0,0,0,Office,Tier3_City,3,3,1,3,4,1,3,49.45,Finance,5,2,2,4,2,5,5,4,2,2,0,1,2,1,47.78
Marketing,Graphic Designer,4.810149938001185,8,2,3,1,3,1,3,4,2,3,1,3,1,1,Commerce,Bachelors,25-30,11,0,0,Remote,Tier3_City,2,5,5,3,3,1,1,44.26,Manufacturing,1,3,5,4,5,1,4,3,3,5,0,0,5,3,68.16
Finance,Acoustics Specialist,4.796188635553763,8,2,2,0,8,0,1,3,0,3,3,3,0,1,Commerce,Masters,25-30,4,0,0,Remote,Any,1,1,4,1,4,1,1,35.54,Manufacturing,3,2,4,1,5,3,4,1,1,4,0,0,3,1,49.36
Marketing,Construction Manager,3.684293964438522,4,0,0,0,8,0,4,0,3,4,0,2,0,0,Commerce,Masters,18-24,5,1,13,Remote,Any,4,4,2,2,0,0,3,45.06,Finance,1,1,1,1,1,3,5,3,4,1,0,0,1,3,50.11
Marketing,Forensic Psychologist,4.525990781660057,5,1,0,1,3,1,1,3,3,3,3,1,0,0,Commerce,PhD,31-35,14,0,0,Flexible,Tier2_City,3,5,0,1,0,3,4,35.03,Other,4,1,2,1,0,5,5,2,4,4,0,0,4,2,68.56
Psychology,Chemical Engineer,3.3415297856481345,2,2,2,0,1,1,1,3,2,3,0,1,2,0,Arts,PhD,36-40,0,0,0,Hybrid,Tier1_City,2,4,4,4,2,0,4,23.7,Manufacturing,4,3,5,3,4,3,4,4,5,5,0,1,5,4,55.65
Music,Art Director,2.9425071371736724,3,0,4,1,7,0,4,3,0,1,3,0,1,0,Arts,High School,18-24,10,0,0,Office,Tier1_City,2,3,1,5,4,0,1,47.56,Healthcare,2,1,5,2,4,2,2,1,3,4,1,1,3,1,58.02
Psychology,Counselor,4.744307929087043,1,0,2,0,3,1,3,2,4,0,0,1,4,0,Arts,Bachelors,25-30,5,1,48,Flexible,Any,5,5,5,1,1,0,3,48.27,Manufacturing,3,5,1,1,3,2,1,1,5,2,0,1,3,3,45.47
Computer Science,Human Resources Specialist,3.950303868949823,3,1,4,1,1,1,4,2,3,1,4,3,1,0,Science,Bachelors,36-40,4,1,56,Office,Tier1_City,3,2,4,5,5,3,1,17.77,Education,3,3,5,2,5,1,4,5,4,4,0,1,1,3,60.11
Psychology,Inorganic Chemist,4.521946511356146,6,2,0,1,1,0,0,4,2,1,2,2,3,1,Arts,Masters,25-30,3,0,0,Hybrid,Tier1_City,2,5,4,2,5,2,3,19.66,Manufacturing,4,5,4,3,3,1,3,4,3,1,0,0,5,3,49.6
Business,Microbiologist,4.500292805625492,1,0,1,0,3,1,4,3,1,0,2,2,0,0,Commerce,Masters,31-35,9,1,51,Remote,Tier2_City,1,5,3,4,3,4,2,20.99,Finance,1,2,4,2,3,0,4,3,4,3,0,0,5,2,59.77
Psychology,Curriculum Developer,3.2631493669230807,3,1,4,1,5,1,3,1,3,1,1,2,3,0,Arts,Bachelors,25-30,4,0,0,Remote,Tier1_City,1,3,1,2,2,2,3,41.64,Other,5,4,2,2,0,4,1,2,2,1,1,1,2,4,39.29
Finance,Advertising Manager,3.0095639869091952,5,1,2,0,0,1,4,0,2,2,2,0,4,0,Commerce,Masters,25-30,7,0,0,Hybrid,Tier2_City,4,1,0,4,4,2,1,40.18,Tech,3,4,3,3,3,0,4,3,4,1,0,0,5,1,54.11
Marketing,Architectural Technologist,4.89550758759018,9,1,1,0,1,0,1,3,0,0,3,4,4,0,Commerce,Bachelors,25-30,8,0,0,Flexible,Tier3_City,5,3,4,4,1,0,5,49.21,Healthcare,5,3,5,4,2,5,1,2,2,2,1,0,1,3,50.08
Physics,Legal Secretary,2.87876846373796,3,2,3,1,6,0,3,4,4,4,3,3,3,1,Science,Masters,25-30,10,0,0,Flexible,Tier1_City,5,3,4,5,2,2,4,24.87,Manufacturing,4,5,4,2,2,4,2,5,1,1,0,0,2,1,65.17
Chemistry,Art Director,4.786301055794644,8,0,1,0,4,1,1,0,4,3,1,2,1,0,Science,PhD,18-24,13,0,0,Remote,Tier3_City,5,3,5,2,0,0,1,37.63,Other,2,4,1,2,4,3,2,1,3,5,1,0,5,1,64.84
Architecture,Paralegal,4.903882383515545,9,2,4,0,8,1,3,4,2,4,0,2,1,0,Interdisciplinary,Bachelors,31-35,11,0,0,Remote,Tier2_City,3,4,0,2,3,0,3,43.27,Healthcare,4,3,1,5,1,3,5,2,4,5,0,0,3,3,70.96
Art,Microbiologist,4.184658250589532,9,2,2,0,7,1,4,3,4,3,2,4,4,1,Arts,Bachelors,31-35,1,0,0,Hybrid,Tier2_City,1,2,0,1,4,4,3,13.4,Education,5,4,3,5,5,0,2,1,4,5,0,0,1,5,68.16
Biology,Pharmacist,3.0652651535600075,5,2,2,1,6,0,1,2,1,4,1,2,3,0,Science,Bachelors,31-35,5,0,0,Hybrid,Tier1_City,3,4,2,2,5,1,4,32.17,Manufacturing,4,4,3,1,0,2,4,1,4,4,1,0,4,4,54.79
Biology,Acoustics Specialist,2.8771793985175926,6,2,0,0,4,1,3,2,4,4,1,0,4,0,Science,Masters,31-35,2,0,0,Remote,Any,2,5,2,1,1,0,1,28.74,Manufacturing,3,1,3,1,1,2,3,3,4,4,0,1,4,3,50.87
Education,Game Developer,3.672930838570209,1,1,2,0,6,1,3,1,4,2,1,1,1,0,Arts,Bachelors,18-24,14,1,49,Hybrid,Tier2_City,4,3,4,3,0,2,5,37.91,Healthcare,5,3,1,3,3,1,4,2,3,4,1,0,1,2,60.74
Music,Credit Analyst,3.1289772105728866,5,1,4,0,1,0,2,1,0,4,4,1,0,1,Arts,Bachelors,18-24,1,0,0,Flexible,Tier1_City,4,1,2,3,2,4,2,35.69,Manufacturing,5,4,5,3,0,1,2,2,4,4,0,1,1,1,48.85
Engineering,Illustrator,4.075686658869605,8,1,4,1,6,1,4,3,0,3,1,2,3,1,Science,Bachelors,36-40,11,0,0,Flexible,Tier2_City,3,3,4,3,3,5,5,41.2,Manufacturing,2,3,4,5,3,0,3,1,5,1,1,1,4,1,61.65
Education,Teacher,4.46008105554093,7,0,0,0,9,0,0,3,4,2,4,0,2,1,Arts,Bachelors,25-30,13,0,0,Hybrid,Any,4,4,0,2,2,5,2,17.62,Tech,3,1,1,5,1,2,2,2,2,4,1,0,4,1,60.46
Music,Investment Banker,3.146885438371011,5,2,1,1,9,0,4,4,4,2,2,4,3,1,Arts,Bachelors,25-30,12,1,36,Hybrid,Tier2_City,3,2,2,2,5,5,2,13.17,Healthcare,1,3,4,1,4,3,1,4,2,2,1,1,4,2,68.62
Biology,Biotechnologist,3.937334963418918,5,1,0,1,9,0,4,3,2,3,3,3,3,1,Science,Masters,18-24,0,0,0,Remote,Tier3_City,5,4,5,1,2,2,1,40.84,Finance,2,1,3,5,2,5,4,5,4,2,0,1,2,3,55.39
Law,Organic Chemist,4.386547568362076,1,2,3,0,7,0,4,0,0,3,2,0,2,0,Arts,High School,18-24,3,0,0,Office,Tier2_City,2,3,1,4,1,1,2,19.95,Finance,3,4,2,2,2,3,3,4,1,3,1,1,1,4,35.69
Education,Web Developer,4.787429277441349,3,2,4,1,1,0,2,0,2,2,4,4,4,0,Arts,Masters,25-30,7,0,0,Remote,Tier1_City,5,2,1,1,0,3,3,16.52,Education,1,4,5,2,2,2,5,3,5,5,1,0,2,3,63.72
Law,Biochemist,4.239371397718731,2,2,1,0,9,1,4,3,2,2,1,0,2,1,Arts,Masters,36-40,2,1,26,Remote,Tier1_City,4,1,0,3,4,1,2,18.83,Tech,5,4,3,5,0,0,3,3,5,1,1,0,5,5,51.02
Law,Financial Advisor,3.663503277419863,6,1,4,1,1,1,0,4,2,4,0,4,3,0,Arts,Bachelors,36-40,4,0,0,Remote,Tier1_City,2,4,4,1,1,4,2,6.12,Healthcare,2,1,3,3,3,1,3,4,1,2,1,1,2,2,42.61
Art,Dentist,4.017221112750436,1,0,0,1,9,1,4,1,0,2,2,4,3,0,Arts,Bachelors,36-40,13,0,0,Hybrid,Tier1_City,1,4,1,4,5,1,4,39.34,Healthcare,5,2,4,1,2,0,3,5,2,4,1,0,3,4,61.52
Business,Curriculum Developer,3.321078845610753,9,0,4,1,3,0,0,4,4,2,4,0,1,0,Commerce,Masters,36-40,9,0,0,Flexible,Tier2_City,3,5,2,2,3,5,4,36.61,Tech,5,1,1,2,3,2,5,2,3,5,0,0,1,4,69.27
Computer Science,Digital Marketing Specialist,4.984000055771299,5,2,3,0,3,1,0,2,3,3,3,3,3,1,Science,PhD,36-40,4,1,10,Flexible,Tier1_City,2,2,3,1,5,1,1,28.98,Tech,5,1,2,3,2,0,3,5,4,3,0,1,5,5,64.92
Music,Ecologist,4.547327428981152,4,1,0,1,0,0,1,4,0,1,3,4,4,0,Arts,Bachelors,25-30,4,0,0,Office,Any,3,4,4,3,5,4,1,36.66,Education,3,5,5,5,1,2,4,5,2,2,1,0,4,5,48.8
Medicine,Urban Planner,2.8682164527306817,6,2,0,1,1,0,4,2,3,0,1,2,0,0,Science,Bachelors,18-24,10,0,0,Office,Any,2,5,2,3,2,4,3,20.54,Finance,1,4,2,1,4,0,3,2,3,1,0,1,3,2,53.48
Biology,Art Therapist,4.633126863985737,4,2,3,1,6,1,4,2,2,0,1,0,3,0,Science,Bachelors,31-35,8,0,0,Remote,Tier2_City,4,1,4,2,3,5,4,16.88,Other,3,4,3,1,3,4,2,2,2,3,1,0,5,3,44.8
Marketing,Musician,3.3008354333334045,1,2,4,1,1,1,0,3,3,0,4,4,4,0,Commerce,Masters,18-24,14,0,0,Hybrid,Tier2_City,5,4,5,1,1,2,5,43.53,Healthcare,5,5,2,3,0,3,3,2,1,5,0,0,5,1,60.77
Psychology,Art Therapist,4.235554366800578,9,2,2,1,6,0,2,0,1,4,2,4,2,1,Arts,Bachelors,25-30,7,0,0,Office,Tier1_City,4,4,5,4,5,0,1,22.86,Other,2,2,5,3,2,4,3,2,1,4,1,0,3,1,54.77
Biology,Illustrator,3.320373672023996,3,0,2,1,6,1,2,2,4,1,2,0,4,1,Science,Bachelors,18-24,7,1,13,Hybrid,Tier2_City,1,3,2,2,1,3,1,12.21,Tech,5,3,3,3,1,2,5,1,2,4,1,1,1,4,49.79
Physics,Chemical Engineer,4.888358815295672,3,0,3,0,4,1,1,0,1,1,3,2,0,1,Science,Masters,25-30,12,1,58,Remote,Tier2_City,4,4,0,1,4,3,4,38.21,Healthcare,1,4,5,5,2,3,1,4,2,5,1,0,5,5,62.37
Architecture,Brand Manager,3.324581055204465,3,1,3,0,6,0,2,1,0,2,3,0,1,1,Interdisciplinary,Masters,25-30,12,0,0,Office,Tier1_City,2,1,0,5,2,5,4,18.79,Finance,3,4,2,5,4,4,5,1,3,2,0,1,2,4,56.46
Medicine,Financial Advisor,3.5451835486756016,8,2,4,1,9,0,1,2,4,1,4,0,4,0,Science,Bachelors,18-24,0,0,0,Remote,Tier1_City,1,5,0,3,1,3,3,12.96,Healthcare,1,1,3,3,5,5,5,4,4,4,1,1,2,2,46.95
Physics,Nuclear Physicist,4.335623067890921,4,0,0,0,5,1,4,2,1,2,3,1,4,1,Science,Bachelors,25-30,0,0,0,Remote,Tier2_City,2,2,0,4,3,1,4,4.28,Other,3,2,3,5,2,0,3,4,5,4,1,0,2,4,54.32
Art,Risk Analyst,4.233311135431813,7,0,1,0,5,1,4,1,4,3,2,4,3,1,Arts,Masters,36-40,1,0,0,Hybrid,Tier2_City,5,1,2,4,5,4,2,48.62,Healthcare,1,2,5,1,4,0,1,4,4,2,0,0,1,3,56.28
Biology,Physicist,2.646042678564533,1,2,3,1,5,0,0,0,4,4,3,2,3,0,Science,High School,25-30,13,0,0,Remote,Tier3_City,3,2,1,4,4,4,5,24.96,Tech,1,2,1,4,3,3,5,5,3,5,0,0,4,3,60.22
Finance,Judge,3.474066732531879,2,0,0,0,9,0,4,4,4,0,1,3,1,0,Commerce,Bachelors,36-40,7,0,0,Hybrid,Any,5,1,2,3,3,5,2,10.6,Tech,3,2,3,5,4,2,2,4,3,5,1,1,5,1,62.81
Music,School Psychologist,4.9554647307799815,3,1,2,0,7,1,3,2,4,1,3,3,3,1,Arts,Masters,18-24,9,0,0,Hybrid,Tier3_City,5,5,2,1,2,4,2,38.62,Tech,3,5,5,1,1,5,1,2,2,3,0,1,2,2,62.86
Engineering,Financial Controller,3.2075696609905564,6,2,0,1,7,1,2,0,2,1,3,3,2,0,Science,Bachelors,18-24,0,0,0,Remote,Tier1_City,5,3,3,2,4,0,2,44.72,Finance,3,1,5,4,5,4,5,5,1,4,1,0,1,5,42.68
Physics,Principal,2.7206066417308,1,1,4,0,1,1,0,2,2,4,3,2,2,0,Science,Masters,25-30,14,1,11,Flexible,Tier3_City,2,5,3,1,4,4,1,27.81,Manufacturing,4,5,5,4,1,2,3,5,5,5,0,1,4,1,71.58
Chemistry,Analytical Chemist,2.868227973111895,8,2,1,1,4,1,1,2,4,4,4,2,1,0,Science,PhD,25-30,3,0,0,Office,Tier2_City,3,2,5,2,4,4,2,4.33,Finance,1,5,1,3,3,0,2,1,4,2,0,1,5,4,62.58
Music,Fluid Mechanics Engineer,4.013282654769835,8,0,3,0,3,0,4,0,0,3,1,1,1,0,Arts,Bachelors,31-35,8,1,10,Remote,Tier3_City,2,2,2,4,5,1,1,20.16,Tech,4,3,4,3,0,1,1,3,5,2,0,0,4,4,53.1
Business,Biochemist,4.422407316957063,3,0,1,1,5,1,1,0,2,2,0,2,3,0,Commerce,Bachelors,31-35,1,1,40,Office,Any,1,4,0,1,0,2,4,14.43,Education,4,1,3,1,1,1,2,5,4,2,1,1,2,3,31.06
Architecture,Judge,3.8991412368568814,0,1,3,1,8,1,2,1,3,2,0,4,3,1,Interdisciplinary,Masters,31-35,2,1,49,Hybrid,Tier1_City,2,3,3,4,4,3,5,32.91,Healthcare,5,2,2,3,3,2,4,2,4,4,1,0,4,4,53.15
Education,Zoologist,4.048423041696116,6,2,4,1,9,0,0,4,3,0,0,3,4,0,Arts,Masters,36-40,10,0,0,Office,Tier1_City,5,5,3,5,3,1,5,27.39,Healthcare,4,1,5,4,5,0,5,5,1,1,0,0,1,5,53.83
Law,Architectural Technologist,3.309017298441659,2,0,1,0,4,0,0,0,4,2,0,1,3,1,Arts,PhD,25-30,5,0,0,Office,Tier2_City,4,5,2,4,3,1,2,19.72,Other,4,2,2,1,3,0,3,1,5,5,0,0,2,3,56.93
Business,Sound Engineer,3.832354485387204,6,2,1,1,2,1,0,3,1,4,4,1,3,1,Commerce,Masters,18-24,12,0,0,Remote,Tier1_City,4,2,4,4,2,1,5,33.48,Healthcare,3,3,5,1,1,1,4,5,1,1,0,0,5,1,52.07
Psychology,Mechanical Engineer,3.6031259989958313,6,2,2,1,8,1,0,0,1,3,0,1,3,0,Arts,Bachelors,25-30,14,1,55,Office,Tier2_City,2,3,3,2,1,3,1,30.47,Other,3,4,5,1,3,1,3,3,3,1,0,1,3,5,36.29
Marketing,Inorganic Chemist,4.495757262501352,0,2,4,0,1,1,1,1,3,0,1,4,2,0,Commerce,Masters,18-24,10,0,0,Flexible,Tier3_City,5,5,0,5,1,5,4,45.61,Healthcare,2,5,3,3,3,5,5,4,2,3,0,1,5,3,56.8
Chemistry,Clinical Psychologist,4.108413622181844,5,2,2,1,2,0,0,3,4,0,0,2,1,0,Science,Bachelors,25-30,9,1,13,Hybrid,Tier1_City,5,3,5,4,0,1,2,31.05,Education,1,3,1,3,2,4,4,5,2,2,1,0,5,3,46.45
Psychology,Actuary,4.411010723594903,4,0,1,0,4,1,3,4,2,4,1,0,4,0,Arts,Bachelors,18-24,2,0,0,Remote,Tier2_City,4,3,2,4,5,2,3,26.86,Other,4,5,1,3,3,4,1,1,2,2,0,0,5,4,46.58
Education,Construction Manager,4.015172666774389,7,0,1,0,8,1,1,0,2,0,3,4,2,0,Arts,High School,25-30,14,0,0,Remote,Tier2_City,3,5,4,5,5,5,5,41.71,Tech,4,2,2,5,1,1,4,3,3,2,1,0,1,1,55.41
Biology,Art Director,4.049929648624188,4,0,0,0,8,1,2,1,0,1,4,4,4,1,Science,Bachelors,18-24,14,0,0,Remote,Tier1_City,3,3,1,5,4,4,5,12.51,Manufacturing,1,2,4,5,1,2,1,4,2,5,0,0,2,2,60.98
Computer Science,Animator,2.6949716163214026,1,1,4,0,5,1,4,3,1,3,0,3,3,0,Science,Masters,18-24,3,1,36,Remote,Tier3_City,5,1,0,1,0,2,2,14.45,Healthcare,3,3,1,5,1,5,1,5,3,2,1,0,5,3,50.02
Education,Judge,2.567853438064764,9,2,3,1,0,1,1,4,0,2,4,1,1,0,Arts,Bachelors,31-35,8,0,0,Hybrid,Tier2_City,1,2,0,2,2,5,5,39.83,Other,3,4,1,1,2,3,3,2,2,2,0,1,1,5,46.02
Law,Physician Assistant,3.703395536604746,1,1,0,1,0,1,4,2,0,2,3,0,2,1,Arts,Bachelors,31-35,8,0,0,Remote,Tier2_City,1,3,2,5,2,4,5,23.79,Manufacturing,1,4,4,3,1,0,2,5,4,3,1,1,1,4,55.72
Business,Architectural Technologist,2.7310703902675098,6,0,1,0,0,0,1,0,1,3,3,4,0,1,Commerce,Bachelors,31-35,9,0,0,Remote,Tier3_City,1,3,1,5,1,4,3,22.23,Other,1,5,1,5,3,0,2,2,1,3,0,1,2,4,52.82
Chemistry,Digital Marketing Specialist,2.8099557987972985,8,0,4,0,3,0,0,3,2,3,4,4,1,1,Science,Masters,31-35,4,0,0,Office,Tier2_City,1,1,0,3,2,1,1,44.69,Finance,3,2,3,1,4,0,1,1,3,1,0,0,1,1,53.66
Engineering,Legal Consultant,3.679518115726644,9,0,2,0,3,1,3,4,0,3,0,3,3,0,Science,Masters,18-24,6,0,0,Flexible,Tier1_City,1,4,0,5,4,1,2,31.68,Finance,1,2,3,4,2,4,5,4,3,5,0,1,2,5,58.86
Art,Clinical Psychologist,4.564706247610726,6,1,3,1,3,0,3,4,1,1,0,0,4,0,Arts,Bachelors,25-30,8,0,0,Flexible,Tier3_City,4,3,2,2,3,3,2,40.74,Healthcare,3,4,2,5,4,1,2,5,1,1,0,1,1,4,43.57
Art,Paralegal,2.6113410421302565,2,2,0,1,7,1,2,4,1,0,2,0,4,0,Arts,Bachelors,18-24,7,0,0,Remote,Tier2_City,5,5,0,4,2,0,3,41.06,Tech,1,2,2,1,0,5,2,4,4,5,0,1,2,5,55.02
Engineering,Financial Controller,3.25818548476717,3,0,0,1,2,1,4,0,2,2,2,3,2,0,Science,Bachelors,36-40,10,0,0,Office,Tier3_City,2,4,5,4,0,2,3,8.64,Education,3,2,2,2,5,5,5,2,1,4,1,0,4,4,56.9
Education,Credit Analyst,4.394089725714489,5,1,4,0,6,1,1,3,2,0,4,3,4,0,Arts,PhD,31-35,6,1,49,Flexible,Tier1_City,4,4,4,4,4,3,1,33.72,Other,2,3,3,5,4,4,3,3,3,3,1,1,5,2,64.59
Medicine,Civil Engineer,2.505707435692426,9,0,3,1,5,0,1,2,4,3,3,2,4,0,Science,Masters,18-24,11,1,54,Flexible,Tier1_City,4,1,1,4,2,3,4,47.77,Healthcare,3,4,2,4,3,1,1,1,2,2,1,0,2,5,62.74
Business,Conductor,3.019063316831869,5,0,3,0,7,1,0,2,4,4,1,0,0,0,Commerce,Bachelors,25-30,7,0,0,Flexible,Tier3_City,5,5,3,3,5,2,2,25.56,Finance,3,4,2,1,2,2,4,5,2,1,1,0,2,5,45.38
Business,Paralegal,3.1898381704183008,4,1,1,1,4,1,4,3,3,3,2,1,2,0,Commerce,Masters,40+,4,0,0,Office,Tier1_City,3,4,3,5,2,5,5,37.41,Finance,4,1,3,5,1,4,4,3,4,2,1,1,4,3,58.28
Psychology,Astronomer,2.7904000288553075,0,0,1,1,3,0,0,0,2,3,1,2,1,1,Arts,Bachelors,25-30,4,0,0,Remote,Tier2_City,4,3,1,4,5,2,1,29.64,Other,3,4,4,5,1,1,1,1,3,3,1,1,5,5,44.2
Marketing,Accountant,3.866981625185832,7,2,2,0,0,0,2,4,2,4,3,3,0,1,Commerce,Masters,36-40,4,1,58,Remote,Tier2_City,4,1,5,1,4,4,2,12.63,Other,1,4,2,2,4,2,3,2,3,1,0,1,3,4,55.97
Computer Science,Chemical Engineer,3.764493213192721,2,1,3,0,7,0,3,3,3,0,2,3,3,0,Science,Bachelors,25-30,0,0,0,Hybrid,Tier2_City,2,1,4,4,2,0,1,12.17,Other,5,1,1,1,4,4,4,1,4,5,1,1,2,3,48.4
Business,Fluid Mechanics Engineer,2.8640803933658683,2,2,4,0,6,1,1,1,3,2,0,4,0,0,Commerce,Bachelors,18-24,5,0,0,Remote,Tier1_City,1,1,2,5,5,5,4,23.39,Manufacturing,1,2,3,1,4,0,2,4,5,5,0,0,5,3,56.74
Engineering,Civil Engineer,4.488483362552543,1,1,4,0,7,1,1,3,4,2,0,0,0,1,Science,Bachelors,31-35,4,0,0,Flexible,Tier1_City,4,2,2,4,3,1,2,25.7,Education,4,2,4,1,3,2,3,2,4,2,1,0,1,5,43.17
Architecture,Pharmacist,4.89431070264845,5,0,1,1,1,1,1,4,1,3,4,1,2,1,Interdisciplinary,Bachelors,31-35,7,0,0,Hybrid,Tier1_City,1,4,3,3,1,0,5,26.65,Other,1,5,1,3,1,4,5,1,1,5,0,1,5,3,53.58
Music,Marketing Specialist,3.662694469019577,7,1,0,1,8,1,3,0,1,0,2,4,2,1,Arts,PhD,31-35,7,0,0,Flexible,Tier2_City,5,5,0,2,4,0,2,47.89,Other,2,2,1,2,5,1,1,4,1,2,0,1,2,5,53.13
Physics,Risk Analyst,4.42424552445095,6,0,0,1,1,1,3,3,0,0,2,3,3,1,Science,Bachelors,25-30,1,1,18,Office,Any,4,5,1,2,5,1,1,7.71,Healthcare,5,4,5,1,0,0,4,4,5,1,0,1,4,5,44.07
Physics,Civil Engineer,3.025892386511373,8,2,2,0,9,1,3,2,4,3,0,2,2,0,Science,Masters,25-30,10,0,0,Hybrid,Tier1_City,2,2,4,5,0,0,4,20.88,Tech,5,5,4,2,3,1,1,5,1,2,1,1,3,3,51.75
Medicine,Pharmacist,3.888889892237631,7,0,2,0,8,1,3,3,0,0,3,0,0,1,Science,Masters,31-35,5,0,0,Remote,Tier3_City,2,3,2,2,2,5,1,27.18,Manufacturing,4,5,5,3,5,3,5,5,4,4,0,1,1,4,51.77
Law,Lawyer,3.479806414283753,8,0,3,0,6,1,4,0,1,3,3,3,1,1,Arts,Bachelors,25-30,11,0,0,Remote,Tier1_City,5,4,1,2,5,5,1,48.27,Education,5,2,3,1,1,3,4,1,1,1,0,0,4,3,51.47
Psychology,Nuclear Physicist,3.195810143353549,3,1,1,0,2,0,4,1,1,0,3,1,4,0,Arts,High School,25-30,10,1,29,Office,Any,1,1,0,1,5,5,3,26.7,Manufacturing,3,5,4,2,1,4,1,4,4,2,0,0,2,1,53.09
Medicine,Paralegal,3.6656348247985946,0,0,0,1,9,0,3,4,0,1,3,2,1,1,Science,Bachelors,36-40,9,0,0,Office,Tier2_City,3,2,3,5,5,3,1,39.44,Other,4,1,5,2,1,2,5,3,1,5,1,0,4,5,56.23
Biology,Graphic Designer,4.217476699938678,5,1,0,1,3,1,2,2,4,3,1,4,0,0,Science,Masters,25-30,9,0,0,Flexible,Tier1_City,5,2,0,5,1,3,4,38.22,Tech,2,5,3,3,1,5,2,4,1,2,0,0,1,2,60.08
Architecture,Game Developer,3.5616282140685263,8,2,1,1,9,0,0,0,4,4,3,3,1,1,Interdisciplinary,Bachelors,25-30,14,0,0,Remote,Tier2_City,3,4,4,2,0,5,5,29.62,Other,5,3,2,2,2,2,5,2,2,5,0,0,5,2,58.46
Chemistry,Animator,3.7031686581760495,8,0,0,1,4,0,0,4,0,3,3,1,2,1,Science,Bachelors,31-35,5,1,31,Remote,Tier2_City,2,5,5,2,0,1,3,9.14,Finance,5,1,1,3,1,4,3,1,2,4,1,0,4,2,46.99
Music,Financial Advisor,3.0285808645326893,8,0,2,1,7,0,3,4,1,0,2,0,0,1,Arts,Bachelors,40+,2,0,0,Remote,Tier1_City,2,4,5,2,3,1,1,13.28,Other,4,4,3,5,4,4,3,1,4,4,0,0,1,2,52.03
Psychology,Lawyer,3.415861333628846,4,2,3,0,5,1,3,4,1,3,3,3,3,0,Arts,Masters,25-30,0,0,0,Remote,Tier1_City,4,5,3,3,1,2,2,14.29,Healthcare,5,2,4,2,1,5,5,5,5,5,1,0,4,5,56.64
Psychology,Financial Analyst,3.08485455484274,9,1,4,0,7,0,1,2,1,1,2,3,4,0,Arts,Bachelors,25-30,6,0,0,Office,Tier1_City,2,4,0,4,5,2,3,4.82,Healthcare,5,2,1,3,5,0,2,4,2,1,1,0,2,5,44.64
Medicine,Human Resources Specialist,2.6450590103498213,9,1,3,0,2,1,2,0,4,4,3,0,4,0,Science,Bachelors,36-40,9,1,35,Remote,Tier3_City,1,5,5,3,4,5,4,20.82,Tech,2,3,1,4,0,1,1,5,4,5,1,0,3,3,69.82
Medicine,Geneticist,4.383967066921834,6,2,2,1,0,0,4,0,1,3,0,0,1,0,Science,Bachelors,36-40,4,0,0,Hybrid,Any,2,2,4,5,1,0,2,31.69,Other,2,2,3,1,2,5,1,4,4,2,0,1,3,3,41.51
Psychology,Financial Advisor,4.579127897823245,1,0,4,1,5,0,3,4,4,1,4,3,4,0,Arts,Bachelors,31-35,11,0,0,Hybrid,Tier1_City,4,5,5,1,1,0,4,9.78,Healthcare,4,4,2,1,0,1,2,1,2,1,1,1,3,2,56.09
Engineering,Aerospace Engineer,3.994900121952287,4,0,4,1,9,0,2,3,3,1,1,4,3,0,Science,Masters,25-30,11,0,0,Hybrid,Tier2_City,5,4,4,4,0,1,2,11.23,Healthcare,5,5,3,1,0,3,4,2,5,1,0,0,1,5,62.06
Business,Civil Engineer,2.8421485121530456,4,1,1,1,1,0,0,4,1,4,1,3,0,1,Commerce,Bachelors,25-30,9,0,0,Hybrid,Tier1_City,4,3,4,1,3,0,5,36.23,Other,1,2,5,3,0,3,5,2,1,2,1,0,3,3,47.22
Chemistry,Geneticist,4.74842631602135,4,1,4,0,5,0,2,2,1,2,2,4,1,1,Science,Masters,31-35,4,0,0,Hybrid,Tier1_City,5,4,1,5,3,4,4,10.95,Manufacturing,4,4,5,3,3,4,3,2,5,1,1,0,1,3,50.79
Computer Science,Financial Controller,4.720591759690436,9,1,3,1,8,0,4,1,3,0,1,2,3,0,Science,Masters,36-40,10,1,31,Hybrid,Tier2_City,4,2,4,5,1,3,2,9.36,Tech,2,1,5,1,1,2,3,1,2,2,1,1,2,3,54.2
Music,Digital Marketing Specialist,3.150944635019383,0,0,2,1,0,0,1,3,0,2,1,1,3,0,Arts,Masters,36-40,7,0,0,Office,Tier3_City,2,5,2,1,1,0,4,48.96,Manufacturing,1,4,4,3,5,2,3,5,4,3,1,0,1,5,51.39
Business,Nuclear Physicist,3.864097468698789,4,2,2,0,0,0,2,2,1,3,1,4,4,0,Commerce,Masters,18-24,11,1,13,Remote,Tier1_City,3,5,4,1,2,0,3,3.69,Healthcare,5,3,3,2,1,0,1,4,2,4,1,1,3,1,62.13
Art,Geneticist,2.605155667180249,9,1,3,1,4,1,0,1,0,0,2,4,4,0,Arts,Bachelors,25-30,4,0,0,Hybrid,Tier3_City,1,5,0,1,5,2,4,18.29,Other,4,4,1,2,0,3,1,5,2,3,1,1,3,2,38.91
Music,Legal Consultant,3.675280727050995,0,2,3,1,1,1,0,3,0,3,3,4,1,1,Arts,Bachelors,25-30,4,1,38,Flexible,Tier1_City,3,2,2,5,0,4,4,4.64,Education,4,2,4,2,1,0,2,1,2,3,1,0,3,3,42.9
Law,Human Resources Specialist,2.9663856538318583,1,1,4,0,1,1,2,4,1,3,3,1,0,1,Arts,Masters,40+,0,0,0,Office,Tier3_City,1,4,3,2,5,0,2,42.39,Other,2,5,5,5,3,1,4,5,2,4,1,1,4,3,55.38
Marketing,Microbiologist,4.895960776970682,9,0,4,1,6,0,4,3,4,2,1,0,1,1,Commerce,Bachelors,31-35,1,0,0,Hybrid,Tier2_City,2,5,5,1,4,3,4,30.43,Education,3,4,4,1,1,4,5,3,5,3,0,0,3,2,52.78
Music,Forensic Psychologist,3.071518163898756,8,0,3,0,0,0,0,0,3,3,3,1,0,1,Arts,Masters,25-30,4,0,0,Office,Tier1_City,4,3,5,4,4,0,5,5.25,Manufacturing,3,3,1,4,1,2,3,4,3,5,1,0,3,5,55.8
Business,School Psychologist,3.653899869314132,8,0,3,1,0,0,4,3,3,4,2,0,2,1,Commerce,Bachelors,18-24,6,0,0,Office,Tier3_City,4,3,2,5,3,1,1,31.92,Finance,3,1,4,1,0,3,2,1,2,4,1,0,1,4,58.36
Art,Pharmacist,4.256888093363568,5,2,4,0,1,1,1,1,2,3,3,4,0,1,Arts,PhD,25-30,2,0,0,Hybrid,Tier1_City,5,1,0,3,0,4,3,8.79,Other,4,3,2,2,2,3,4,3,5,3,1,1,5,2,55.89
Law,Risk Analyst,3.85126170491725,5,0,3,0,1,0,4,2,0,4,0,2,0,0,Arts,Masters,18-24,11,0,0,Office,Tier1_City,3,3,5,3,5,0,2,26.3,Finance,2,1,5,1,2,5,1,5,5,4,1,0,4,2,67.1
Psychology,Chemical Engineer,4.541303270219468,4,0,3,0,9,1,2,0,0,2,3,1,3,1,Arts,Bachelors,36-40,14,0,0,Hybrid,Tier1_City,1,1,5,4,3,4,4,34.46,Tech,2,4,3,5,1,4,3,2,2,4,1,0,5,4,55.1
Architecture,Physician Assistant,4.653098323540739,4,1,0,1,7,0,3,4,3,2,1,2,2,0,Interdisciplinary,Bachelors,31-35,0,0,0,Office,Tier1_City,4,5,3,2,4,0,4,9.98,Education,3,5,5,2,0,4,5,5,5,4,0,0,1,4,52.4
Marketing,Lawyer,2.6975203725078027,2,2,0,0,2,0,1,2,0,1,2,1,1,0,Commerce,Masters,25-30,10,1,19,Remote,Tier1_City,2,2,0,1,1,3,4,26.36,Education,1,3,5,5,2,5,3,1,2,5,1,1,3,2,54.97
Engineering,Aerospace Engineer,3.810299136828705,5,2,1,0,1,0,4,2,0,2,3,2,2,0,Science,Masters,25-30,11,0,0,Flexible,Tier2_City,4,2,0,5,0,3,3,24.5,Manufacturing,3,5,3,5,5,3,3,2,4,5,0,0,3,3,69.49
Law,Music Teacher,3.8849058807505545,0,2,1,0,3,0,1,1,3,4,1,1,1,0,Arts,Bachelors,36-40,1,1,32,Hybrid,Tier1_City,5,2,1,1,0,4,1,46.04,Other,4,4,3,5,2,3,5,5,1,2,0,0,5,4,33.78
Marketing,Special Education Teacher,4.77665685224501,8,0,0,0,0,0,1,3,1,1,4,4,0,1,Commerce,Masters,25-30,2,1,25,Hybrid,Tier1_City,4,5,1,5,5,5,5,49.8,Healthcare,1,5,1,2,4,2,2,1,5,2,0,0,3,1,55.25
Chemistry,Curriculum Developer,2.65676355050187,5,1,1,0,9,1,4,3,4,2,0,1,3,1,Science,Bachelors,18-24,11,0,0,Hybrid,Any,2,5,0,3,2,2,5,33.76,Tech,2,5,1,5,2,2,5,3,3,5,0,0,3,1,65.24
Medicine,Biochemist,4.041857564460892,4,1,2,1,1,1,4,0,3,0,1,2,0,1,Science,Bachelors,36-40,8,0,0,Hybrid,Tier3_City,4,4,4,1,5,2,2,43.18,Manufacturing,5,3,2,5,5,4,5,3,3,4,0,1,4,2,58.62
Marketing,Market Research Analyst,3.106851278755068,6,1,0,0,6,1,4,4,2,1,1,0,4,1,Commerce,Masters,36-40,7,0,0,Remote,Tier1_City,1,3,1,4,1,1,1,33.4,Finance,1,4,4,4,3,1,1,2,4,1,1,0,3,3,54.44
Law,Interior Designer,4.566068525316911,8,1,2,0,9,0,2,0,4,1,2,0,3,1,Arts,Masters,36-40,14,0,0,Remote,Tier3_City,1,5,5,2,1,5,1,44.19,Other,2,5,4,1,5,1,2,5,5,2,0,0,3,4,55.05
Physics,Pharmacist,2.6995291214090416,2,0,4,1,8,0,1,2,0,0,3,2,1,0,Science,Masters,18-24,3,0,0,Hybrid,Tier2_City,4,3,0,4,3,2,3,23.36,Healthcare,1,1,4,4,4,4,2,3,4,2,1,1,5,2,46.35
Music,Lawyer,3.259285523352505,2,2,3,1,8,1,0,3,4,3,1,2,1,0,Arts,Masters,18-24,7,0,0,Hybrid,Tier1_City,2,2,2,2,0,4,4,31.58,Tech,3,2,5,1,0,4,4,5,3,1,0,0,1,4,50.49
Music,Nurse,2.7988316325169165,5,2,3,1,7,1,3,0,1,4,4,2,3,0,Arts,Bachelors,18-24,12,0,0,Hybrid,Tier1_City,2,3,0,1,3,2,1,42.72,Other,1,1,5,2,5,0,4,3,4,1,0,0,3,1,56.74
Architecture,Market Research Analyst,2.978876294557078,5,2,2,0,4,0,1,4,3,2,4,4,3,0,Interdisciplinary,Masters,18-24,8,0,0,Remote,Any,4,4,0,1,1,1,4,46.15,Healthcare,1,5,3,4,4,1,1,1,2,2,1,0,4,3,64.2
Psychology,Biologist,3.228555904224532,4,1,0,1,1,0,3,1,4,1,3,3,2,0,Arts,Bachelors,31-35,2,0,0,Hybrid,Tier3_City,2,2,3,2,2,0,3,4.16,Finance,1,4,2,3,2,3,1,2,1,2,0,0,1,1,44.02
Education,Urban Planner,4.016291014622059,8,2,3,0,3,0,2,2,3,3,1,0,0,0,Arts,Bachelors,18-24,5,1,35,Remote,Tier3_City,1,3,1,3,0,2,2,7.89,Manufacturing,4,1,2,2,4,0,4,2,2,3,0,0,4,5,44.72
Music,Illustrator,3.533092424839153,9,2,1,1,9,0,4,2,1,0,4,1,1,0,Arts,Bachelors,31-35,7,0,0,Remote,Tier2_City,1,4,3,5,1,4,2,46.77,Manufacturing,4,4,4,2,0,0,4,4,5,3,1,1,5,1,56.83
Physics,Education Administrator,4.332798202726632,6,0,3,1,3,1,0,4,3,1,4,1,3,1,Science,Bachelors,25-30,9,0,0,Remote,Tier2_City,1,3,4,4,2,4,4,29.72,Education,3,1,3,1,1,5,2,3,3,4,0,0,1,4,56.61
Music,Accountant,2.883404144422002,6,2,2,1,1,1,2,1,1,2,3,2,0,1,Arts,Bachelors,25-30,6,0,0,Hybrid,Tier2_City,5,4,0,4,5,1,4,49.54,Other,5,4,4,1,3,4,4,3,5,2,0,0,2,5,54.62
Chemistry,Judge,4.165537789837308,5,0,1,1,3,1,0,0,1,3,3,0,2,1,Science,Bachelors,40+,8,0,0,Remote,Tier3_City,3,3,1,4,4,1,1,40.25,Manufacturing,4,5,5,5,1,2,5,4,4,2,1,1,4,1,48.1
Law,Risk Analyst,3.184822892731712,7,1,4,0,5,1,2,4,3,1,1,4,2,0,Arts,Bachelors,18-24,6,0,0,Remote,Tier3_City,1,2,1,1,1,3,3,41.45,Education,5,3,3,3,0,0,3,5,1,4,1,0,2,5,50.31
Education,Architect,3.4525262793208027,7,0,1,0,8,1,3,0,3,0,0,2,3,0,Arts,Bachelors,25-30,0,0,0,Hybrid,Tier1_City,4,2,5,4,4,3,2,21.15,Manufacturing,4,1,4,2,1,4,5,2,2,4,0,0,4,1,35.07
Law,Legal Secretary,4.483757772517492,3,0,3,1,3,0,3,4,2,3,4,2,2,0,Arts,Masters,25-30,8,0,0,Remote,Tier2_City,5,1,1,5,3,3,1,15.1,Tech,2,4,2,2,3,0,4,2,2,1,1,1,1,3,62.26
Computer Science,Biochemist,3.591108517398373,2,2,2,1,6,0,3,3,4,3,1,0,0,0,Science,Bachelors,18-24,11,0,0,Hybrid,Tier2_City,4,4,0,5,4,0,5,31.12,Other,2,1,1,4,0,5,3,2,1,2,1,0,4,1,55.14
Psychology,Composer,3.7478912435444416,9,0,0,1,5,1,4,2,2,0,2,4,4,1,Arts,Bachelors,25-30,4,0,0,Hybrid,Tier1_City,2,3,0,2,1,4,1,44.31,Finance,1,4,5,1,1,2,1,1,1,2,0,1,5,1,41.79
Medicine,Microbiologist,3.398384072315771,8,2,3,0,4,0,0,0,1,2,2,0,3,0,Science,Masters,25-30,5,0,0,Flexible,Tier2_City,3,3,5,1,4,3,4,37.11,Other,5,4,4,4,3,4,4,5,4,1,1,0,4,1,44.91
Marketing,Curriculum Developer,4.806920513619062,8,2,2,0,4,0,0,0,4,1,3,2,2,0,Commerce,Masters,31-35,1,0,0,Office,Any,5,3,2,5,0,4,5,25.19,Other,1,3,3,1,4,2,4,4,2,1,1,0,3,3,37.99
Architecture,Legal Secretary,3.925985132701247,5,0,1,0,3,1,1,2,0,0,0,3,1,0,Interdisciplinary,Masters,36-40,14,0,0,Flexible,Any,2,5,3,3,1,1,1,38.4,Healthcare,1,4,3,1,1,2,1,2,3,1,0,1,4,3,47.17
Marketing,Artist,4.3214851898484365,4,2,2,0,0,0,2,4,4,1,0,3,1,1,Commerce,Bachelors,25-30,1,0,0,Hybrid,Tier3_City,2,4,3,1,2,0,3,35.45,Finance,4,1,4,4,4,3,4,3,1,4,1,1,1,1,47.22
Chemistry,Web Developer,4.179988146077974,6,2,4,1,9,1,3,3,2,2,2,1,0,1,Science,Masters,18-24,12,1,47,Hybrid,Tier1_City,1,3,0,1,4,1,2,45.91,Finance,4,5,2,4,2,2,3,3,4,3,1,0,1,4,67.64
Art,Actuary,3.564719183220838,4,2,0,0,1,1,1,1,1,0,4,0,3,0,Arts,Bachelors,31-35,3,0,0,Flexible,Tier1_City,4,1,4,5,0,4,5,15.39,Education,1,2,4,4,5,2,1,5,1,2,0,1,5,3,31.04
Physics,Credit Analyst,4.6566227249188845,7,2,4,0,7,1,4,0,0,4,1,2,4,0,Science,Bachelors,18-24,3,0,0,Hybrid,Tier1_City,2,2,5,3,3,5,3,8.61,Education,4,4,5,1,4,2,1,1,5,3,0,0,5,5,47.0
Biology,Legal Consultant,3.464618399578857,1,0,2,1,8,1,2,2,0,1,0,0,3,0,Science,Bachelors,31-35,4,0,0,Hybrid,Tier2_City,2,5,1,2,3,5,1,25.09,Tech,2,2,3,3,4,1,2,4,1,1,1,1,3,5,32.78
Computer Science,Lawyer,3.1291077707535644,9,0,0,1,9,1,1,4,2,2,0,2,3,1,Science,Masters,31-35,6,1,48,Hybrid,Tier3_City,2,5,0,5,4,3,4,19.97,Healthcare,2,5,5,4,2,3,4,2,5,3,1,1,3,4,61.99
Medicine,Curriculum Developer,3.9700503661155744,7,0,0,0,6,0,1,0,2,4,4,1,0,0,Science,Bachelors,18-24,12,1,51,Hybrid,Any,3,2,0,3,3,5,4,48.82,Manufacturing,5,2,1,1,0,1,2,4,5,5,1,1,3,1,65.36
Art,Illustrator,3.574126387320245,7,1,3,0,9,1,3,4,2,3,0,3,1,0,Arts,Bachelors,36-40,10,1,51,Remote,Any,5,5,0,1,2,1,3,3.35,Manufacturing,2,4,2,4,5,2,3,4,3,5,1,1,1,3,67.17
Architecture,Aerospace Engineer,3.9338242831739887,3,1,4,0,4,0,0,3,2,2,1,3,0,0,Interdisciplinary,Bachelors,36-40,11,0,0,Office,Tier1_City,1,1,1,3,1,5,4,46.87,Finance,1,1,4,3,2,1,3,3,5,3,1,1,4,4,59.29
Architecture,Industrial-Organizational Psychologist,2.961976023989485,1,2,0,1,6,1,1,3,3,3,0,0,0,1,Interdisciplinary,Masters,36-40,14,1,33,Flexible,Tier1_City,5,1,1,1,0,2,2,47.89,Other,3,3,4,3,5,4,1,1,5,1,0,0,2,1,58.19
Physics,Forensic Psychologist,3.572502589034463,3,2,3,1,3,0,1,1,3,4,4,4,2,1,Science,Masters,25-30,0,0,0,Remote,Any,2,2,5,5,5,0,3,5.4,Tech,4,4,2,5,5,5,2,2,5,4,1,0,3,2,65.69
Medicine,Urban Planner,4.961835831775659,4,2,3,1,2,1,3,3,1,0,1,2,2,1,Science,Bachelors,25-30,9,0,0,Office,Tier3_City,3,4,0,5,4,4,3,44.81,Other,1,4,3,5,4,5,4,3,1,5,0,0,5,5,55.76
Education,Teacher,3.4009385119847284,5,2,2,0,1,0,2,3,1,1,1,0,0,0,Arts,Masters,36-40,3,0,0,Remote,Tier2_City,2,5,2,4,3,3,4,25.13,Healthcare,4,3,4,3,0,5,3,3,1,3,1,1,5,4,41.28
Physics,Financial Advisor,3.4699620176743613,6,0,1,0,6,1,4,4,0,4,1,1,2,0,Science,Bachelors,25-30,12,0,0,Remote,Tier2_City,4,3,3,4,1,1,3,39.01,Manufacturing,5,3,2,4,1,1,2,3,4,5,1,0,3,3,63.55
Music,Legal Secretary,4.7843301186489295,4,0,3,0,0,1,3,1,3,1,0,4,3,0,Arts,Masters,36-40,8,0,0,Office,Tier2_City,5,3,5,4,5,0,1,6.73,Finance,1,3,4,5,3,4,1,3,2,2,0,1,1,2,56.69
Law,Legal Consultant,4.01521080307947,8,2,4,0,9,1,2,0,1,0,3,2,4,0,Arts,Bachelors,18-24,7,0,0,Remote,Tier2_City,1,1,2,5,2,3,5,47.89,Tech,1,3,3,1,0,0,5,4,3,4,1,0,5,2,46.62
Finance,Risk Analyst,3.2879991132920017,7,0,1,0,7,1,3,2,0,3,3,2,3,1,Commerce,Masters,18-24,2,1,45,Hybrid,Tier1_City,3,4,2,2,3,1,5,31.55,Healthcare,1,3,2,3,5,3,1,1,1,1,1,0,2,2,44.04
Marketing,Astronomer,3.3030697468264503,3,0,4,0,6,1,1,1,2,2,0,4,3,1,Commerce,Bachelors,31-35,5,1,17,Remote,Tier2_City,5,4,0,5,3,5,4,45.24,Other,5,4,3,4,4,5,1,4,4,2,1,0,4,1,48.31
Art,Electrical Engineer,3.1409711084224377,2,2,2,1,0,1,3,2,0,3,3,3,2,1,Arts,Masters,31-35,10,0,0,Hybrid,Tier2_City,2,5,1,3,0,4,2,34.63,Finance,1,2,4,1,1,1,2,1,4,1,1,1,5,5,58.76
Medicine,Advertising Manager,3.881728424318713,1,0,2,1,8,1,1,0,4,4,1,4,0,0,Science,High School,31-35,8,0,0,Hybrid,Tier1_City,1,5,3,5,2,2,2,28.23,Finance,4,1,2,3,0,0,5,1,3,2,0,1,2,3,53.12
Engineering,Interior Designer,4.062361972104203,7,2,4,0,0,1,3,3,3,0,0,4,2,0,Science,Bachelors,36-40,7,1,31,Flexible,Any,3,2,2,5,2,2,4,11.11,Other,3,4,1,3,3,2,4,2,4,5,0,1,4,3,57.05
Music,Ecologist,4.658494331853372,5,2,0,0,3,0,3,1,1,1,0,2,3,1,Arts,Bachelors,18-24,6,1,18,Office,Tier1_City,2,1,4,1,4,5,4,11.36,Tech,1,5,4,4,5,4,1,4,1,1,0,0,1,1,38.66
Chemistry,Lawyer,4.509590925833283,9,1,3,1,4,0,1,1,4,2,3,3,1,0,Science,Bachelors,18-24,6,0,0,Remote,Tier2_City,2,2,1,1,5,4,3,25.21,Tech,5,4,2,4,4,5,1,5,5,1,0,0,2,4,60.02
Business,Legal Secretary,3.832360308098017,6,0,3,1,2,0,3,4,3,0,4,4,2,0,Commerce,Bachelors,36-40,0,0,0,Hybrid,Tier2_City,5,2,5,1,0,0,2,43.91,Tech,5,4,1,2,2,1,5,1,1,4,1,0,3,1,48.71
Finance,AI Researcher,2.649248505984861,6,1,2,1,6,0,2,3,2,3,3,0,0,1,Commerce,Masters,18-24,14,0,0,Flexible,Tier2_City,2,4,1,5,4,4,5,8.42,Tech,1,2,2,4,5,0,4,5,4,2,0,0,4,1,68.03
Education,Architect,3.185364395015383,1,1,1,0,3,0,3,3,1,4,2,3,3,0,Arts,Bachelors,31-35,4,0,0,Office,Tier1_City,2,5,3,2,0,5,4,49.92,Healthcare,5,3,5,1,3,5,1,3,2,1,1,0,1,1,41.11
Art,Urban Planner,2.5568900730684945,3,0,3,0,3,1,1,1,0,2,0,2,2,0,Arts,Masters,25-30,6,0,0,Hybrid,Tier2_City,3,3,3,3,2,1,5,44.17,Tech,2,5,5,5,3,0,1,1,2,5,1,0,5,2,46.78
Physics,Art Therapist,3.2414429885379783,6,2,2,1,6,0,3,1,3,4,3,1,0,1,Science,Masters,18-24,13,0,0,Hybrid,Tier1_City,2,2,3,3,0,0,5,21.45,Tech,5,2,2,4,3,3,2,1,5,1,0,0,1,2,67.34
Computer Science,Physician Assistant,4.264566646206849,5,0,1,0,5,0,3,4,1,0,0,4,4,1,Science,Masters,25-30,12,0,0,Hybrid,Tier1_City,4,1,0,2,0,2,2,14.9,Tech,3,1,2,4,3,2,2,4,4,2,1,0,2,2,56.32
Law,Conductor,3.946387988117505,9,2,0,0,1,1,3,3,3,3,3,2,4,1,Arts,Masters,25-30,1,0,0,Hybrid,Tier1_City,4,2,1,2,0,5,5,46.33,Healthcare,2,5,5,5,1,3,3,1,5,1,1,0,3,1,55.72
Medicine,Interior Designer,4.770159565709674,3,0,4,0,5,0,4,3,1,1,1,1,3,0,Science,Masters,36-40,14,1,43,Office,Tier1_City,1,3,0,3,1,1,3,8.79,Manufacturing,4,5,4,5,5,1,2,5,5,4,1,1,3,2,65.89
Finance,Lawyer,2.917616759207498,1,2,2,0,4,1,3,3,4,4,4,1,0,1,Commerce,Bachelors,31-35,5,0,0,Remote,Any,4,3,0,4,1,5,3,19.32,Finance,2,2,5,3,5,2,4,1,5,4,1,0,5,1,64.0
Engineering,Advertising Manager,3.706987391236126,2,1,0,1,4,1,1,1,3,3,4,2,1,0,Science,Masters,31-35,13,0,0,Flexible,Tier2_City,4,1,0,1,5,3,2,6.94,Education,3,5,5,3,0,1,3,2,2,2,1,0,2,5,61.72
Chemistry,Music Therapist,4.152897303172638,6,2,0,1,5,1,4,1,3,0,3,3,2,1,Science,Bachelors,25-30,1,1,18,Remote,Tier1_City,5,3,1,1,5,3,3,47.81,Other,2,4,5,5,3,4,2,2,3,4,1,1,4,2,53.82
Psychology,Zoologist,2.715753402215114,9,0,1,1,1,1,4,0,4,0,0,4,0,0,Arts,Masters,25-30,2,0,0,Hybrid,Any,4,3,5,3,2,3,4,32.03,Finance,1,4,3,5,3,1,5,4,4,4,0,0,2,4,54.76
Marketing,Inorganic Chemist,4.839161857754966,5,1,4,1,5,0,4,0,1,0,1,2,0,1,Commerce,Masters,18-24,0,0,0,Remote,Tier1_City,2,3,4,2,0,2,2,18.8,Healthcare,5,3,4,5,4,5,2,2,5,5,0,1,5,5,50.64
Music,Pharmacist,2.5901564309523,0,2,2,0,9,1,0,4,3,3,0,2,3,0,Arts,Bachelors,25-30,2,0,0,Hybrid,Tier1_City,5,2,2,4,2,4,5,15.95,Other,1,2,3,1,2,2,2,1,5,5,1,1,5,3,49.94
Biology,Chemist,4.608980024303504,3,1,3,0,9,1,1,3,2,1,1,4,0,0,Science,Bachelors,18-24,14,1,21,Hybrid,Tier1_City,4,1,1,3,1,0,4,23.87,Tech,1,4,4,2,4,1,2,2,1,2,0,0,3,4,50.82
Chemistry,Illustrator,2.502808830640106,9,2,4,1,4,0,4,2,0,4,0,4,2,1,Science,Bachelors,18-24,6,1,23,Remote,Tier3_City,2,2,1,1,0,2,2,7.29,Healthcare,1,5,3,1,0,3,1,3,1,2,0,0,4,4,43.5
Business,Legal Secretary,4.549595981246167,9,0,1,0,0,1,2,0,1,1,3,2,3,0,Commerce,Masters,25-30,4,0,0,Flexible,Tier2_City,1,1,3,5,4,1,5,44.8,Manufacturing,2,5,3,2,1,0,5,4,1,2,0,1,2,2,42.45
Biology,Music Teacher,3.673387540896644,1,0,4,0,8,0,0,3,4,2,3,4,2,1,Science,PhD,25-30,3,1,15,Hybrid,Tier1_City,5,3,2,2,1,1,5,27.01,Education,4,4,2,3,2,1,3,1,4,1,0,1,1,2,56.61
Marketing,Brand Manager,3.831193402402133,2,2,4,0,6,1,0,1,4,2,1,3,2,0,Commerce,Bachelors,18-24,14,0,0,Hybrid,Tier1_City,2,3,3,5,1,3,5,37.08,Manufacturing,5,2,5,5,5,2,1,2,3,5,0,0,3,1,62.97
Marketing,Acoustics Specialist,2.650848985311114,5,1,1,0,1,1,0,2,3,4,4,0,3,0,Commerce,Masters,25-30,14,1,37,Hybrid,Tier2_City,5,5,4,3,1,0,5,13.99,Tech,2,2,2,1,4,3,5,3,4,5,1,0,1,3,67.42
Music,Construction Manager,3.3045945996438806,5,1,2,0,6,1,0,2,1,1,4,0,2,1,Arts,PhD,25-30,12,1,13,Remote,Tier2_City,1,3,5,1,0,3,5,26.68,Healthcare,1,1,2,5,4,5,3,2,4,5,0,1,1,4,67.63
Medicine,Mechanical Engineer,3.436364652738031,9,1,3,1,6,1,0,4,3,1,2,4,4,1,Science,Bachelors,18-24,11,0,0,Hybrid,Tier3_City,1,1,0,4,5,1,2,12.92,Healthcare,3,2,2,5,5,2,2,2,2,2,0,1,1,2,61.33
Computer Science,Counselor,3.8138184505596606,1,2,4,0,2,1,4,2,4,3,2,2,2,0,Science,Bachelors,36-40,7,1,53,Hybrid,Tier2_City,5,4,3,5,3,1,3,41.36,Tech,3,4,1,5,1,4,1,2,4,2,1,0,2,4,64.21
Biology,Fluid Mechanics Engineer,4.2383396822946,0,0,2,0,6,0,1,1,1,2,2,4,1,0,Science,Masters,18-24,7,0,0,Hybrid,Tier2_City,2,1,4,4,4,4,5,39.44,Tech,1,1,4,1,5,0,3,1,1,4,1,0,1,4,50.64
Art,Lawyer,4.051605542306714,3,1,0,0,0,0,4,2,3,0,2,0,1,0,Arts,Masters,36-40,0,0,0,Flexible,Tier3_City,3,3,2,1,4,4,4,9.97,Education,4,5,2,5,1,3,2,4,1,4,1,0,1,1,46.87
Education,Graphic Designer,3.0077699860729097,7,0,3,1,5,1,3,2,3,4,0,3,3,1,Arts,Masters,18-24,8,1,32,Remote,Tier2_City,5,3,0,5,2,4,2,6.5,Manufacturing,5,4,2,3,5,0,1,3,5,3,0,0,1,5,62.85
Music,Accountant,3.4445404996091336,6,0,0,0,1,1,1,2,2,1,1,3,1,0,Arts,Bachelors,36-40,13,0,0,Hybrid,Tier1_City,3,4,4,4,0,3,1,41.74,Tech,2,3,1,2,2,1,3,4,5,5,1,1,5,1,59.12
Medicine,Sound Engineer,2.764777430408174,5,2,4,0,4,0,1,2,4,1,2,2,2,1,Science,Bachelors,18-24,8,0,0,Remote,Tier1_City,2,3,3,4,5,5,3,8.15,Tech,4,3,1,4,3,0,3,4,1,4,0,1,1,4,57.25
Business,Animator,4.945143948412923,4,2,0,1,7,1,4,4,4,4,3,4,0,1,Commerce,Bachelors,31-35,1,0,0,Hybrid,Tier2_City,4,5,4,5,1,0,4,28.78,Manufacturing,3,2,5,3,1,1,1,5,4,4,0,0,3,5,63.84
Computer Science,Animator,3.626364399205293,2,0,1,0,4,1,3,4,4,3,2,3,0,1,Science,Bachelors,25-30,1,1,42,Hybrid,Tier3_City,5,4,4,1,3,4,5,28.12,Tech,1,1,2,2,4,5,1,3,4,5,1,1,1,5,61.64
Biology,Lawyer,3.44113208765002,9,2,4,0,0,1,0,1,0,2,3,1,3,0,Science,Bachelors,31-35,7,1,32,Remote,Tier1_City,1,2,0,4,0,2,2,12.54,Other,2,1,4,4,4,3,3,1,3,1,1,1,4,3,38.77
Business,Zoologist,4.149052845651589,6,2,1,0,8,0,0,3,1,0,3,2,4,1,Commerce,Masters,25-30,11,0,0,Hybrid,Tier2_City,4,5,1,3,0,4,2,30.79,Education,4,5,2,5,3,2,4,1,4,2,1,0,2,2,54.23
Education,Dentist,2.9594272682307805,4,1,1,0,5,0,2,0,0,2,0,2,0,0,Arts,Bachelors,18-24,10,0,0,Hybrid,Tier1_City,2,1,4,5,5,3,5,26.63,Education,4,2,5,3,3,3,2,5,2,1,1,0,1,5,42.54
Law,Paralegal,4.7123410500721326,3,0,1,0,3,1,0,0,0,4,3,4,2,0,Arts,Masters,31-35,5,1,50,Flexible,Tier1_City,1,5,0,2,3,0,4,26.93,Manufacturing,4,1,2,4,1,2,3,5,2,1,0,1,5,5,47.01
Art,Art Director,2.889050613485594,5,0,0,0,3,1,3,4,1,4,1,2,4,1,Arts,Bachelors,18-24,2,0,0,Hybrid,Tier1_City,5,5,5,2,1,4,2,19.91,Finance,2,4,1,4,3,5,1,5,4,3,1,0,3,2,48.94
Art,Quantum Physicist,4.723800896798529,4,0,0,0,4,0,4,3,3,0,3,2,4,1,Arts,Masters,36-40,11,1,31,Remote,Tier1_City,2,3,5,1,0,0,3,42.41,Education,5,5,1,4,4,2,3,5,5,5,1,1,3,3,71.35
Physics,Music Teacher,4.570077578096476,4,0,4,1,6,1,3,2,0,3,3,0,4,1,Science,Bachelors,18-24,1,1,59,Remote,Tier2_City,5,2,0,3,4,2,4,6.97,Healthcare,2,1,5,5,1,0,1,1,5,1,1,1,5,5,46.59
Medicine,Surgeon,3.928318374212074,9,0,1,0,0,0,0,2,4,1,3,0,0,0,Science,Bachelors,25-30,4,0,0,Remote,Tier1_City,4,4,2,4,4,1,5,23.62,Healthcare,1,3,5,2,2,2,2,1,5,1,0,0,5,3,47.52
Engineering,Zoologist,2.8679167651700177,8,0,0,1,8,1,3,4,1,3,0,0,1,0,Science,Bachelors,31-35,14,0,0,Remote,Tier2_City,5,5,2,2,3,0,4,15.21,Finance,2,3,1,2,0,4,1,2,2,1,0,0,1,3,46.76
Chemistry,Marketing Specialist,3.431745035977012,5,2,2,1,4,1,2,4,2,3,2,4,4,0,Science,PhD,25-30,7,0,0,Office,Tier1_City,1,3,1,1,1,5,4,42.88,Education,4,1,1,3,1,4,1,4,1,1,1,0,2,5,57.39
Engineering,Entrepreneur,4.95592504430103,3,2,1,1,7,1,2,0,2,0,2,0,0,1,Science,Masters,18-24,5,0,0,Flexible,Tier2_City,5,5,3,3,3,4,1,13.58,Tech,5,3,2,5,5,0,4,4,3,3,0,0,1,2,46.31
Computer Science,Teacher,4.52332022854294,3,1,4,0,6,1,3,2,0,0,2,3,0,0,Science,Bachelors,31-35,11,0,0,Remote,Tier1_City,4,2,4,3,0,3,5,39.05,Other,5,4,5,2,2,0,1,4,5,3,0,0,5,3,56.81
Biology,Accountant,3.555202842663891,2,1,0,0,0,0,0,2,1,2,0,0,3,1,Science,Bachelors,31-35,2,1,54,Hybrid,Tier1_City,4,4,4,1,4,5,3,31.74,Finance,1,5,2,3,4,3,5,4,4,5,1,0,2,2,42.69
Medicine,Music Teacher,4.403004725677069,8,1,0,1,5,1,3,3,1,1,1,4,2,0,Science,PhD,36-40,11,1,20,Hybrid,Tier2_City,1,3,0,1,2,5,5,44.12,Tech,1,4,1,2,1,4,5,1,1,1,1,1,1,4,56.91
Business,Nurse,4.78513998827922,0,2,1,0,3,1,0,3,2,4,2,3,1,1,Commerce,Bachelors,25-30,11,0,0,Hybrid,Tier2_City,3,5,0,4,3,3,1,30.91,Other,3,3,4,1,1,5,4,1,3,4,0,1,3,5,60.97
Education,Education Administrator,3.5484163267481064,6,1,3,1,1,1,3,2,2,4,0,1,4,1,Arts,Bachelors,25-30,8,1,30,Remote,Tier3_City,3,2,0,1,2,3,5,29.15,Healthcare,3,1,5,5,1,4,2,5,1,1,1,0,4,1,45.88
Business,Biologist,4.807753355676284,5,1,3,1,7,1,3,2,3,0,3,1,3,1,Commerce,Masters,25-30,7,0,0,Flexible,Tier1_City,5,1,5,4,2,3,5,40.65,Other,3,1,2,1,3,2,2,1,4,5,0,1,3,5,59.62
Physics,Industrial-Organizational Psychologist,3.4478130840037715,9,1,0,0,3,0,2,0,1,2,1,2,2,1,Science,PhD,25-30,9,0,0,Office,Tier2_City,4,1,2,4,5,5,3,29.44,Finance,2,5,5,2,3,3,1,1,1,4,0,1,4,2,56.04
Finance,Software Developer,4.412006572657159,5,0,0,0,0,0,4,3,0,0,0,4,4,0,Commerce,High School,31-35,5,0,0,Flexible,Tier1_City,2,2,5,5,4,0,1,42.69,Education,5,3,4,2,4,3,4,2,3,5,0,0,3,5,49.14
Music,Software Developer,4.295490868953333,7,0,0,0,8,0,1,1,3,0,3,1,2,0,Arts,Bachelors,25-30,0,1,58,Remote,Tier2_City,2,4,5,3,3,3,5,5.32,Healthcare,1,3,3,1,2,3,4,3,4,5,0,0,3,4,45.61
Art,Lawyer,4.725524750087769,5,0,1,1,9,1,3,4,1,4,0,4,1,1,Arts,PhD,25-30,1,0,0,Hybrid,Tier1_City,4,5,0,3,2,1,5,26.27,Education,3,3,1,5,1,1,4,5,2,1,0,1,5,3,54.11
Biology,Animator,4.3415526842552215,7,1,2,1,1,0,2,2,2,3,2,3,0,1,Science,Bachelors,25-30,3,0,0,Office,Tier3_City,2,5,1,3,0,5,2,41.2,Tech,1,2,4,3,0,2,5,5,1,2,1,1,5,1,42.93
Engineering,Marketing Manager,3.383992045694839,1,2,4,1,5,0,0,2,4,1,2,2,3,0,Science,Bachelors,31-35,1,0,0,Office,Tier2_City,1,2,0,5,5,5,5,42.87,Education,3,1,3,4,0,0,2,2,4,2,1,0,5,2,46.21
Biology,Financial Advisor,3.9322000433117847,2,1,2,0,9,0,1,2,4,4,2,3,0,1,Science,Masters,36-40,2,0,0,Remote,Tier3_City,5,5,3,4,1,5,3,42.2,Other,2,3,2,1,0,5,5,3,1,1,0,0,4,2,43.62
Law,Inorganic Chemist,4.479705323521014,3,2,4,0,9,1,3,2,2,2,4,3,3,1,Arts,Masters,31-35,13,0,0,Flexible,Any,4,4,5,4,5,2,2,31.41,Finance,2,5,4,5,3,3,2,1,4,3,0,1,2,1,72.7
Psychology,Legal Analyst,2.87660352271937,7,2,3,0,3,0,1,0,4,0,3,3,2,1,Arts,Bachelors,25-30,7,0,0,Flexible,Any,5,2,0,1,1,0,1,49.72,Tech,4,2,3,5,4,2,3,5,5,4,0,1,2,5,57.42
Art,Landscape Architect,3.3373632278784204,2,1,0,0,1,0,3,0,0,1,2,2,2,1,Arts,PhD,31-35,8,1,48,Remote,Tier2_City,1,1,4,5,4,0,4,11.53,Finance,1,3,4,4,1,5,1,3,1,3,1,0,5,1,52.94
Computer Science,Investment Banker,4.615389871943564,7,1,2,1,9,1,2,0,0,4,0,0,2,0,Science,Masters,31-35,5,0,0,Hybrid,Any,2,1,4,1,3,3,3,11.2,Other,4,1,3,3,4,2,3,4,5,4,1,1,1,2,51.19
Biology,Paralegal,2.508797222444942,2,0,2,0,4,1,4,0,2,1,1,2,0,0,Science,Bachelors,18-24,3,0,0,Hybrid,Tier1_City,4,3,0,5,3,5,1,4.54,Tech,2,2,2,3,3,2,1,5,5,1,1,0,4,5,43.48
Education,Human Resources Specialist,4.984858764282017,6,0,1,0,7,1,1,1,1,1,0,0,4,1,Arts,PhD,18-24,10,0,0,Flexible,Tier1_City,1,1,4,1,1,5,2,49.5,Finance,2,4,2,2,1,4,1,3,2,2,0,1,4,2,44.16
Chemistry,Geneticist,3.802917551759616,9,2,1,1,6,1,2,1,1,4,0,2,2,1,Science,Bachelors,18-24,1,1,12,Office,Tier2_City,1,5,0,2,0,3,4,19.36,Healthcare,1,5,2,2,1,5,4,4,5,2,0,1,5,2,36.83
Business,Software Developer,3.3566660647614004,1,2,0,0,1,1,3,0,2,1,2,1,3,1,Commerce,Bachelors,25-30,6,0,0,Remote,Any,5,4,5,3,1,0,1,38.82,Finance,4,1,2,1,5,0,5,4,1,5,1,0,5,4,43.98
Music,Principal,4.929394948880587,1,2,3,0,2,1,2,2,3,0,0,2,3,0,Arts,Masters,36-40,9,1,6,Remote,Tier3_City,4,4,0,3,1,3,3,5.81,Healthcare,4,4,2,3,4,3,5,1,1,2,1,1,5,3,46.44
Psychology,Legal Analyst,4.914896375694694,6,2,0,0,4,0,3,3,4,0,0,0,4,0,Arts,Bachelors,25-30,10,1,48,Remote,Tier1_City,5,3,5,4,3,3,2,17.04,Other,4,1,3,1,0,0,2,3,3,4,1,1,3,3,54.24
Education,School Psychologist,2.880651162798795,8,2,4,1,5,0,4,4,0,0,4,4,3,1,Arts,Bachelors,25-30,6,1,42,Remote,Tier2_City,5,5,2,2,2,3,3,32.32,Manufacturing,1,5,2,2,0,0,4,5,5,2,1,0,4,1,56.31
Music,Data Scientist,4.0131162128759135,8,1,0,1,9,0,3,3,3,1,2,4,4,1,Arts,High School,36-40,9,1,11,Remote,Tier1_City,1,2,5,3,0,3,3,27.66,Education,1,3,4,1,5,4,5,5,2,2,0,0,5,5,51.89
Architecture,Digital Marketing Specialist,4.5214143271404135,1,1,0,1,8,1,3,0,2,4,1,0,4,1,Interdisciplinary,Bachelors,36-40,8,0,0,Hybrid,Tier2_City,5,3,2,4,3,3,2,12.76,Tech,1,4,4,4,2,0,2,3,4,2,0,1,3,2,51.0
Medicine,Animator,3.392145056918232,9,0,2,0,3,0,4,3,1,4,1,3,2,1,Science,Masters,31-35,4,0,0,Office,Tier1_City,2,5,4,2,5,4,5,24.69,Education,5,4,2,1,2,0,2,2,4,3,1,1,1,3,58.68
Physics,Accountant,4.603206824244118,7,1,3,1,4,0,4,2,1,0,1,2,0,0,Science,Masters,25-30,9,0,0,Hybrid,Tier1_City,2,2,4,3,1,4,3,8.11,Other,2,2,4,2,4,2,2,2,4,3,0,0,5,1,56.12
Biology,Teacher,3.2546991502104263,7,1,2,1,5,0,1,4,3,3,0,0,3,0,Science,PhD,18-24,3,1,30,Hybrid,Tier1_City,1,1,1,1,2,5,2,28.51,Healthcare,5,3,2,2,5,2,5,1,2,3,0,0,4,5,47.6
Business,AI Researcher,3.1089732462659434,2,1,1,1,2,0,3,0,0,3,3,4,0,0,Commerce,Bachelors,18-24,9,1,30,Remote,Tier3_City,5,1,5,5,0,5,3,7.56,Healthcare,5,5,4,4,1,3,1,1,2,4,1,1,4,5,55.03
Biology,School Counselor,3.780400845129844,8,1,3,1,7,0,2,1,4,3,2,3,4,1,Science,Bachelors,18-24,5,1,8,Hybrid,Tier2_City,2,2,5,2,4,4,5,32.89,Healthcare,2,2,5,4,3,1,4,2,3,4,0,1,1,5,59.86
Business,Doctor,4.118170992228078,5,2,1,1,9,1,4,1,1,3,0,3,0,1,Commerce,Bachelors,25-30,11,0,0,Office,Tier1_City,3,3,1,4,0,0,2,10.3,Finance,3,4,1,3,3,3,4,4,3,1,1,1,5,1,48.42
Music,Animator,4.592283492265208,4,2,2,0,0,1,1,3,3,0,3,1,1,1,Arts,Bachelors,25-30,1,0,0,Hybrid,Tier2_City,3,2,0,2,0,2,1,28.71,Education,3,1,4,4,2,3,2,4,4,4,1,0,4,2,44.83
Music,Legal Secretary,2.6186511686334093,4,1,3,0,3,0,4,0,1,2,0,0,0,0,Arts,Bachelors,18-24,1,0,0,Hybrid,Tier3_City,5,5,1,4,1,0,1,9.07,Healthcare,3,5,4,4,2,2,2,2,5,1,0,1,2,1,34.66
Business,Quantum Physicist,2.532665211370416,0,1,1,0,7,1,2,0,4,3,2,0,4,0,Commerce,Masters,18-24,11,0,0,Remote,Any,1,2,3,2,1,5,1,21.83,Manufacturing,1,2,1,3,3,0,2,5,2,5,1,0,4,1,62.72
Medicine,Architect,2.5461098023912325,0,0,1,0,6,0,1,1,3,3,0,4,3,1,Science,PhD,18-24,8,0,0,Hybrid,Any,2,5,2,4,4,4,4,19.54,Other,1,3,5,4,5,4,2,2,5,5,1,0,3,4,73.84
Medicine,Physicist,4.734526763551687,4,0,3,1,3,1,0,1,0,1,3,3,4,1,Science,PhD,31-35,6,0,0,Office,Tier1_City,4,5,5,3,4,0,3,38.55,Healthcare,4,1,1,5,0,5,2,5,3,3,1,0,2,4,56.58
Finance,Paralegal,3.395739829252593,7,1,1,1,7,0,4,1,4,1,0,3,4,0,Commerce,Bachelors,31-35,6,1,26,Hybrid,Tier1_City,4,1,4,1,4,2,3,33.13,Education,4,2,4,5,4,3,2,5,5,2,0,1,2,5,56.44
Business,Chemist,3.649795526616836,1,2,4,1,7,0,2,3,1,1,4,3,2,0,Commerce,Masters,25-30,12,0,0,Remote,Tier1_City,2,5,1,3,3,3,2,47.04,Healthcare,5,5,2,5,2,1,4,4,1,3,1,1,1,4,62.33
Education,Musician,4.511973123107234,6,0,4,1,2,1,2,4,0,1,4,4,0,0,Arts,Bachelors,25-30,4,0,0,Office,Tier2_City,5,4,3,1,3,1,4,46.33,Healthcare,4,1,5,4,2,3,2,4,2,1,1,1,1,2,47.27
Art,Accountant,4.271021195549048,3,2,4,1,2,0,4,2,2,3,1,2,0,1,Arts,Bachelors,25-30,6,0,0,Remote,Tier2_City,3,1,1,3,1,4,3,37.07,Tech,1,2,4,2,3,0,1,4,2,4,0,0,2,2,53.71
Art,Biochemist,3.8363802925456696,7,0,3,0,2,0,1,0,4,3,3,1,1,1,Arts,Masters,18-24,8,0,0,Hybrid,Tier1_City,3,1,4,3,1,4,2,39.22,Healthcare,5,2,2,2,0,3,3,5,4,4,1,1,3,4,57.92
Business,Animator,4.026394131872326,6,2,4,1,5,1,1,0,2,3,4,4,3,0,Commerce,Masters,18-24,9,1,39,Remote,Any,2,2,1,2,4,2,5,32.37,Education,4,5,2,3,3,0,5,5,4,1,0,1,5,3,65.01
Finance,Marketing Manager,3.100359434924103,0,0,2,0,8,1,3,3,2,3,0,1,2,1,Commerce,Bachelors,36-40,4,0,0,Flexible,Tier3_City,3,5,2,5,3,3,3,35.51,Other,4,3,5,2,2,0,5,1,4,5,0,0,2,5,51.86
Biology,Credit Analyst,2.5206107715699804,9,2,1,1,8,1,1,0,4,4,3,4,3,0,Science,Bachelors,40+,8,0,0,Office,Tier2_City,2,2,5,4,2,3,3,32.01,Tech,3,1,4,2,5,4,4,2,1,3,0,0,1,5,56.76
Medicine,Geneticist,2.8516241055360423,5,0,0,1,2,1,2,1,3,0,3,3,2,1,Science,Bachelors,31-35,0,0,0,Hybrid,Tier2_City,1,5,1,4,3,1,5,17.65,Tech,1,2,3,3,3,4,5,4,4,1,0,0,5,5,43.58
Physics,Surgeon,4.530205757936036,4,0,4,1,8,0,4,1,2,1,3,3,2,1,Science,Masters,36-40,12,1,48,Office,Tier2_City,3,1,3,4,1,3,5,19.48,Healthcare,5,5,2,5,4,5,2,3,4,5,0,1,2,5,73.1
Computer Science,Ecologist,2.8708945605277894,4,2,0,1,0,0,0,4,3,2,1,4,3,1,Science,Bachelors,31-35,14,0,0,Hybrid,Tier2_City,5,4,5,1,3,2,3,30.01,Healthcare,2,2,1,3,2,5,1,3,2,3,1,1,5,2,55.44
Psychology,Physician Assistant,4.772869560498667,1,1,2,0,8,0,0,4,4,4,3,1,4,0,Arts,PhD,18-24,11,0,0,Remote,Any,3,1,1,4,1,5,5,36.85,Manufacturing,4,5,3,2,2,3,4,5,5,1,0,1,4,2,65.41
Physics,Physician Assistant,3.190979928157116,5,0,2,1,8,1,2,2,2,1,4,1,0,0,Science,Bachelors,40+,2,0,0,Office,Tier1_City,2,3,4,4,4,3,2,22.09,Education,1,5,1,2,2,5,4,1,2,4,0,1,1,5,46.52
Art,Zoologist,3.870355213574008,0,0,4,0,4,1,0,0,3,1,2,4,0,0,Arts,Bachelors,18-24,6,0,0,Hybrid,Tier2_City,4,2,1,2,4,5,3,9.71,Other,5,2,5,3,2,4,1,2,5,2,1,0,3,3,53.52
Law,Landscape Architect,4.504541573036149,4,2,3,0,8,0,1,4,1,0,0,4,3,1,Arts,Bachelors,31-35,3,1,47,Hybrid,Tier1_City,3,4,3,3,4,5,3,24.59,Education,1,5,2,4,2,1,2,5,2,2,1,0,4,1,42.42
Business,Physician Assistant,4.475568406265729,1,1,0,1,8,1,0,3,2,4,2,4,4,0,Commerce,Bachelors,25-30,14,0,0,Remote,Tier2_City,2,2,1,4,2,2,1,48.27,Finance,1,1,2,2,1,2,4,2,1,4,0,1,5,5,58.57
Education,Interior Designer,3.9213414342330513,2,1,3,0,5,1,3,1,2,1,3,0,2,0,Arts,Bachelors,25-30,1,0,0,Remote,Tier2_City,3,5,0,5,2,4,3,13.06,Other,5,5,5,2,1,5,1,5,5,2,0,1,4,2,40.55
Biology,Judge,4.047460557963639,7,1,3,1,3,1,1,2,3,3,0,3,1,0,Science,Masters,31-35,11,0,0,Hybrid,Tier1_City,3,2,4,4,1,4,1,33.51,Finance,3,3,2,3,3,3,2,4,1,1,0,0,2,2,50.48
Art,Special Education Teacher,3.8461270674284576,6,2,0,0,5,1,0,1,2,2,4,1,1,0,Arts,Masters,25-30,13,1,8,Hybrid,Tier1_City,3,1,0,1,0,4,5,49.18,Education,3,3,3,2,5,5,1,1,2,4,0,0,2,1,55.03
Music,Forensic Psychologist,3.245101610809717,9,1,1,1,9,0,0,1,2,2,1,4,3,1,Arts,PhD,25-30,2,0,0,Remote,Tier1_City,4,1,5,1,5,0,5,20.68,Healthcare,4,5,3,4,1,4,2,4,3,4,1,1,2,1,53.21
Engineering,Landscape Architect,2.7231840001798484,5,1,2,1,9,0,1,4,4,3,2,4,3,1,Science,Masters,25-30,6,1,29,Remote,Tier1_City,2,2,0,1,2,4,2,44.73,Tech,3,1,5,4,2,1,5,4,1,2,1,1,4,3,58.13
Chemistry,Nuclear Physicist,2.6373191014930084,7,0,4,0,0,1,1,1,1,2,4,4,4,1,Science,Masters,25-30,7,0,0,Hybrid,Tier2_City,1,5,5,4,1,2,1,43.61,Manufacturing,4,4,4,3,2,2,1,3,4,2,0,1,1,2,53.75
Psychology,Curriculum Developer,3.872076162527426,3,1,0,1,4,1,4,3,3,1,4,4,4,1,Arts,Masters,40+,10,1,45,Remote,Any,5,5,5,2,3,1,3,18.94,Healthcare,4,4,2,1,2,5,2,3,3,4,0,1,3,1,74.24
Physics,Artist,4.612721149585683,9,0,2,1,3,1,0,4,2,1,4,0,1,1,Science,Masters,31-35,8,1,33,Hybrid,Tier1_City,4,4,4,5,4,3,1,7.63,Other,5,1,3,5,1,1,3,3,2,1,0,1,5,2,52.8
Finance,Investment Banker,4.739454127600439,5,2,4,1,5,1,2,3,1,4,2,4,3,0,Commerce,Bachelors,25-30,5,0,0,Hybrid,Tier1_City,5,1,4,4,4,4,5,11.39,Other,1,3,1,4,1,5,5,3,3,5,1,1,1,3,62.53
Medicine,Brand Manager,2.717490250643903,3,2,3,0,2,1,4,0,3,2,4,2,2,1,Science,Bachelors,18-24,9,0,0,Hybrid,Tier2_City,5,2,3,2,4,0,5,20.19,Tech,2,5,2,4,5,3,4,5,1,1,1,0,5,2,53.77
Law,Legal Consultant,4.547221375781929,5,1,0,1,2,1,0,3,4,1,1,2,0,1,Arts,Bachelors,36-40,8,0,0,Office,Tier1_City,1,4,3,2,1,5,2,48.08,Other,2,2,3,5,0,2,1,5,3,1,1,1,4,4,49.32
Architecture,Physical Chemist,4.549240588799068,8,1,3,1,4,0,4,4,0,1,3,3,3,1,Interdisciplinary,Bachelors,18-24,3,1,44,Remote,Tier1_City,3,3,3,4,4,0,5,15.9,Education,3,5,3,3,2,5,2,1,2,5,0,0,1,1,53.0
Engineering,Credit Analyst,3.195627272988596,0,2,2,0,3,0,1,2,3,4,1,2,1,0,Science,Bachelors,18-24,11,0,0,Flexible,Tier2_City,1,4,0,4,2,2,1,46.56,Other,5,5,3,2,5,4,4,3,3,1,0,1,3,1,52.18
Chemistry,Construction Manager,4.622442645469468,9,1,4,1,8,1,2,2,0,2,2,0,2,0,Science,PhD,25-30,4,0,0,Office,Any,5,3,5,2,3,1,3,11.52,Healthcare,2,4,4,3,5,0,4,3,1,1,0,1,2,3,44.98
Medicine,Quantum Physicist,4.661982980221455,8,2,2,1,9,1,0,3,3,4,1,1,4,0,Science,Bachelors,36-40,0,0,0,Hybrid,Any,4,3,1,2,4,4,3,48.58,Other,1,5,5,1,0,5,4,5,5,4,0,1,3,3,46.85
Finance,Legal Consultant,4.455928185842046,5,0,0,1,8,0,0,2,1,2,3,4,1,1,Commerce,Bachelors,18-24,13,0,0,Flexible,Tier1_City,5,4,2,2,1,4,1,16.8,Manufacturing,4,4,4,1,5,4,4,2,5,5,1,1,3,3,59.8
Music,Biochemist,2.579909781513895,2,2,4,0,4,1,3,1,0,2,3,1,3,1,Arts,Bachelors,18-24,8,0,0,Office,Tier1_City,5,1,1,4,3,0,2,32.76,Other,4,2,1,5,0,5,2,4,1,5,1,1,3,1,53.32
Marketing,Fluid Mechanics Engineer,4.333389353857207,3,2,1,1,2,1,2,2,3,1,0,4,1,0,Commerce,Bachelors,25-30,8,1,32,Flexible,Tier2_City,1,4,2,2,4,2,3,6.28,Finance,5,5,1,1,5,5,2,1,2,1,1,0,2,1,48.39
Chemistry,Mechanical Engineer,4.606441949383484,5,0,4,1,2,1,4,4,1,1,2,4,1,0,Science,Bachelors,25-30,8,1,22,Hybrid,Tier1_City,2,4,2,1,0,0,1,17.08,Tech,3,1,5,1,5,0,3,5,3,3,0,0,3,4,56.85
Architecture,Clinical Psychologist,4.520495717817206,4,0,2,0,4,0,3,0,1,2,3,3,3,1,Interdisciplinary,Bachelors,25-30,2,0,0,Hybrid,Tier3_City,5,1,2,4,4,0,1,12.9,Healthcare,1,5,5,5,0,1,3,5,4,5,0,0,4,1,52.66
Business,Risk Analyst,2.792561267085936,5,0,2,0,9,1,4,2,4,2,1,3,4,1,Commerce,Bachelors,25-30,12,0,0,Hybrid,Tier2_City,2,1,2,1,5,1,5,3.16,Manufacturing,3,1,3,5,5,5,2,4,1,2,1,0,3,2,62.24
Music,Surgeon,3.85995408783263,7,0,0,1,3,1,2,1,2,2,0,2,3,0,Arts,Bachelors,25-30,14,0,0,Remote,Tier1_City,3,1,4,3,2,2,5,10.37,Healthcare,3,4,1,5,2,0,2,1,3,5,0,1,3,1,57.94
Marketing,Paralegal,2.5016996614270868,9,1,0,1,9,1,0,3,0,4,2,3,3,1,Commerce,Masters,18-24,9,1,28,Flexible,Tier1_City,5,1,3,4,3,1,2,30.88,Education,5,5,3,5,1,0,3,5,2,2,1,0,4,1,55.91
Music,Musician,4.183262131841049,2,1,4,0,8,1,0,1,0,3,2,3,4,1,Arts,Masters,18-24,9,0,0,Office,Any,1,1,4,3,2,2,2,21.33,Tech,4,4,5,5,2,1,2,3,3,2,0,0,1,3,53.28
Business,Architect,2.8078330006497128,5,2,4,0,6,0,3,3,4,2,2,0,1,1,Commerce,Bachelors,36-40,9,0,0,Hybrid,Tier2_City,3,1,0,2,0,4,2,36.96,Education,3,1,1,4,1,5,1,3,2,2,0,1,4,1,55.5
Law,Entrepreneur,4.470896930054074,6,0,2,1,5,1,4,3,0,1,3,0,1,0,Arts,Bachelors,36-40,7,0,0,Flexible,Tier3_City,4,4,4,2,0,3,1,34.54,Other,3,4,3,2,5,5,1,5,1,5,0,0,5,4,51.66
Engineering,Illustrator,4.249501968486984,1,2,1,1,4,0,3,2,2,4,0,0,4,0,Science,Bachelors,18-24,2,1,13,Flexible,Tier2_City,5,2,3,5,5,5,1,40.57,Education,1,3,2,5,2,1,1,2,3,5,1,0,2,2,55.19
Physics,Inorganic Chemist,2.991969231097096,1,2,2,1,3,0,0,3,4,0,3,4,3,0,Science,Masters,18-24,12,0,0,Remote,Tier2_City,1,2,1,2,2,3,5,43.75,Other,4,1,2,2,4,0,1,2,4,4,1,1,4,4,67.91
Marketing,Financial Analyst,3.6602699104791534,7,1,1,1,8,0,4,0,1,2,1,4,4,0,Commerce,Bachelors,18-24,5,0,0,Office,Tier1_City,5,2,3,3,3,2,3,41.53,Finance,3,4,3,1,4,0,4,2,4,4,0,0,2,5,50.95
Architecture,Education Administrator,4.893234464758515,4,2,4,1,4,0,3,4,1,3,3,0,2,0,Interdisciplinary,High School,31-35,4,0,0,Hybrid,Tier3_City,1,4,1,2,0,3,2,24.06,Education,2,5,4,4,2,3,1,3,3,2,0,1,4,2,41.21
Chemistry,Investment Banker,4.792391284145543,8,1,2,0,9,0,2,2,4,1,1,4,1,1,Science,Masters,31-35,7,0,0,Hybrid,Tier3_City,1,1,0,4,0,0,4,17.51,Manufacturing,2,4,3,5,2,4,3,3,1,4,1,0,3,5,58.83
Business,Inorganic Chemist,3.631377771495597,6,2,2,1,5,1,4,3,1,3,1,4,1,1,Commerce,Bachelors,25-30,2,0,0,Flexible,Tier1_City,2,3,2,2,4,4,2,26.61,Tech,4,2,1,4,2,2,4,4,5,3,1,1,3,1,56.89
Architecture,Fluid Mechanics Engineer,3.940497404124139,0,1,0,0,0,0,1,0,1,3,3,1,1,0,Interdisciplinary,Bachelors,31-35,13,0,0,Flexible,Tier1_City,5,1,5,5,5,5,5,28.15,Finance,4,1,5,3,4,1,3,2,2,4,1,1,5,3,54.51
Art,Counselor,2.918477112718204,9,2,4,0,6,1,0,0,4,4,4,2,2,0,Arts,Bachelors,31-35,0,0,0,Office,Tier2_City,1,5,4,2,1,5,1,17.72,Healthcare,5,4,3,2,2,1,5,4,5,2,0,0,1,4,44.86
Engineering,Game Developer,2.5649105750686445,8,2,1,1,5,1,4,2,3,0,3,2,3,1,Science,PhD,36-40,11,1,38,Hybrid,Tier2_City,1,1,5,3,0,5,5,28.38,Education,3,3,1,5,3,0,5,5,2,1,1,1,4,2,64.14
Education,Actuary,3.613470229030028,2,1,4,0,2,1,2,1,2,3,3,4,2,0,Arts,Masters,18-24,8,0,0,Office,Tier2_City,3,2,2,3,3,4,5,7.97,Healthcare,2,2,1,2,3,1,2,5,2,3,1,0,5,2,57.2
Music,Nuclear Physicist,3.21191277484548,3,1,4,0,1,0,4,1,0,4,3,4,0,0,Arts,Masters,18-24,9,0,0,Hybrid,Tier2_City,5,1,0,2,3,3,5,13.86,Finance,2,1,2,2,3,4,4,1,2,5,1,1,4,3,66.72
Art,Composer,3.5384743499636784,2,1,1,1,4,0,1,2,3,2,0,2,1,0,Arts,Bachelors,18-24,8,0,0,Remote,Tier3_City,3,1,0,3,4,5,4,38.06,Healthcare,4,2,3,3,2,5,1,1,5,3,1,0,2,4,55.94
Engineering,Graphic Designer,3.592483162192412,7,2,3,1,5,1,1,4,0,2,0,0,2,0,Science,Bachelors,36-40,2,0,0,Hybrid,Tier2_City,2,5,1,3,3,5,4,11.59,Manufacturing,4,5,4,2,5,3,5,1,4,1,1,1,5,3,32.91
Business,Art Therapist,4.416118675158042,2,2,3,1,9,0,2,0,3,3,1,2,2,1,Commerce,PhD,31-35,1,0,0,Remote,Tier2_City,2,3,1,5,4,2,2,9.53,Finance,1,3,4,1,0,5,4,1,4,1,1,0,1,5,50.12
Chemistry,Psychologist,3.714321859787219,4,2,3,1,8,0,2,3,3,4,0,4,4,1,Science,PhD,25-30,3,1,18,Hybrid,Tier1_City,1,3,5,4,0,0,1,16.51,Tech,1,5,5,2,0,5,1,3,4,2,1,1,4,1,56.91
Psychology,Clinical Psychologist,2.553235107938689,1,1,3,1,1,0,2,2,4,1,3,3,2,0,Arts,Bachelors,18-24,13,0,0,Office,Tier1_City,1,2,0,5,0,2,5,20.44,Tech,4,4,5,3,1,3,5,4,1,1,1,1,2,5,53.53
Computer Science,Data Scientist,3.3925202357336097,1,2,2,1,6,1,2,4,4,2,0,0,3,0,Science,Masters,25-30,7,1,46,Remote,Tier2_City,1,3,3,1,0,3,3,18.44,Tech,1,2,2,3,5,0,2,3,5,5,0,0,2,3,63.36
Architecture,Financial Controller,2.929540921920128,2,2,3,1,5,0,3,2,3,3,3,3,2,1,Interdisciplinary,Bachelors,25-30,5,1,28,Office,Tier3_City,5,2,2,5,0,4,2,20.61,Tech,4,5,3,5,3,5,3,5,2,3,0,1,5,2,53.85
Computer Science,Financial Analyst,2.852904987254916,1,0,0,1,3,0,1,0,4,4,4,1,4,0,Science,Bachelors,25-30,9,0,0,Remote,Tier3_City,5,4,4,2,1,4,2,9.58,Finance,4,4,5,1,4,5,2,2,1,3,0,0,3,4,49.42
Education,Legal Consultant,4.278542715817505,2,2,0,1,2,0,0,1,1,1,0,1,3,1,Arts,Masters,25-30,14,1,36,Hybrid,Tier3_City,4,5,0,4,5,2,5,10.77,Finance,5,3,3,2,3,0,5,2,1,3,0,0,5,2,47.25
Law,Architect,3.766157939726589,6,0,1,0,5,1,2,2,3,3,0,2,3,1,Arts,Bachelors,18-24,14,0,0,Hybrid,Tier2_City,1,1,4,2,5,1,2,14.08,Other,1,5,4,3,3,2,3,4,5,4,0,0,5,3,64.57
Architecture,Animator,3.505766045483649,1,2,2,1,5,0,2,3,1,4,3,4,1,0,Interdisciplinary,PhD,31-35,0,0,0,Office,Tier1_City,3,5,0,1,1,2,5,21.89,Finance,3,2,1,3,1,4,5,4,3,3,1,1,2,3,53.41
Biology,Special Education Teacher,3.96962180415021,8,1,0,1,9,0,3,1,4,3,2,2,0,1,Science,Bachelors,25-30,14,1,10,Office,Tier2_City,4,3,1,4,0,1,2,18.79,Education,3,5,4,2,5,1,5,5,3,1,0,0,1,2,56.07
Music,Musician,3.025719064041098,9,2,2,0,2,1,3,0,2,0,0,1,4,1,Arts,Bachelors,25-30,7,0,0,Hybrid,Tier1_City,5,1,1,3,3,2,1,40.19,Other,5,3,2,2,3,0,1,3,4,4,0,1,5,2,47.71
Music,Paralegal,3.4154788310247137,5,0,1,1,0,0,3,2,3,3,2,1,2,1,Arts,PhD,18-24,4,0,0,Remote,Tier2_City,5,5,0,5,4,1,2,27.7,Finance,3,4,3,5,0,2,4,2,4,3,1,1,3,2,67.68
Biology,Musician,4.612924400378331,4,0,1,0,9,0,0,2,2,0,1,2,4,1,Science,PhD,36-40,12,0,0,Office,Tier1_City,1,5,4,2,5,1,2,30.06,Finance,3,5,1,5,4,3,3,3,4,3,0,1,2,4,66.44
Architecture,Inorganic Chemist,2.722415144832607,1,2,2,0,5,1,1,4,0,3,0,4,3,0,Interdisciplinary,Bachelors,25-30,5,0,0,Hybrid,Tier1_City,3,2,2,1,2,5,3,29.35,Finance,5,5,1,1,0,1,2,5,3,4,0,0,3,1,44.69
Law,Conductor,4.163117508284287,7,2,2,1,6,0,0,1,0,2,1,3,3,1,Arts,Bachelors,36-40,4,0,0,Hybrid,Tier2_City,3,4,0,3,4,5,1,21.74,Tech,2,1,2,5,3,5,3,3,1,2,0,1,2,1,35.29
Business,Biochemist,3.941979971435816,9,0,2,1,1,1,2,2,4,2,1,3,1,0,Commerce,Masters,25-30,9,1,46,Remote,Tier1_City,2,5,0,5,2,1,1,49.08,Manufacturing,5,4,1,5,2,3,4,2,1,3,0,1,2,3,60.48
Chemistry,Financial Controller,3.169484988538036,2,1,4,1,5,0,3,0,1,4,3,0,0,1,Science,Bachelors,36-40,4,0,0,Remote,Tier2_City,1,1,3,3,2,1,1,4.75,Tech,5,1,3,4,4,3,4,5,1,2,0,0,5,4,39.33
Marketing,Legal Secretary,3.6125607604100014,8,2,0,0,3,0,4,3,3,0,2,3,3,1,Commerce,PhD,36-40,2,1,54,Remote,Tier2_City,5,4,0,5,0,0,2,13.14,Other,1,1,4,2,4,4,4,3,4,5,0,0,2,2,60.17
Biology,Web Developer,3.1927484986049226,1,1,3,0,9,0,2,0,4,2,0,0,4,1,Science,PhD,25-30,13,0,0,Hybrid,Tier3_City,1,4,5,4,2,1,4,16.38,Manufacturing,3,3,3,5,1,0,1,3,3,3,1,1,1,1,60.93
Chemistry,Civil Engineer,3.4957895561794183,2,2,0,1,9,1,2,3,4,1,0,3,3,0,Science,Bachelors,36-40,3,0,0,Hybrid,Tier1_City,1,1,1,3,0,5,2,44.42,Manufacturing,3,3,5,4,1,0,5,3,4,4,1,1,3,4,51.68
Law,Music Teacher,2.906347786837771,3,0,4,0,1,1,3,3,3,3,2,2,3,0,Arts,Bachelors,25-30,4,0,0,Hybrid,Tier1_City,2,4,3,3,1,1,5,46.19,Manufacturing,2,2,1,4,4,0,2,3,2,4,1,1,4,2,53.48
Computer Science,Fluid Mechanics Engineer,4.544721035683932,2,2,4,1,7,1,3,3,3,3,4,3,2,1,Science,Bachelors,25-30,10,0,0,Hybrid,Tier3_City,2,3,3,3,3,4,3,42.77,Other,5,4,1,5,4,3,2,4,4,5,1,0,2,4,74.32
Business,Astronomer,3.143784820001163,7,2,3,0,8,0,2,0,2,3,4,2,4,1,Commerce,PhD,18-24,10,0,0,Flexible,Tier1_City,4,4,1,4,2,0,1,22.6,Other,4,4,3,3,5,2,2,5,2,4,1,0,5,4,64.66
Law,Digital Marketing Specialist,4.050487996505222,8,1,3,1,3,0,2,1,3,0,3,1,2,1,Arts,Bachelors,25-30,1,1,12,Hybrid,Any,1,2,1,1,3,1,5,45.99,Tech,2,3,2,5,0,4,3,5,2,1,1,0,4,5,38.13
Medicine,Psychologist,3.7010098706364656,5,1,4,1,8,0,0,3,4,4,4,3,3,0,Science,Bachelors,31-35,5,0,0,Hybrid,Tier1_City,5,4,5,5,0,5,5,7.63,Education,2,3,3,5,3,4,1,3,3,2,0,0,1,4,54.32
Engineering,Electrical Engineer,4.183854924859953,8,0,3,0,6,0,4,3,4,0,3,4,1,1,Science,Bachelors,31-35,1,0,0,Remote,Tier2_City,2,5,1,3,2,5,4,33.66,Healthcare,3,1,4,2,4,3,1,3,1,1,0,1,3,5,46.13
Education,Software Developer,3.392133118270908,4,1,1,0,7,1,3,2,0,1,4,4,4,1,Arts,Masters,18-24,3,0,0,Hybrid,Tier1_City,4,4,4,4,4,3,1,47.05,Education,3,3,2,3,5,0,2,4,5,3,0,1,1,3,62.17
Architecture,Artist,3.5017054039218074,7,0,2,0,9,0,2,0,0,1,1,2,2,0,Interdisciplinary,Bachelors,25-30,11,0,0,Hybrid,Tier2_City,4,2,5,1,1,5,2,38.48,Tech,3,5,1,1,2,5,2,2,4,1,0,1,5,4,44.98
Medicine,Entrepreneur,4.349299275992742,4,1,1,0,4,0,1,2,1,1,2,0,1,1,Science,Bachelors,18-24,0,0,0,Hybrid,Any,4,2,3,5,5,0,1,16.06,Manufacturing,3,4,1,5,3,2,4,4,3,2,0,0,4,1,36.9
Psychology,Fluid Mechanics Engineer,3.839942822765151,8,1,1,1,8,1,1,2,3,0,4,0,1,1,Arts,PhD,31-35,3,0,0,Flexible,Tier2_City,5,4,2,4,1,5,3,36.72,Healthcare,2,2,2,5,4,0,3,3,4,5,1,1,1,4,59.12
Chemistry,Fluid Mechanics Engineer,4.329700136924592,3,2,2,1,0,0,1,3,2,0,3,0,4,1,Science,PhD,18-24,13,1,37,Office,Tier2_City,2,3,2,5,2,4,1,16.85,Education,5,1,2,2,5,4,4,3,2,5,1,1,2,1,61.47
Business,Digital Marketing Specialist,2.7868096804382274,1,0,1,0,9,1,4,1,4,0,0,0,2,0,Commerce,Masters,36-40,6,1,38,Flexible,Tier1_City,3,4,5,3,1,2,5,8.24,Other,3,5,2,1,1,2,5,3,1,5,1,0,4,2,51.35
Music,Chemical Engineer,4.946266771064061,0,1,2,0,8,1,0,4,4,3,0,0,1,1,Arts,High School,18-24,14,0,0,Remote,Any,5,1,4,1,5,4,5,36.71,Other,1,3,1,4,1,1,4,3,1,5,1,1,3,1,55.77
Art,Inorganic Chemist,3.1264577252838084,3,1,4,0,4,0,0,2,0,2,4,1,3,0,Arts,Bachelors,25-30,13,0,0,Hybrid,Tier2_City,1,2,2,4,4,4,2,11.42,Finance,2,2,1,3,1,1,5,4,5,3,0,0,5,3,59.71
Engineering,Special Education Teacher,4.735802047802355,2,1,3,0,1,1,0,0,0,1,0,2,2,1,Science,Masters,36-40,7,0,0,Hybrid,Tier1_City,3,4,3,1,3,0,2,8.22,Other,4,3,1,1,2,3,5,3,2,4,0,1,5,4,40.39
Biology,Art Director,2.769447183134452,2,1,2,1,6,1,2,4,4,4,3,4,0,0,Science,Bachelors,25-30,1,1,31,Office,Tier1_City,5,3,1,3,4,0,2,28.93,Education,4,5,1,5,0,1,4,2,5,5,0,0,3,5,65.27
Finance,Education Administrator,3.405581113420132,7,1,3,0,7,0,4,1,1,1,4,1,4,1,Commerce,PhD,18-24,2,1,56,Hybrid,Tier1_City,2,3,3,1,1,3,3,32.17,Tech,5,2,1,4,3,5,2,1,4,1,1,0,5,4,50.07
Finance,Urban Planner,4.149390534804071,2,0,0,1,9,1,4,4,1,0,4,0,3,0,Commerce,Masters,25-30,0,1,50,Office,Tier1_City,4,3,5,1,5,5,1,5.4,Healthcare,2,3,3,2,0,4,4,2,1,1,1,1,5,5,40.13
Finance,Astronomer,4.366709971142642,7,1,3,1,9,1,3,2,4,0,3,0,1,0,Commerce,Bachelors,18-24,14,0,0,Hybrid,Any,5,5,4,2,3,3,4,3.21,Finance,2,5,3,5,0,4,5,3,1,4,1,0,3,5,59.38
Computer Science,Entrepreneur,2.721692241497553,4,1,0,0,8,0,2,2,3,1,2,2,4,1,Science,PhD,40+,6,0,0,Remote,Tier1_City,1,5,4,1,5,0,1,44.46,Other,2,5,3,2,0,1,1,4,5,2,0,1,5,4,63.26
Marketing,Pharmacist,3.848591890846094,9,1,1,1,9,0,3,4,1,2,1,3,1,1,Commerce,PhD,25-30,3,0,0,Remote,Tier1_City,1,5,0,5,4,5,2,8.42,Other,1,2,2,3,1,3,5,3,2,2,1,1,3,1,52.18
Physics,Clinical Psychologist,3.980037287258874,1,1,1,1,7,1,0,2,3,4,0,1,1,1,Science,Bachelors,25-30,10,1,50,Remote,Tier2_City,1,1,4,4,0,0,3,30.44,Healthcare,1,5,1,2,3,3,3,4,1,5,1,1,5,2,49.67
Physics,Marketing Manager,2.855797058196947,6,0,0,1,0,0,1,0,3,2,3,2,3,0,Science,Bachelors,25-30,9,1,9,Remote,Tier2_City,3,1,4,2,0,0,1,47.82,Healthcare,3,3,3,1,1,2,1,1,3,1,0,0,1,1,46.79
Education,Marketing Manager,2.6227146507190784,5,0,0,1,3,0,4,3,4,0,1,3,4,1,Arts,Bachelors,18-24,7,0,0,Remote,Tier1_City,4,4,5,4,3,2,5,27.06,Education,4,2,2,1,0,1,4,5,3,4,0,0,1,1,57.2
Business,AI Researcher,4.561259935057555,4,2,0,0,7,1,4,4,3,0,3,4,2,0,Commerce,Bachelors,31-35,4,1,13,Remote,Tier1_City,5,5,3,4,3,4,1,9.57,Other,1,1,4,3,5,1,5,2,2,2,1,0,1,3,53.66
Psychology,Biologist,3.6804694326139824,0,1,1,0,6,0,1,4,3,4,1,1,3,1,Arts,Bachelors,36-40,8,1,17,Office,Tier1_City,3,5,3,3,3,3,5,21.49,Manufacturing,4,5,5,3,5,5,1,1,2,5,1,1,4,2,56.17
Education,Accountant,2.853872322799663,6,1,4,1,6,1,2,2,2,0,1,0,1,1,Arts,Masters,36-40,5,0,0,Hybrid,Tier2_City,5,1,4,3,0,3,1,32.33,Other,2,3,4,3,4,4,2,3,5,5,0,0,3,1,51.98
Architecture,Data Scientist,4.742289566255424,6,1,3,1,3,1,2,0,1,2,3,0,0,1,Interdisciplinary,PhD,25-30,10,1,29,Remote,Tier1_City,2,3,3,2,4,1,1,38.85,Education,1,2,4,1,2,1,4,4,2,4,0,0,1,2,60.3
Finance,Landscape Architect,3.119360469040847,2,2,3,1,0,0,4,4,4,0,3,3,3,0,Commerce,Bachelors,25-30,9,0,0,Hybrid,Any,2,3,3,3,3,2,1,31.53,Finance,4,1,5,5,5,0,5,4,5,1,1,0,5,5,67.94
Finance,Landscape Architect,3.2967144433083555,6,0,3,0,3,1,2,2,1,2,1,4,2,0,Commerce,Bachelors,18-24,1,0,0,Flexible,Tier2_City,5,2,5,3,0,0,2,4.61,Tech,1,1,2,1,5,3,3,5,2,2,1,1,3,4,35.06
Physics,Human Resources Specialist,3.313350740272626,5,0,3,0,9,1,0,0,1,1,3,3,1,0,Science,Masters,31-35,0,0,0,Hybrid,Tier2_City,3,4,5,3,3,0,5,9.73,Other,2,4,5,2,5,5,2,1,3,2,0,1,3,4,39.57
Engineering,Graphic Designer,4.6530803961245,4,0,2,1,2,1,4,0,4,1,2,4,2,0,Science,Bachelors,25-30,0,0,0,Flexible,Any,1,4,4,4,3,2,3,20.47,Education,2,4,2,3,2,3,3,2,1,1,0,0,5,4,43.4
Computer Science,Financial Analyst,3.10580430479538,9,2,1,1,3,0,2,3,4,3,0,4,4,1,Science,Masters,25-30,11,1,32,Hybrid,Tier2_City,3,5,1,2,5,5,4,36.17,Manufacturing,2,2,4,4,5,5,1,4,2,1,0,0,2,2,63.26
Law,Zoologist,2.7291740391835657,2,1,2,0,8,1,1,4,2,3,3,2,1,0,Arts,Bachelors,36-40,11,0,0,Flexible,Tier2_City,3,1,4,4,3,3,5,30.46,Manufacturing,3,5,5,1,0,5,3,2,2,5,1,1,3,1,59.78
Physics,Credit Analyst,3.578462468846677,8,0,1,1,2,0,4,2,4,4,4,4,1,1,Science,Bachelors,18-24,13,0,0,Remote,Tier1_City,5,4,2,5,0,0,2,5.1,Education,4,3,4,4,1,2,5,3,2,1,0,1,4,2,67.87
Architecture,Legal Analyst,3.290573766134145,4,0,2,1,8,1,0,0,4,2,3,3,4,0,Interdisciplinary,Bachelors,18-24,13,0,0,Remote,Tier3_City,3,3,3,4,4,1,5,40.45,Finance,3,5,5,5,3,1,5,4,3,3,0,0,4,4,60.13
Biology,AI Researcher,4.720119326485044,6,1,4,1,8,0,1,3,1,3,4,3,1,1,Science,Masters,18-24,8,0,0,Office,Tier1_City,2,1,0,5,0,3,3,31.44,Manufacturing,5,3,5,1,1,3,3,4,4,4,0,0,2,1,60.07
Education,Counselor,4.852504984030569,3,1,3,1,7,1,4,0,0,4,0,0,3,1,Arts,Bachelors,18-24,0,0,0,Flexible,Tier2_City,5,5,4,1,0,4,5,44.7,Manufacturing,5,3,1,5,3,1,1,1,2,4,1,0,1,3,38.38
Computer Science,Conductor,2.770060120852535,0,1,0,1,8,1,2,1,3,2,0,0,2,0,Science,Masters,18-24,2,0,0,Office,Tier2_City,5,5,1,1,3,2,2,22.63,Other,1,4,3,5,4,4,5,5,3,1,1,1,1,4,44.69
Law,Actuary,3.534314962337487,8,2,4,1,9,1,3,3,4,2,0,4,1,0,Arts,Bachelors,25-30,11,0,0,Hybrid,Tier2_City,5,4,1,5,5,3,2,26.04,Other,1,4,3,1,3,3,5,3,1,4,0,0,3,1,60.44
Engineering,Music Therapist,4.925367516219325,0,0,1,1,2,1,1,2,4,2,2,4,3,1,Science,Bachelors,25-30,1,1,25,Remote,Tier3_City,3,4,3,5,2,4,4,22.06,Finance,1,5,4,1,3,1,3,5,3,5,1,0,5,1,50.55
Physics,Legal Consultant,2.968682660982041,0,1,3,1,6,0,3,2,2,0,3,1,1,1,Science,Bachelors,18-24,14,1,29,Hybrid,Tier2_City,4,2,4,4,2,1,3,36.96,Finance,3,2,4,5,4,1,3,1,2,2,0,1,3,5,55.72
Art,Legal Analyst,2.559677044363313,8,2,0,0,6,1,4,4,2,1,0,1,4,0,Arts,PhD,31-35,14,0,0,Remote,Tier1_City,1,4,4,5,2,5,4,38.35,Finance,2,3,4,3,2,5,1,2,1,2,1,1,2,3,58.64
Medicine,Quantum Physicist,4.713088704624663,5,2,0,0,8,0,0,4,0,4,3,4,4,1,Science,PhD,18-24,14,1,49,Hybrid,Tier2_City,1,4,5,2,0,2,1,36.99,Finance,1,4,1,1,3,2,2,1,3,4,1,0,1,3,65.58
Art,Accountant,4.675718895639974,1,1,0,1,9,1,2,1,1,1,1,1,0,0,Arts,Bachelors,31-35,11,1,9,Remote,Any,2,3,2,1,3,5,2,16.71,Education,1,2,1,5,4,3,4,1,5,1,1,0,4,5,52.07
Biology,Legal Analyst,2.886004142377367,6,0,4,1,4,0,3,3,4,3,1,0,3,1,Science,Bachelors,25-30,3,0,0,Hybrid,Tier2_City,5,3,5,1,2,0,4,32.89,Education,5,4,4,2,3,0,4,1,2,4,1,0,3,1,50.07
Engineering,Education Administrator,4.879961501632069,4,2,0,1,7,1,3,4,1,3,1,4,2,0,Science,Bachelors,25-30,0,0,0,Office,Tier1_City,1,1,4,5,1,5,2,18.91,Healthcare,2,3,1,4,1,5,4,4,4,3,1,1,2,3,50.93
Physics,Clinical Psychologist,3.062032868178335,8,0,4,0,9,0,2,4,0,4,1,1,2,0,Science,Bachelors,36-40,14,1,40,Remote,Any,3,4,5,3,1,0,2,42.21,Healthcare,3,1,5,2,4,3,3,3,3,5,0,1,3,3,59.94
Finance,Inorganic Chemist,4.917712895269528,3,2,1,0,6,0,3,1,1,1,4,1,1,0,Commerce,Bachelors,18-24,0,0,0,Hybrid,Tier1_City,3,4,2,3,1,4,1,5.59,Healthcare,2,4,5,1,0,4,5,2,4,4,1,1,1,2,44.47
Law,Music Therapist,3.4877488828335808,3,1,0,1,9,0,3,1,1,4,0,2,0,0,Arts,PhD,25-30,3,0,0,Remote,Any,3,5,1,5,4,3,2,4.77,Manufacturing,5,2,5,1,5,1,5,5,3,5,1,0,5,1,53.85
Finance,Graphic Designer,2.7846719312168062,1,2,3,1,5,0,2,2,2,0,1,3,3,1,Commerce,PhD,36-40,12,1,56,Remote,Tier1_City,2,3,4,2,3,1,4,7.78,Finance,3,5,3,1,3,3,2,2,1,1,0,1,4,5,54.17
Marketing,Biomedical Engineer,3.057254739847473,7,0,0,1,9,0,1,0,0,1,4,0,4,0,Commerce,Bachelors,25-30,12,0,0,Hybrid,Any,5,5,5,3,0,4,3,12.51,Education,4,5,5,1,3,1,5,4,4,1,0,0,2,4,41.07
Law,Physical Chemist,3.598852118272678,3,1,2,0,9,1,2,1,3,3,0,1,1,0,Arts,Bachelors,25-30,13,1,22,Remote,Tier1_City,1,4,5,5,0,1,5,4.77,Education,1,3,3,2,1,2,3,4,2,5,0,1,1,5,54.87
Engineering,Legal Analyst,3.921939234668008,6,0,1,1,0,0,0,2,2,0,2,1,2,1,Science,Masters,25-30,3,0,0,Flexible,Tier3_City,5,3,3,2,3,5,4,6.37,Finance,3,1,5,3,1,2,1,5,4,4,0,1,4,2,47.1
Biology,Credit Analyst,2.6703186529080183,5,0,1,1,2,0,2,2,0,4,3,3,0,1,Science,Masters,31-35,6,0,0,Hybrid,Tier3_City,5,4,2,2,5,1,1,17.38,Healthcare,5,4,4,5,0,3,1,4,2,1,1,0,1,2,53.66
Architecture,Geneticist,3.657293314212136,7,0,3,1,7,0,0,3,2,4,0,4,2,1,Interdisciplinary,High School,36-40,7,0,0,Remote,Tier2_City,3,2,2,4,5,5,5,7.69,Other,2,4,3,5,4,2,4,5,1,3,0,1,1,4,50.7
Chemistry,Cybersecurity Analyst,4.326727273260079,0,2,2,0,3,1,0,0,4,3,4,3,4,1,Science,Bachelors,18-24,12,0,0,Hybrid,Tier3_City,1,5,3,2,4,1,2,40.7,Manufacturing,3,1,1,5,5,5,4,4,2,3,1,1,3,1,62.12
Architecture,Biotechnologist,4.32602910611382,4,1,4,1,0,0,3,3,4,3,2,3,1,1,Interdisciplinary,Bachelors,18-24,7,1,17,Remote,Tier2_City,2,3,0,3,3,2,4,5.53,Education,5,3,3,4,0,1,1,1,3,5,0,0,4,3,67.55
Finance,Quantum Physicist,4.24496596443339,8,0,0,0,8,1,0,2,3,2,2,0,3,1,Commerce,Bachelors,25-30,7,0,0,Remote,Tier1_City,5,3,3,3,5,4,5,45.67,Tech,3,3,2,1,0,4,4,4,2,3,0,0,5,5,49.49
Education,Analytical Chemist,4.803944881266657,8,0,0,1,7,1,3,0,0,1,4,3,3,0,Arts,Bachelors,18-24,13,1,36,Remote,Tier1_City,4,4,2,5,4,2,4,43.93,Manufacturing,1,2,3,2,2,5,4,5,4,5,0,1,1,5,62.37
Business,Aerospace Engineer,3.14881947524777,6,2,2,1,1,0,0,1,4,1,1,4,1,0,Commerce,High School,25-30,13,0,0,Remote,Tier2_City,3,4,3,5,2,3,2,12.79,Manufacturing,2,2,5,2,5,3,2,5,4,4,1,0,5,4,53.26
Biology,Physicist,4.19928025199061,4,2,2,1,3,1,3,4,3,4,2,2,3,0,Science,Masters,18-24,11,0,0,Office,Tier2_City,4,1,2,2,2,3,4,6.36,Healthcare,2,2,5,2,0,4,1,5,3,2,1,0,5,1,65.47
Architecture,Chemist,4.281526124605145,3,1,3,0,6,0,2,2,4,4,4,4,4,0,Interdisciplinary,Bachelors,18-24,13,1,16,Office,Tier1_City,2,1,5,1,4,0,1,7.96,Finance,3,3,5,3,3,2,2,3,2,1,1,0,1,1,65.46
Art,Electrical Engineer,3.551236915549618,2,1,4,0,7,0,4,0,3,2,0,2,1,1,Arts,Bachelors,18-24,8,0,0,Hybrid,Tier1_City,2,5,0,4,3,0,5,29.28,Tech,5,4,1,1,0,2,4,2,2,1,1,1,3,3,44.51
Law,Architect,2.6260962264650662,1,1,1,0,0,1,2,1,4,3,4,1,0,0,Arts,Bachelors,36-40,0,1,21,Office,Tier2_City,2,3,4,1,2,0,5,31.24,Healthcare,1,5,4,5,5,1,5,2,2,4,1,1,2,5,51.19
Chemistry,Curriculum Developer,3.9681933576422224,0,0,3,0,0,1,0,2,2,0,0,0,2,1,Science,Masters,18-24,8,0,0,Hybrid,Tier3_City,2,4,1,2,3,3,5,17.83,Finance,1,3,3,5,1,5,4,1,5,4,1,1,2,5,57.38
Marketing,Interior Designer,4.797713435717335,1,0,0,1,1,1,1,2,4,4,1,4,2,0,Commerce,Masters,18-24,9,1,54,Remote,Any,1,5,0,2,5,1,4,16.95,Tech,3,1,1,1,1,5,4,5,5,4,1,1,1,4,73.71
Medicine,Civil Engineer,4.3361981572956205,0,0,1,0,7,1,1,0,0,1,1,1,1,1,Science,Bachelors,18-24,7,0,0,Hybrid,Tier1_City,4,3,4,1,2,5,2,27.98,Other,4,5,2,5,5,3,2,3,4,1,0,1,3,5,41.53
Engineering,AI Researcher,2.9303857796890846,8,2,1,1,0,0,1,2,0,2,2,0,4,0,Science,Bachelors,36-40,0,1,14,Hybrid,Any,3,4,5,4,5,1,4,17.36,Other,3,3,3,5,3,5,3,3,4,5,1,1,2,1,48.13
Computer Science,Actuary,3.21753655595149,0,2,3,0,1,0,2,2,4,0,3,3,2,0,Science,PhD,31-35,6,1,13,Remote,Any,4,1,3,1,3,4,4,46.91,Education,1,3,5,1,2,3,3,3,1,3,0,1,1,1,55.07
Finance,Forensic Psychologist,4.309629520985,8,1,2,1,2,0,3,4,4,0,1,4,2,0,Commerce,Bachelors,31-35,8,0,0,Office,Tier1_City,1,3,2,5,3,3,5,20.98,Tech,2,2,1,2,0,0,5,5,2,1,0,0,4,3,54.19
Business,AI Researcher,4.724830428785223,5,0,4,1,0,1,3,0,0,0,0,2,1,1,Commerce,Bachelors,18-24,3,0,0,Office,Tier2_City,5,4,5,3,1,5,2,13.33,Healthcare,3,4,1,4,4,1,4,3,4,2,1,0,1,4,36.18
Chemistry,Physician Assistant,2.801707058971374,8,1,3,1,1,1,1,0,0,3,0,4,0,1,Science,Bachelors,36-40,12,0,0,Flexible,Tier2_City,2,5,5,5,4,5,3,9.86,Tech,3,4,3,1,1,3,3,3,1,5,1,0,1,5,52.8
Finance,Marketing Manager,2.7873930994900045,1,2,2,0,1,0,4,0,2,2,4,4,3,0,Commerce,Bachelors,25-30,14,0,0,Remote,Tier2_City,5,5,0,3,0,5,2,32.69,Tech,2,5,1,5,3,4,5,2,5,4,0,0,5,3,67.21
Finance,Fluid Mechanics Engineer,4.657881078260883,2,2,1,1,1,0,1,1,1,4,0,2,1,0,Commerce,Bachelors,25-30,12,0,0,Remote,Tier2_City,2,2,3,2,4,0,4,18.35,Tech,3,3,1,5,4,2,4,4,4,2,0,1,5,1,54.98
Architecture,Acoustics Specialist,3.620408264011613,4,2,3,0,7,0,0,0,0,0,2,0,3,0,Interdisciplinary,PhD,25-30,8,0,0,Remote,Tier2_City,3,3,5,4,3,5,1,11.87,Education,5,2,1,4,5,4,1,4,2,3,0,1,3,1,45.32
Art,Musician,3.787012172955998,2,1,3,1,5,1,1,0,4,3,2,2,0,1,Arts,Masters,36-40,0,0,0,Flexible,Tier1_City,2,5,4,1,3,5,2,15.96,Other,2,1,3,4,0,5,5,4,4,3,1,0,2,3,49.29
Finance,Paralegal,4.589103251782541,0,1,3,0,0,0,4,2,1,0,3,1,1,1,Commerce,Bachelors,31-35,8,0,0,Office,Tier1_City,2,3,5,4,4,3,5,17.47,Other,2,3,5,4,0,2,3,5,5,1,1,1,3,2,58.81
Medicine,Graphic Designer,4.777928108465845,2,0,4,1,7,0,0,0,3,4,1,0,2,1,Science,PhD,36-40,5,1,59,Office,Tier1_City,5,5,1,1,3,1,1,32.41,Finance,2,2,1,1,0,1,4,1,1,5,0,1,5,2,48.52
Physics,Analytical Chemist,4.6175273779961215,4,0,0,1,2,0,1,2,0,2,1,3,2,0,Science,High School,36-40,3,1,55,Hybrid,Tier3_City,5,3,0,5,5,1,3,11.21,Tech,1,1,1,2,4,3,5,1,1,2,0,0,1,4,33.3
Finance,Physical Chemist,3.401021526112,4,2,0,1,6,1,1,1,0,3,4,2,3,1,Commerce,Bachelors,18-24,11,1,28,Hybrid,Tier1_City,5,3,1,5,2,2,3,37.44,Manufacturing,3,1,4,4,0,2,2,2,1,4,0,1,5,1,52.56
Biology,Biochemist,3.0466109840379083,5,0,3,1,5,0,2,3,1,0,3,0,4,1,Science,Masters,25-30,11,0,0,Remote,Tier3_City,1,3,3,1,3,2,1,17.33,Healthcare,4,5,2,3,2,1,5,1,2,4,0,0,1,3,60.88
Finance,Marketing Manager,4.072317091607683,7,0,4,1,1,0,0,3,1,2,2,2,0,1,Commerce,Masters,18-24,4,0,0,Office,Tier2_City,2,2,4,4,4,4,3,25.95,Manufacturing,3,4,4,2,4,4,3,1,4,2,0,0,3,2,46.46
Chemistry,Brand Manager,4.187680820593393,1,0,0,1,5,0,4,1,3,4,4,0,0,0,Science,High School,36-40,14,0,0,Office,Tier2_City,5,1,5,1,4,3,1,33.78,Finance,3,4,5,4,1,2,4,4,4,1,0,1,3,4,63.43
Physics,Architectural Technologist,4.40460129142906,1,1,2,1,3,1,0,3,0,3,3,3,2,1,Science,Bachelors,18-24,6,1,39,Hybrid,Any,1,3,0,2,4,2,4,28.55,Healthcare,1,5,4,5,5,5,1,4,1,2,1,1,3,1,50.34
Physics,Nurse,4.783347175352903,8,1,2,0,7,1,1,3,3,2,1,2,2,0,Science,Masters,36-40,9,0,0,Hybrid,Tier1_City,3,1,5,5,1,2,1,34.12,Finance,5,3,3,1,2,3,1,5,3,5,1,0,3,3,61.5
Engineering,Architect,3.063709500796322,7,0,1,0,3,0,4,2,4,3,4,0,4,1,Science,Masters,25-30,12,0,0,Office,Tier1_City,3,1,4,2,5,3,4,18.16,Healthcare,5,2,4,5,3,5,5,1,5,4,1,0,3,4,79.72
Music,Financial Advisor,3.278740679302926,5,2,1,1,3,0,4,3,4,2,4,3,0,1,Arts,Masters,25-30,3,0,0,Remote,Any,2,1,2,5,5,1,5,48.28,Other,1,4,3,5,0,4,2,5,4,4,0,1,1,5,71.13
Engineering,Physical Chemist,4.382527244082173,0,0,1,1,1,1,4,2,4,0,3,0,0,0,Science,Bachelors,18-24,7,0,0,Flexible,Tier2_City,5,5,4,5,1,4,5,24.57,Other,1,5,4,1,3,1,1,3,5,2,1,0,1,5,52.01
Music,Art Therapist,3.743067531495469,3,2,4,1,2,1,3,4,2,2,1,2,4,0,Arts,Bachelors,25-30,2,0,0,Hybrid,Tier1_City,2,4,4,3,5,4,3,18.13,Manufacturing,1,4,4,2,1,4,2,2,2,1,1,1,3,4,41.67
Music,Biotechnologist,4.939265032953008,6,1,1,1,0,1,1,4,4,3,1,4,2,0,Arts,Bachelors,36-40,1,0,0,Hybrid,Tier1_City,2,1,5,2,1,4,1,16.93,Manufacturing,3,4,2,5,3,2,5,2,4,1,1,0,3,2,51.33
Finance,Accountant,4.7888323891029145,6,1,0,1,5,1,1,0,3,2,1,2,2,0,Commerce,Bachelors,18-24,0,0,0,Office,Any,2,3,4,2,5,2,4,5.01,Education,1,4,3,2,1,5,4,3,2,3,0,0,1,4,39.2
Education,Financial Controller,3.588417883055004,2,2,3,1,7,0,4,0,2,3,0,4,3,1,Arts,PhD,25-30,13,0,0,Hybrid,Tier2_City,1,4,5,3,1,1,5,35.19,Finance,4,3,5,1,3,5,4,2,2,3,1,0,1,2,61.05
Biology,Game Developer,4.860714375098732,5,2,0,0,5,1,0,4,4,4,1,0,1,0,Science,Bachelors,18-24,12,0,0,Remote,Tier1_City,2,5,0,4,1,4,5,15.34,Manufacturing,2,5,1,4,1,0,1,1,4,2,0,1,3,2,60.77
Chemistry,Nurse,3.569818418185829,0,1,3,0,0,0,4,3,0,1,3,0,3,0,Science,Bachelors,25-30,5,0,0,Flexible,Any,3,2,0,2,5,3,5,48.07,Healthcare,5,4,5,5,4,0,1,5,5,2,0,0,2,3,57.23
Psychology,Organic Chemist,4.701816024498276,2,1,0,0,8,1,3,1,0,3,4,0,4,1,Arts,Masters,18-24,1,1,46,Flexible,Tier2_City,5,1,0,1,1,4,3,12.89,Tech,4,4,4,5,4,3,1,1,4,4,0,0,4,1,52.1
Finance,Legal Secretary,4.100832330474645,5,0,2,0,0,1,4,2,0,0,4,1,4,0,Commerce,Bachelors,25-30,7,0,0,Hybrid,Any,4,1,1,3,5,0,5,27.89,Tech,5,5,5,1,5,1,1,2,1,4,0,1,2,3,51.19
Chemistry,Paralegal,4.476992566384968,5,1,0,1,2,1,4,1,1,4,0,2,3,0,Science,Bachelors,36-40,14,0,0,Hybrid,Tier1_City,4,5,5,2,1,1,2,37.57,Tech,3,1,4,1,5,3,5,1,2,2,1,0,2,1,49.38
Marketing,Nuclear Physicist,2.7920632584897658,3,1,4,0,7,1,0,3,4,2,0,4,1,0,Commerce,Masters,25-30,10,1,48,Hybrid,Tier2_City,4,3,3,4,4,0,3,43.9,Education,3,3,4,4,3,2,2,2,2,3,0,1,5,1,64.3
Medicine,Architectural Technologist,4.068437763018718,0,2,3,1,6,0,1,2,4,2,3,0,1,0,Science,Masters,25-30,9,1,32,Hybrid,Tier1_City,5,3,3,2,0,1,1,10.35,Manufacturing,1,3,1,1,2,1,3,5,5,1,0,0,4,3,55.98
Marketing,Accountant,2.543052437856296,8,1,0,1,2,0,3,2,4,0,0,2,2,1,Commerce,Masters,25-30,12,0,0,Flexible,Tier2_City,2,4,4,5,5,5,2,49.31,Finance,5,2,2,3,2,0,5,2,1,4,1,0,3,1,60.53
Marketing,Legal Secretary,3.1674580320371755,5,0,1,0,1,1,1,1,4,0,0,1,2,0,Commerce,High School,18-24,3,0,0,Remote,Tier1_City,5,4,1,1,1,3,3,45.62,Finance,3,2,2,3,4,4,1,3,3,4,0,0,3,2,35.47
Finance,Zoologist,4.159936914785893,9,0,1,0,0,1,4,4,1,1,2,4,2,1,Commerce,Masters,25-30,8,1,17,Remote,Tier1_City,5,3,3,3,4,5,3,48.25,Education,3,1,1,1,0,4,1,2,5,3,1,1,2,5,67.99
Engineering,Dentist,4.270663695653249,1,2,3,1,8,0,0,1,0,3,1,1,4,0,Science,Masters,25-30,3,0,0,Flexible,Tier1_City,1,2,0,5,0,2,4,43.08,Healthcare,5,2,5,4,0,2,1,3,3,3,0,0,5,2,36.85
Architecture,Web Developer,3.397403855312784,7,0,0,0,4,0,3,0,2,3,2,0,2,0,Interdisciplinary,Bachelors,18-24,3,1,28,Remote,Tier1_City,5,3,2,4,1,2,2,44.25,Other,3,4,3,3,2,2,3,5,1,1,1,1,2,4,33.94
Physics,AI Researcher,2.5808629094510502,6,1,0,0,0,1,0,3,4,1,3,0,1,1,Science,Bachelors,31-35,12,0,0,Office,Any,1,2,5,5,0,5,2,31.14,Manufacturing,1,4,1,5,3,1,2,2,2,1,1,0,1,1,50.32
Art,Musician,4.354808188825608,6,0,1,1,9,1,4,1,3,3,2,1,0,1,Arts,Masters,25-30,11,1,21,Remote,Tier1_City,3,5,2,5,5,1,2,42.73,Manufacturing,3,2,4,4,2,0,1,5,1,4,1,1,2,3,65.36
Finance,Physician Assistant,3.449882980493029,5,0,2,0,2,1,1,3,0,0,3,3,2,0,Commerce,High School,31-35,7,0,0,Flexible,Tier2_City,1,2,3,4,0,4,5,28.1,Healthcare,4,3,2,1,5,4,4,4,1,2,0,1,2,5,35.5
Biology,Judge,3.2082147848700524,9,1,2,1,1,1,1,1,0,3,1,4,4,0,Science,Masters,36-40,11,1,20,Office,Tier2_City,4,5,1,5,2,0,5,28.3,Healthcare,4,1,2,3,4,1,1,4,5,5,0,0,1,3,63.0
Psychology,Entrepreneur,4.177222039215923,7,2,3,1,1,0,4,0,2,2,0,0,2,0,Arts,Bachelors,18-24,12,0,0,Flexible,Tier2_City,1,1,3,3,3,3,1,29.44,Manufacturing,1,4,5,4,3,5,3,2,2,3,1,1,1,1,54.15
Music,Cybersecurity Analyst,4.244837408686809,6,1,0,0,6,1,2,0,0,3,0,0,1,0,Arts,Bachelors,25-30,7,1,50,Flexible,Tier3_City,3,3,0,2,2,4,1,49.83,Manufacturing,4,1,3,5,4,5,3,4,2,2,0,0,2,5,37.75
Education,Music Teacher,4.015973204319806,8,0,3,1,1,1,1,2,2,1,1,4,4,1,Arts,High School,25-30,4,0,0,Remote,Tier3_City,5,4,1,5,5,2,1,7.91,Tech,3,2,1,1,2,5,3,1,2,5,0,1,5,1,43.49
Business,Architect,3.041874541331661,8,0,0,1,7,0,1,1,3,4,4,0,1,1,Commerce,Masters,18-24,2,0,0,Hybrid,Any,4,1,2,3,5,4,5,40.86,Finance,4,5,4,2,2,1,3,1,4,5,0,1,1,1,58.61
Finance,School Psychologist,3.4576998427875383,9,2,1,0,7,0,4,1,3,2,3,4,4,0,Commerce,Bachelors,36-40,11,0,0,Hybrid,Tier3_City,1,4,5,2,0,5,4,15.85,Tech,4,1,4,3,4,1,5,3,1,4,0,0,4,1,60.55
Marketing,Clinical Psychologist,2.5881201332239847,4,0,4,0,1,1,4,0,4,0,0,3,1,0,Commerce,Bachelors,31-35,1,1,35,Office,Tier3_City,2,2,4,2,4,5,1,19.98,Tech,3,1,3,5,3,3,1,4,2,3,0,0,1,4,46.11
Engineering,Art Director,3.328339655722809,0,0,4,1,5,1,3,3,1,3,4,2,1,0,Science,Masters,25-30,14,0,0,Remote,Tier2_City,5,3,0,5,1,0,3,6.79,Finance,5,2,5,4,3,1,4,3,4,5,0,0,3,5,73.82
Marketing,Legal Consultant,2.5594988753693304,2,1,1,1,2,1,3,2,2,1,1,4,3,1,Commerce,Masters,25-30,8,0,0,Flexible,Tier2_City,4,3,1,3,3,2,5,19.52,Education,1,2,3,3,1,5,5,4,5,2,1,0,1,4,62.94
Marketing,Biomedical Engineer,3.60217988317678,5,1,2,0,3,0,3,2,4,0,2,4,3,0,Commerce,PhD,18-24,13,0,0,Remote,Tier2_City,4,3,4,5,1,1,4,49.57,Other,5,4,5,3,4,1,2,1,4,3,0,1,1,2,71.33
Education,Special Education Teacher,4.190291206248679,9,2,0,0,5,1,2,1,3,1,4,0,1,0,Arts,Bachelors,25-30,8,1,9,Flexible,Tier1_City,1,1,0,4,4,3,3,21.66,Education,5,5,5,1,2,5,5,4,5,5,0,1,4,4,61.7
Physics,Pharmacist,4.1060710501090325,9,0,2,0,7,1,2,2,3,0,0,0,4,0,Science,Bachelors,31-35,4,0,0,Hybrid,Tier1_City,5,5,5,2,5,5,3,34.48,Education,4,5,1,5,4,5,1,1,3,5,0,1,5,2,50.01
Computer Science,Microbiologist,4.987102544390438,5,0,4,1,1,0,2,3,4,4,1,4,3,0,Science,PhD,25-30,13,0,0,Hybrid,Tier1_City,5,2,5,5,3,3,5,8.67,Education,2,1,1,3,4,1,5,1,1,2,1,0,2,5,64.95
Psychology,Market Research Analyst,2.6743530616460904,2,0,4,0,0,1,4,0,3,0,1,1,2,1,Arts,Masters,25-30,12,1,37,Hybrid,Tier1_City,2,1,2,2,2,2,2,46.36,Healthcare,5,5,4,3,0,1,3,5,4,4,1,1,4,3,58.85
Music,Physicist,4.870024572755468,6,1,2,0,8,1,0,2,0,0,3,3,2,1,Arts,Bachelors,31-35,14,1,40,Remote,Tier2_City,2,1,1,3,5,1,4,41.9,Tech,3,2,2,5,1,3,5,1,5,1,0,0,4,5,57.88
Psychology,Data Scientist,3.2123929781758944,7,0,0,1,5,1,4,3,0,2,4,2,0,0,Arts,Bachelors,25-30,7,0,0,Hybrid,Tier1_City,4,5,3,1,5,5,5,21.16,Healthcare,3,2,5,4,3,2,3,1,3,4,0,1,4,2,60.15
Psychology,Physical Chemist,3.733459416724121,6,0,3,1,8,0,4,1,0,1,3,1,2,0,Arts,Masters,25-30,6,0,0,Hybrid,Tier2_City,4,4,1,5,0,0,2,19.38,Healthcare,3,2,4,1,0,5,5,3,2,4,0,1,5,5,51.11
Art,Organic Chemist,4.8494709240002924,2,0,4,0,7,0,1,2,4,2,3,3,1,0,Arts,Bachelors,25-30,2,0,0,Hybrid,Any,3,4,1,5,4,3,5,23.32,Finance,2,1,2,3,1,3,2,4,3,1,1,0,2,5,45.84
Education,Ecologist,3.2121188159506864,5,2,3,0,6,1,3,1,3,4,2,0,1,1,Arts,Masters,25-30,11,0,0,Office,Tier2_City,4,3,0,2,0,2,5,21.86,Education,2,3,4,5,0,1,1,2,2,3,0,0,1,4,61.2
Biology,Dentist,3.147399352270246,9,2,4,1,1,0,4,1,3,0,0,0,1,1,Science,Bachelors,31-35,4,0,0,Hybrid,Tier1_City,2,1,3,3,0,3,3,15.13,Manufacturing,1,2,5,2,1,2,1,2,5,5,1,1,3,1,51.0
Finance,Mechanical Engineer,3.229099862316461,7,0,0,1,9,0,1,2,2,4,0,3,3,0,Commerce,Bachelors,36-40,14,0,0,Hybrid,Tier1_City,1,5,2,4,1,1,5,49.57,Education,2,5,2,4,1,3,5,1,1,3,1,0,4,1,51.04
Law,Curriculum Developer,3.6584349495770594,9,1,0,1,9,0,0,0,0,3,4,0,1,1,Arts,Masters,18-24,12,1,18,Flexible,Any,3,5,4,3,5,0,2,41.1,Tech,1,5,3,1,5,0,3,4,3,1,1,1,2,1,52.5
Computer Science,Cybersecurity Analyst,4.373177198776728,1,0,0,0,3,1,4,0,4,4,3,0,4,1,Science,Bachelors,36-40,8,0,0,Office,Any,4,4,2,5,4,1,3,15.59,Healthcare,3,2,1,2,4,0,2,5,5,1,1,1,5,4,61.3
Engineering,Financial Analyst,4.285172381031437,6,2,1,1,3,0,2,1,0,2,1,4,2,1,Science,Bachelors,25-30,3,1,51,Remote,Any,2,5,3,4,0,5,2,49.14,Tech,2,3,1,4,1,1,3,2,5,4,0,0,5,4,47.33
Finance,Ecologist,2.927698932891938,5,2,1,1,1,1,3,0,3,2,2,0,2,0,Commerce,Bachelors,31-35,2,0,0,Office,Tier1_City,3,4,5,3,2,4,2,3.73,Healthcare,4,1,2,3,2,1,1,3,5,3,1,0,2,2,45.3
Marketing,Music Therapist,4.861510408120699,0,2,0,1,4,1,0,0,2,2,4,0,1,1,Commerce,Bachelors,36-40,6,0,0,Flexible,Tier1_City,1,4,4,1,3,1,3,23.58,Healthcare,4,2,2,1,2,4,3,3,2,5,1,1,4,2,45.02
Psychology,Microbiologist,2.6297241187372897,8,1,0,1,9,0,1,4,1,1,2,2,0,1,Arts,Masters,25-30,7,0,0,Flexible,Any,1,1,1,2,4,1,2,29.77,Healthcare,4,1,5,4,2,0,2,3,1,2,0,1,3,1,50.03
Biology,Astronomer,2.6094765946685325,2,0,3,0,2,1,0,4,0,3,2,2,3,0,Science,Masters,36-40,4,1,24,Office,Tier1_City,2,2,4,3,1,3,1,4.77,Manufacturing,2,3,2,4,2,2,2,5,3,4,0,0,5,1,53.21
Psychology,Art Director,3.272911233696031,9,0,3,1,5,0,4,4,0,4,2,2,1,1,Arts,Masters,18-24,12,0,0,Hybrid,Tier1_City,5,3,1,3,4,1,5,10.57,Education,2,2,1,4,0,2,3,5,2,3,0,0,1,4,64.86
Music,Data Scientist,4.574054949565023,7,1,0,1,4,0,0,0,4,2,3,4,0,1,Arts,High School,18-24,7,0,0,Remote,Tier1_City,2,2,5,1,5,2,3,15.13,Healthcare,2,2,5,4,3,5,4,5,1,4,0,0,5,5,54.12
Marketing,Music Teacher,4.801292040516291,5,1,0,1,7,1,4,0,3,2,3,2,0,0,Commerce,Bachelors,31-35,4,0,0,Office,Any,2,5,3,5,1,5,3,36.85,Finance,4,2,4,2,3,5,2,4,1,1,1,0,3,4,39.82
Architecture,Paralegal,4.2026422959321685,0,1,0,0,2,0,3,1,4,0,2,2,2,0,Interdisciplinary,Bachelors,36-40,8,0,0,Office,Tier2_City,2,2,2,2,3,3,1,47.17,Other,3,4,1,1,5,4,2,4,2,2,0,0,2,3,52.13
Education,Legal Secretary,3.065562150198229,8,0,1,0,8,1,3,2,2,2,4,0,4,0,Arts,PhD,36-40,6,0,0,Remote,Any,5,2,0,3,2,3,1,32.35,Other,5,2,3,3,1,0,4,4,3,1,0,0,2,1,54.42
Finance,Special Education Teacher,3.5290424189085945,6,2,1,1,1,1,3,0,0,1,4,3,0,1,Commerce,Masters,31-35,4,1,42,Remote,Tier1_City,4,4,4,4,0,4,1,29.45,Healthcare,3,2,5,1,3,3,1,5,2,4,1,0,4,4,45.25
Physics,Zoologist,3.437270784945918,6,0,1,0,2,1,1,4,0,2,1,4,2,0,Science,Masters,25-30,12,1,34,Hybrid,Tier3_City,4,1,0,3,4,5,1,28.23,Education,2,3,3,2,0,3,5,2,1,5,1,1,5,2,58.47
Marketing,Advertising Manager,4.326872918284616,1,2,2,0,7,1,1,4,4,4,4,4,4,1,Commerce,Bachelors,25-30,8,0,0,Hybrid,Tier1_City,1,5,5,2,1,2,4,19.48,Education,5,3,2,1,2,2,5,2,3,3,0,0,1,4,65.44
Marketing,Music Teacher,3.72817068705329,7,2,1,1,8,0,0,0,4,2,2,4,3,1,Commerce,Bachelors,40+,4,1,38,Remote,Tier1_City,4,3,0,3,3,5,3,41.9,Manufacturing,5,4,4,2,2,3,5,2,5,3,1,0,4,3,52.52
Education,Curriculum Developer,4.539412019307268,7,1,0,1,9,0,2,2,3,0,1,4,4,1,Arts,Bachelors,25-30,7,0,0,Hybrid,Tier2_City,2,4,4,1,0,1,2,28.42,Healthcare,3,2,2,2,2,1,5,4,5,5,0,0,2,3,58.33
Education,Entrepreneur,4.823145627685735,0,1,1,0,9,1,4,2,2,4,3,3,4,1,Arts,Bachelors,31-35,11,1,20,Flexible,Tier2_City,4,3,0,3,3,4,3,13.81,Finance,4,5,1,2,3,1,1,4,4,3,1,0,3,1,69.67
Art,Music Therapist,3.5171573319162808,9,0,3,1,4,1,1,4,4,1,4,1,3,1,Arts,High School,25-30,3,0,0,Remote,Tier2_City,5,1,0,3,2,2,3,9.43,Manufacturing,1,1,4,2,3,4,4,2,4,2,1,0,3,1,48.32
Psychology,Musician,4.703021204493258,9,0,0,1,2,0,3,1,4,3,4,3,3,1,Arts,PhD,31-35,8,1,28,Flexible,Any,4,2,0,4,0,4,3,49.32,Manufacturing,4,2,1,4,4,3,2,5,5,5,1,1,1,3,75.18
Art,Interior Designer,4.850799312596237,5,1,4,0,7,1,3,1,1,3,4,0,2,0,Arts,Bachelors,25-30,11,1,31,Hybrid,Tier1_City,2,2,2,1,0,5,1,3.82,Healthcare,4,4,4,1,4,4,1,2,2,4,1,0,4,2,52.73
Music,Principal,2.819094938033068,9,2,2,1,8,0,4,0,0,1,0,2,0,1,Arts,Bachelors,40+,5,1,6,Remote,Tier1_City,4,1,1,1,0,0,1,46.87,Healthcare,5,5,3,5,3,0,5,2,4,4,1,0,1,5,45.13
Marketing,Mechanical Engineer,4.232103689281543,6,1,3,1,3,0,4,0,4,3,1,4,0,1,Commerce,Bachelors,25-30,5,0,0,Remote,Tier2_City,1,5,2,3,1,5,4,13.26,Manufacturing,2,3,1,2,5,3,3,1,4,2,1,1,1,2,55.55
Business,Physical Chemist,2.6254710421609784,1,1,2,0,4,1,1,3,1,0,1,3,4,1,Commerce,PhD,36-40,13,0,0,Hybrid,Any,4,4,5,4,0,1,3,33.9,Manufacturing,2,1,1,2,5,2,5,4,3,3,0,0,5,1,53.56
Architecture,Investment Banker,4.1228873437060365,9,2,3,1,6,1,4,1,2,1,4,2,2,1,Interdisciplinary,Masters,18-24,2,1,52,Remote,Tier3_City,1,2,5,3,3,4,5,17.17,Manufacturing,5,4,2,1,5,2,1,1,2,1,1,1,3,1,43.02
Law,School Psychologist,4.568023939723046,1,2,3,1,2,1,4,1,3,0,0,3,3,1,Arts,Masters,25-30,12,1,51,Office,Tier2_City,3,1,2,3,1,0,4,43.41,Tech,4,3,5,4,2,0,1,1,2,4,1,0,5,4,58.11
Architecture,Animator,4.907353795547142,9,2,0,0,9,0,3,1,3,0,4,4,1,1,Interdisciplinary,PhD,31-35,2,0,0,Office,Tier3_City,5,4,5,2,0,1,1,28.54,Manufacturing,3,2,1,3,3,1,2,3,2,5,0,0,1,5,56.31
Physics,Web Developer,4.440544123152279,2,2,3,0,1,1,0,2,4,4,2,0,2,1,Science,Bachelors,31-35,3,0,0,Flexible,Tier1_City,1,4,1,2,3,4,3,9.63,Education,1,4,4,2,0,1,3,1,3,3,1,0,5,5,44.5
Business,Data Scientist,2.99136992919746,6,2,0,1,0,0,2,1,0,1,3,2,0,1,Commerce,Masters,36-40,0,0,0,Hybrid,Tier1_City,3,1,1,4,3,4,1,15.68,Other,4,2,2,4,4,1,5,5,4,5,1,1,1,2,47.1
Art,Industrial-Organizational Psychologist,4.991493787169184,6,0,4,1,7,0,3,4,0,4,1,2,2,1,Arts,High School,18-24,5,0,0,Hybrid,Tier2_City,3,2,5,5,4,5,2,18.05,Finance,4,4,5,4,2,3,3,2,3,3,0,1,1,2,51.38
Biology,Digital Marketing Specialist,4.814170319777579,5,0,4,1,4,0,4,2,0,2,1,4,0,1,Science,Bachelors,18-24,0,1,10,Remote,Tier3_City,2,5,0,2,3,4,1,44.64,Finance,1,4,1,5,4,4,4,3,5,4,0,1,4,4,49.78
Chemistry,Digital Marketing Specialist,3.836388325076197,4,1,4,1,6,1,3,2,0,0,3,0,1,1,Science,Masters,25-30,10,1,40,Hybrid,Tier2_City,3,2,2,5,5,4,1,39.04,Other,3,2,3,2,5,0,4,5,1,5,1,1,4,1,58.57
Biology,Biomedical Engineer,3.9120118362248153,3,2,2,0,0,0,2,4,2,2,0,0,0,1,Science,Masters,18-24,3,0,0,Hybrid,Tier2_City,5,2,4,1,2,3,4,41.99,Healthcare,1,4,2,4,1,5,2,3,5,5,0,1,1,2,55.67
Physics,Graphic Designer,4.251523923725652,5,2,2,1,6,0,0,4,3,2,0,3,2,1,Science,Bachelors,40+,14,1,14,Hybrid,Tier2_City,5,2,4,2,0,4,2,5.46,Manufacturing,5,3,3,5,1,3,3,3,5,2,1,0,3,4,59.91
Chemistry,Chemical Engineer,3.231918553189168,0,2,4,0,7,1,1,3,3,0,2,1,1,1,Science,Bachelors,18-24,12,0,0,Flexible,Tier2_City,5,2,0,2,0,5,5,30.2,Finance,1,3,4,4,1,2,1,3,4,3,1,1,3,3,54.11
Law,Electrical Engineer,4.823519336628355,1,0,0,0,8,0,1,0,4,1,2,4,3,0,Arts,Bachelors,25-30,6,0,0,Hybrid,Any,5,3,2,4,0,3,5,49.96,Finance,1,1,2,5,5,4,5,1,4,4,0,1,5,3,58.33
Business,Psychologist,4.487077189929487,9,2,2,1,8,0,0,0,4,4,3,4,2,0,Commerce,High School,18-24,11,0,0,Office,Tier2_City,2,1,0,5,3,3,5,39.9,Education,4,1,2,5,5,4,1,5,1,2,1,1,2,4,54.75
Art,Art Therapist,4.19144416376117,8,0,1,0,9,0,2,1,4,1,3,1,2,0,Arts,Bachelors,25-30,5,1,21,Hybrid,Tier1_City,4,5,2,2,3,0,3,8.67,Education,4,4,2,5,3,3,4,3,4,2,1,0,3,3,56.55
Engineering,Analytical Chemist,3.545702374472427,9,1,0,0,0,0,2,3,2,0,4,3,4,0,Science,Bachelors,25-30,7,1,30,Hybrid,Tier3_City,1,5,0,2,0,1,5,34.9,Tech,2,3,5,4,4,2,3,3,2,1,1,1,5,3,49.73
Computer Science,Physician Assistant,4.892387921120665,3,0,1,1,7,0,4,0,3,3,2,3,2,0,Science,Bachelors,18-24,3,0,0,Office,Tier2_City,2,3,1,4,5,3,3,38.03,Other,1,2,5,3,0,4,2,2,5,4,0,0,4,3,58.93
Marketing,Industrial-Organizational Psychologist,2.9212477202731075,6,2,2,0,5,1,0,2,1,2,2,4,4,0,Commerce,Masters,25-30,8,0,0,Remote,Tier3_City,2,5,4,4,1,2,1,27.17,Tech,5,4,1,1,4,3,3,1,1,1,0,1,1,1,43.05
Psychology,Paralegal,3.6015037701869006,9,2,4,1,4,0,0,2,1,2,0,0,4,1,Arts,Bachelors,25-30,9,0,0,Hybrid,Any,1,3,5,5,1,3,5,6.7,Finance,2,2,3,5,5,2,4,4,1,3,0,1,2,4,39.62
Biology,Social Media Manager,3.079484448391302,3,2,3,0,6,0,1,0,4,1,1,4,1,1,Science,Bachelors,40+,7,0,0,Hybrid,Tier1_City,1,3,0,1,2,2,4,4.63,Healthcare,1,5,1,2,5,5,1,5,4,2,1,1,4,5,49.81
Engineering,Electrical Engineer,3.717426909426947,5,1,3,0,6,0,0,4,3,2,2,3,4,1,Science,Bachelors,18-24,13,0,0,Remote,Tier2_City,4,5,2,1,4,0,2,47.08,Finance,4,1,3,1,2,3,3,2,1,4,0,0,1,1,56.06
Physics,Aerospace Engineer,3.866937604509253,5,0,4,1,8,1,4,2,0,0,4,3,1,1,Science,Masters,25-30,14,0,0,Hybrid,Tier2_City,4,5,5,3,2,2,2,15.1,Healthcare,5,4,1,3,3,5,3,4,1,5,0,0,2,2,61.34
Physics,Conductor,4.61991786896183,1,1,1,1,9,1,2,1,4,1,0,1,2,0,Science,Bachelors,40+,4,1,6,Hybrid,Tier1_City,5,2,5,2,0,0,1,20.81,Finance,3,4,2,1,4,2,5,4,2,2,1,1,3,3,34.45
Art,School Counselor,4.60285851171867,4,1,4,1,8,1,0,0,3,3,1,1,1,1,Arts,Bachelors,31-35,13,0,0,Remote,Tier3_City,4,3,5,5,0,0,2,40.38,Education,2,2,2,1,3,0,2,5,5,4,0,1,4,3,55.18
Computer Science,Legal Consultant,4.414386784442627,0,1,0,0,5,0,4,4,2,0,0,1,3,0,Science,Bachelors,40+,5,0,0,Office,Tier2_City,4,4,4,2,0,0,2,35.4,Manufacturing,4,1,3,3,3,5,2,5,1,2,0,0,1,1,42.28
Computer Science,Landscape Architect,4.314054841007606,8,1,3,0,8,0,3,0,0,4,2,1,0,0,Science,Masters,40+,4,0,0,Hybrid,Tier3_City,1,1,0,5,4,2,1,48.52,Finance,3,2,2,2,0,1,5,4,1,3,0,1,4,3,46.09
Computer Science,Microbiologist,4.150538998748313,9,2,1,1,6,1,3,3,2,4,0,3,4,1,Science,Masters,25-30,14,0,0,Hybrid,Tier3_City,3,2,3,5,3,2,1,7.36,Tech,1,2,1,5,2,3,5,1,1,4,1,1,2,2,65.72
Architecture,Quantum Physicist,3.3002948432292816,9,1,3,0,6,1,4,1,3,0,4,3,0,0,Interdisciplinary,Masters,31-35,5,0,0,Hybrid,Tier1_City,5,3,4,5,4,0,1,36.23,Healthcare,5,1,5,4,0,3,4,5,3,3,1,0,4,2,61.6
Chemistry,Composer,3.266583540067,4,0,2,1,7,0,4,4,3,3,2,2,1,0,Science,PhD,18-24,0,0,0,Office,Tier3_City,5,2,5,2,2,0,4,6.86,Healthcare,4,5,4,2,5,3,1,3,2,4,1,0,2,3,58.01
Architecture,Musician,3.211044586832176,7,2,3,1,7,0,0,3,3,1,1,4,1,1,Interdisciplinary,Masters,25-30,3,0,0,Remote,Tier3_City,2,2,3,4,3,1,1,3.01,Finance,4,3,1,2,0,3,5,1,5,3,1,1,4,5,55.14
Psychology,Nuclear Physicist,4.401193897344835,5,0,0,1,2,0,2,1,1,4,2,2,1,0,Arts,Masters,36-40,8,1,38,Hybrid,Tier3_City,4,1,2,2,3,0,1,8.65,Healthcare,5,3,3,5,3,0,4,5,3,1,0,0,2,4,56.27
Physics,Animator,2.5253204656664545,8,2,1,0,2,1,2,2,3,4,2,2,3,1,Science,Bachelors,25-30,3,0,0,Hybrid,Tier2_City,4,5,1,5,2,4,1,31.99,Tech,4,5,2,2,3,5,1,3,1,4,0,0,4,3,49.41
Art,Software Developer,4.462790404179096,6,0,4,1,6,1,4,4,2,3,3,2,4,0,Arts,High School,31-35,1,0,0,Flexible,Tier2_City,1,5,1,3,3,1,5,34.78,Education,4,1,4,2,0,1,3,5,4,3,1,1,4,1,52.86
Music,Market Research Analyst,4.396061631900579,2,2,2,0,9,0,4,4,3,0,2,4,1,1,Arts,PhD,31-35,5,1,29,Hybrid,Tier1_City,4,1,2,1,1,1,5,23.6,Manufacturing,1,4,4,1,5,5,5,5,1,4,0,0,4,4,62.44
Education,Biochemist,3.4694458105964845,2,1,3,0,4,1,2,3,3,0,0,0,0,0,Arts,Bachelors,25-30,1,0,0,Remote,Any,2,2,3,5,2,1,4,5.17,Manufacturing,2,1,2,1,1,1,2,1,2,5,1,0,2,4,40.87
Computer Science,Manager,4.209743906097742,7,1,3,1,2,1,0,3,4,2,4,3,3,0,Science,Bachelors,36-40,2,0,0,Hybrid,Tier2_City,1,3,5,3,2,4,4,32.8,Healthcare,3,2,1,3,1,4,2,3,1,5,0,1,2,2,49.33
Architecture,Physicist,4.180342502783571,3,1,0,1,1,1,0,0,1,4,1,3,4,0,Interdisciplinary,Masters,25-30,6,0,0,Hybrid,Tier2_City,5,5,1,4,1,1,2,7.03,Finance,5,1,2,3,0,0,3,4,4,3,0,1,2,3,51.0
Chemistry,Psychologist,2.9991493722300926,4,2,1,0,9,0,0,3,0,4,1,4,3,0,Science,Bachelors,18-24,3,0,0,Remote,Tier1_City,4,4,5,5,4,1,5,9.66,Healthcare,3,3,5,3,3,1,3,2,3,5,0,1,1,1,49.56
Architecture,Marketing Manager,2.610275354230692,8,0,4,1,3,0,4,4,1,1,3,3,2,1,Interdisciplinary,Masters,36-40,0,0,0,Flexible,Tier2_City,4,3,1,3,4,2,4,27.09,Tech,5,4,3,4,3,1,3,4,2,3,0,0,4,1,53.78
Business,Brand Manager,3.974642206048773,5,1,4,1,4,1,3,0,3,2,4,4,3,0,Commerce,Masters,25-30,8,0,0,Remote,Tier1_City,2,2,3,5,4,5,4,19.0,Other,5,5,2,5,2,2,4,3,3,5,0,1,2,4,70.62
Architecture,Financial Analyst,3.683071375811689,5,0,4,1,5,1,3,3,1,3,1,0,4,0,Interdisciplinary,Bachelors,31-35,5,1,28,Remote,Any,2,4,0,2,3,2,2,24.84,Finance,4,1,1,4,3,5,3,2,4,2,0,0,3,4,48.49
Business,Art Therapist,4.086716987609702,7,1,3,1,0,0,4,2,4,3,1,1,1,1,Commerce,Masters,25-30,8,1,46,Remote,Any,1,3,1,3,1,0,1,32.85,Education,1,4,5,4,5,2,4,1,5,2,1,1,3,1,67.57
Medicine,Interior Designer,3.21419857622871,4,2,2,1,5,0,2,0,4,0,4,2,0,0,Science,Bachelors,25-30,2,0,0,Office,Tier1_City,5,1,1,2,2,0,3,10.52,Tech,5,4,5,3,4,0,5,2,3,4,0,0,1,3,49.31
Physics,Data Scientist,4.069435860634518,2,2,4,1,2,0,3,0,0,0,4,2,2,1,Science,Bachelors,36-40,4,0,0,Hybrid,Tier2_City,2,4,0,2,2,3,2,44.98,Education,3,3,1,5,5,0,5,1,3,3,1,1,4,3,44.87
Law,Advertising Manager,2.848083720169214,8,2,0,0,5,1,1,4,2,3,3,0,0,0,Arts,Bachelors,25-30,8,0,0,Remote,Tier2_City,2,2,3,3,2,5,3,29.3,Finance,2,2,3,4,4,1,4,1,1,5,1,1,4,3,55.61
Business,Sound Engineer,4.626611767655325,6,1,3,1,8,1,1,4,0,3,0,3,3,1,Commerce,Masters,25-30,5,0,0,Flexible,Tier3_City,5,4,3,1,3,4,2,4.04,Education,3,4,4,1,3,2,1,4,2,4,0,1,5,4,48.06
Biology,Biotechnologist,4.634411584727199,6,2,3,1,7,1,0,4,2,2,3,1,3,0,Science,Masters,18-24,1,0,0,Remote,Tier3_City,3,1,0,3,3,2,2,32.54,Tech,1,4,5,4,0,2,1,2,2,2,0,1,3,5,43.23
Law,Architect,4.351018939308852,4,2,2,0,8,1,2,1,1,2,2,3,3,0,Arts,Bachelors,36-40,14,0,0,Hybrid,Any,1,5,1,1,5,0,1,24.77,Tech,2,1,1,1,5,1,5,1,5,2,0,1,3,5,55.69
Finance,Actuary,3.0229652127680446,5,2,1,1,8,1,2,0,4,4,2,2,1,0,Commerce,Masters,18-24,0,0,0,Remote,Tier1_City,3,5,0,5,4,4,4,35.98,Healthcare,4,5,5,4,5,1,5,2,5,3,1,1,4,3,58.96
Law,Illustrator,3.423331469074502,0,2,0,0,2,0,2,3,1,4,1,4,3,1,Arts,Bachelors,36-40,8,0,0,Flexible,Tier1_City,5,5,2,5,5,1,5,39.85,Other,3,1,4,5,4,4,1,3,3,2,1,0,2,4,59.14
Physics,Architectural Technologist,3.3063732558729413,8,2,3,1,2,1,4,3,1,4,4,4,4,1,Science,PhD,25-30,0,0,0,Office,Tier2_City,4,1,5,3,5,4,2,47.13,Finance,3,3,1,1,3,3,1,4,5,4,1,1,5,4,68.02
Psychology,Special Education Teacher,2.957443546552528,4,2,2,1,6,0,0,4,1,4,3,4,0,0,Arts,Bachelors,31-35,13,0,0,Office,Tier3_City,1,3,0,5,3,2,1,49.92,Manufacturing,5,4,5,1,3,5,4,3,2,4,1,1,2,4,59.59
Marketing,Marketing Manager,4.422434873589557,9,0,2,1,2,1,3,1,3,1,2,1,1,1,Commerce,Masters,36-40,14,0,0,Remote,Tier1_City,5,1,5,4,4,5,3,28.83,Other,5,2,1,3,4,0,1,2,2,4,1,0,2,4,63.59
Business,Pharmacist,3.62292106700334,1,0,2,1,2,0,4,3,2,2,1,3,1,1,Commerce,High School,18-24,4,0,0,Hybrid,Tier1_City,5,4,4,2,4,3,4,29.39,Manufacturing,2,4,1,1,3,0,2,5,3,1,0,1,4,5,45.9
Art,Artist,3.605550691323652,1,1,0,0,8,1,1,4,0,1,3,2,2,0,Arts,Bachelors,25-30,0,0,0,Hybrid,Tier3_City,1,3,3,2,2,2,2,4.05,Education,4,2,4,4,0,4,1,2,3,3,0,1,1,5,43.32
Physics,Analytical Chemist,4.607984852657847,7,0,1,1,4,0,1,2,0,2,2,1,1,0,Science,Bachelors,31-35,4,0,0,Hybrid,Tier3_City,3,5,1,1,3,5,3,43.66,Manufacturing,5,2,1,4,5,2,1,1,4,2,0,0,4,3,42.67
Music,Web Developer,3.89917107740457,3,1,4,0,1,1,1,3,4,2,3,2,4,0,Arts,Masters,31-35,4,0,0,Hybrid,Tier1_City,4,1,1,5,4,0,2,4.35,Manufacturing,3,2,3,3,1,5,2,4,2,1,0,1,2,4,55.21
Physics,Organic Chemist,4.250395661244722,8,0,2,0,2,0,4,0,0,1,3,1,4,0,Science,Bachelors,25-30,6,0,0,Flexible,Any,3,2,2,1,5,0,5,32.74,Tech,2,5,5,2,5,3,3,5,5,4,0,0,4,5,57.45
Engineering,Biologist,3.4289079044566924,3,1,4,1,5,1,4,1,0,0,4,1,2,1,Science,PhD,31-35,6,0,0,Remote,Tier1_City,2,5,1,2,1,4,5,7.63,Tech,5,1,2,1,4,2,2,2,4,3,0,0,4,2,53.98
Music,Lawyer,3.7415558769998745,9,1,0,0,5,1,4,2,1,4,4,2,4,1,Arts,Bachelors,31-35,10,0,0,Hybrid,Tier1_City,3,2,2,2,1,2,4,16.43,Tech,5,3,3,1,4,4,5,4,1,1,1,1,1,1,53.51
Computer Science,Acoustics Specialist,4.063892378373084,7,0,2,0,7,0,4,0,1,2,1,4,3,1,Science,Bachelors,36-40,9,1,26,Hybrid,Tier1_City,2,3,2,5,3,0,3,9.6,Manufacturing,1,5,3,1,3,4,5,1,5,2,0,0,5,2,55.54
Art,AI Researcher,2.650950636406607,4,0,0,0,9,0,4,0,1,0,2,3,1,0,Arts,Bachelors,31-35,0,0,0,Office,Any,1,5,3,4,2,1,5,9.46,Education,2,5,1,4,0,4,5,2,1,2,1,0,5,2,34.99
Engineering,Organic Chemist,4.447192908987361,7,2,0,1,1,1,4,3,3,0,0,0,4,0,Science,Masters,25-30,8,0,0,Remote,Tier2_City,2,1,2,4,2,1,1,6.51,Finance,2,2,3,5,4,0,3,3,4,5,1,0,2,2,62.53
Psychology,Physician Assistant,4.910993088926731,3,0,1,0,4,1,3,2,1,2,2,1,4,0,Arts,Bachelors,40+,0,0,0,Remote,Tier1_City,5,2,3,5,4,3,4,17.94,Healthcare,4,5,3,5,3,0,3,5,2,3,1,0,5,2,41.21
Art,Industrial-Organizational Psychologist,2.7910355707906103,5,1,4,0,0,0,1,3,0,2,3,3,0,0,Arts,Masters,25-30,4,0,0,Hybrid,Tier1_City,2,1,5,5,3,4,2,22.91,Education,5,3,3,5,3,2,5,4,2,5,0,0,2,2,57.37
Business,Musician,2.818949699074583,3,1,0,1,0,0,2,0,1,0,3,0,0,1,Commerce,PhD,18-24,6,0,0,Flexible,Tier3_City,5,5,5,1,1,0,3,24.83,Tech,2,3,1,3,5,5,1,2,1,4,1,1,3,5,48.1
Art,Game Developer,3.7677087918025176,5,2,0,0,8,1,2,1,4,1,3,4,0,1,Arts,PhD,25-30,11,1,45,Flexible,Tier2_City,5,1,2,5,5,3,3,23.67,Education,4,4,3,3,5,1,4,4,2,2,0,0,1,3,68.8
Chemistry,Sound Engineer,3.046698153873897,8,1,4,0,3,0,2,4,3,3,1,3,0,0,Science,Bachelors,18-24,7,1,10,Remote,Any,3,5,5,4,4,1,1,27.61,Finance,5,5,2,4,3,0,4,5,3,4,1,1,5,1,62.05
Physics,Quantum Physicist,4.161292696157194,0,2,3,0,7,0,1,3,4,2,3,0,4,0,Science,Masters,18-24,1,0,0,Remote,Tier3_City,4,4,0,5,5,3,5,43.41,Other,3,4,3,5,2,5,3,3,4,5,0,0,2,5,62.8
Medicine,Music Teacher,4.498569155902896,5,0,3,1,1,0,3,1,2,0,1,4,2,1,Science,Masters,25-30,13,0,0,Hybrid,Tier1_City,3,1,3,1,4,3,3,32.69,Tech,1,3,1,2,2,3,3,2,5,2,0,1,1,3,59.78
Finance,Entrepreneur,3.730216766121126,4,2,1,1,8,0,0,0,4,3,3,1,4,0,Commerce,Bachelors,18-24,0,0,0,Hybrid,Tier3_City,3,4,4,1,0,0,1,3.81,Finance,4,5,1,1,0,3,4,5,4,3,0,0,2,2,40.87
Engineering,Financial Advisor,3.680133180833637,3,2,3,1,7,1,4,3,2,3,0,2,4,0,Science,Masters,31-35,3,0,0,Office,Tier1_City,5,2,0,1,5,0,1,11.13,Other,1,2,4,5,1,3,1,1,1,1,1,0,1,2,51.59
Engineering,Biologist,2.78500108337664,6,1,2,1,6,1,0,0,0,2,1,0,1,1,Science,High School,18-24,11,1,29,Hybrid,Any,4,1,2,1,3,0,2,19.4,Healthcare,3,2,4,2,2,4,1,2,1,4,0,0,4,5,37.27
Engineering,Manager,2.587644911143169,2,2,0,0,1,1,3,2,0,3,0,2,2,0,Science,Bachelors,18-24,14,0,0,Hybrid,Tier1_City,5,1,4,3,5,4,1,47.61,Education,2,5,2,1,0,2,3,1,2,4,1,0,3,5,51.66
Engineering,Urban Planner,4.704313883194376,1,0,1,0,5,0,0,2,0,3,4,0,2,0,Science,Bachelors,18-24,3,0,0,Hybrid,Tier1_City,4,2,3,5,5,3,4,6.67,Healthcare,5,4,5,1,3,4,1,3,1,2,0,1,3,3,38.61
Music,Conductor,3.982494473462938,6,0,3,1,0,0,2,2,3,4,2,1,4,1,Arts,Bachelors,18-24,9,0,0,Remote,Tier2_City,2,1,4,2,4,3,3,36.38,Manufacturing,2,4,4,3,3,3,4,3,5,2,0,0,5,2,62.12
Computer Science,Construction Manager,3.816841681633597,3,1,2,0,0,1,4,2,1,0,1,3,3,1,Science,Bachelors,25-30,11,0,0,Office,Tier1_City,5,5,4,5,1,4,4,4.56,Education,1,2,3,2,1,3,3,2,4,5,1,0,1,1,60.47
Computer Science,Manager,4.34107374662922,0,1,1,1,6,1,1,3,4,4,1,4,0,1,Science,Bachelors,25-30,5,1,56,Hybrid,Tier1_City,3,4,2,3,0,1,1,20.04,Other,2,4,1,5,4,4,2,4,5,4,0,1,1,5,63.58
Physics,Organic Chemist,4.617344966929009,4,0,0,0,3,1,2,1,0,1,0,0,4,0,Science,Masters,40+,0,1,18,Office,Tier2_City,5,3,0,1,5,2,1,39.2,Manufacturing,2,2,4,5,2,3,3,4,4,4,0,1,2,3,41.08
Finance,Urban Planner,4.486984204992104,4,2,3,0,9,1,1,0,3,3,4,4,2,1,Commerce,Bachelors,36-40,13,1,16,Remote,Tier2_City,1,5,4,3,1,1,4,19.16,Finance,4,1,1,4,2,3,5,4,2,4,1,1,4,1,60.78
Finance,Microbiologist,3.560321274999754,0,0,3,1,3,1,4,1,4,4,0,2,4,1,Commerce,Bachelors,36-40,0,0,0,Hybrid,Tier2_City,1,3,0,4,2,4,2,23.22,Manufacturing,4,2,3,2,3,2,1,4,1,1,1,1,5,1,38.74
Law,Animator,2.8175065349080435,9,2,2,1,4,1,3,0,3,4,4,3,4,1,Arts,Bachelors,18-24,2,0,0,Flexible,Any,1,2,5,4,0,3,1,45.55,Other,3,1,1,1,0,3,1,5,4,4,1,0,2,1,51.97
Biology,Pharmacist,3.11041862788353,0,2,3,1,5,1,2,3,1,3,1,0,2,1,Science,Masters,25-30,4,1,30,Hybrid,Tier2_City,3,2,4,5,0,3,4,6.11,Other,4,5,1,3,5,4,4,2,3,5,0,1,2,5,49.63
Biology,Construction Manager,3.962834714504104,0,1,2,1,9,0,0,2,0,4,4,3,1,1,Science,Masters,18-24,11,1,52,Flexible,Any,3,1,3,5,4,0,4,27.8,Finance,4,1,4,4,1,4,3,4,3,4,1,0,4,3,67.62
Psychology,Principal,3.05941393284449,8,2,1,0,9,1,2,3,3,0,3,3,1,0,Arts,Masters,31-35,5,0,0,Office,Tier1_City,1,5,2,2,5,0,3,20.21,Healthcare,4,3,1,3,1,1,4,3,3,5,1,1,5,2,65.06
Architecture,Mechanical Engineer,4.096380723769634,1,2,0,1,6,1,4,0,1,4,3,1,4,1,Interdisciplinary,Masters,18-24,4,1,45,Flexible,Tier1_City,3,3,4,2,2,3,2,48.3,Tech,4,4,3,1,4,3,3,2,3,2,1,1,4,2,50.44
Finance,Organic Chemist,4.75696414234632,6,1,0,1,5,1,3,3,1,1,1,0,1,1,Commerce,Bachelors,25-30,12,0,0,Hybrid,Tier2_City,3,4,2,4,4,3,5,40.3,Healthcare,3,1,2,1,4,1,3,4,5,5,1,1,4,3,60.3
Law,Art Therapist,4.824759288882647,6,0,4,0,0,0,1,4,0,3,0,2,0,1,Arts,Masters,18-24,12,0,0,Remote,Tier1_City,3,5,5,1,3,5,4,8.74,Manufacturing,4,3,1,3,5,5,2,1,1,4,1,1,2,5,54.5
Medicine,Doctor,3.566339126681098,0,1,4,0,6,1,2,2,4,1,4,1,3,1,Science,Bachelors,18-24,12,0,0,Office,Tier1_City,1,2,5,3,1,0,3,46.59,Finance,4,3,1,4,0,4,1,2,4,3,1,1,4,5,61.92
Engineering,Pharmacist,4.292240590844771,7,2,4,1,7,0,4,3,3,1,0,0,2,0,Science,Bachelors,40+,4,0,0,Office,Any,2,5,0,2,1,0,5,12.93,Manufacturing,1,4,3,1,0,1,5,4,3,2,0,0,2,1,39.62
Law,Paralegal,2.921607766064735,1,1,4,0,7,0,1,3,3,4,4,3,4,1,Arts,Masters,31-35,8,1,16,Hybrid,Tier2_City,2,4,4,2,4,1,3,6.99,Other,4,2,5,5,1,5,5,5,3,1,1,0,2,3,63.36
Computer Science,Civil Engineer,4.006296553169766,8,0,2,1,6,1,1,0,4,4,3,1,2,0,Science,High School,36-40,1,0,0,Hybrid,Tier1_City,4,5,3,1,1,3,3,28.45,Tech,3,3,3,5,3,3,1,1,4,1,0,0,4,5,43.37
Psychology,Marketing Manager,3.5474701441619905,7,1,2,0,6,0,1,0,2,2,0,2,1,1,Arts,Masters,25-30,11,1,39,Flexible,Tier3_City,5,1,1,1,5,3,2,37.62,Education,3,1,4,5,0,0,4,1,2,3,0,0,3,1,54.02
Business,Curriculum Developer,3.8599676292633607,9,0,1,0,3,1,4,4,3,1,0,4,2,1,Commerce,Masters,36-40,11,0,0,Remote,Tier1_City,2,4,0,5,1,4,1,36.65,Education,2,4,4,4,5,2,5,3,5,3,1,0,1,4,70.84
Education,Counselor,3.4498698375751022,1,1,4,1,2,0,3,2,2,3,2,0,1,1,Arts,Bachelors,31-35,0,0,0,Hybrid,Tier2_City,4,3,2,3,5,1,2,28.1,Education,4,1,2,4,0,5,2,4,5,2,0,0,4,2,47.05
Engineering,Advertising Manager,4.663888266708732,4,2,1,0,2,1,1,1,4,4,1,2,0,0,Science,Bachelors,36-40,5,1,9,Remote,Tier1_City,2,2,0,1,3,2,5,26.16,Manufacturing,5,2,1,2,4,3,2,4,1,4,0,1,1,2,49.57
Psychology,Market Research Analyst,4.933456302912621,5,1,4,1,2,0,1,4,1,1,1,0,0,0,Arts,Bachelors,25-30,8,0,0,Remote,Tier1_City,1,5,3,2,2,2,2,48.57,Education,2,4,2,2,4,1,2,2,3,2,0,0,2,4,45.93
Psychology,Surgeon,3.495779776989853,7,1,2,0,4,1,4,0,4,4,4,0,1,0,Arts,PhD,25-30,6,1,16,Hybrid,Tier1_City,4,4,5,2,0,2,1,41.57,Finance,3,3,2,5,5,1,5,3,1,1,0,1,1,4,59.71
Physics,Counselor,4.681550524445111,2,0,1,0,0,0,3,0,2,1,4,3,4,1,Science,Masters,31-35,7,0,0,Office,Any,1,1,2,4,4,5,2,35.84,Tech,2,1,1,3,4,5,2,1,1,2,0,0,3,2,52.3
Education,Lawyer,2.570222149726261,2,2,4,1,6,1,1,2,2,2,4,4,2,0,Arts,Bachelors,25-30,4,0,0,Office,Tier1_City,1,1,2,1,4,0,2,12.17,Other,5,1,1,3,3,1,2,5,1,4,0,0,3,5,49.79
Education,Brand Manager,4.603432440473094,2,2,4,1,2,0,3,3,0,2,4,2,0,0,Arts,Bachelors,36-40,9,0,0,Flexible,Tier2_City,4,3,2,5,5,2,2,41.53,Healthcare,1,3,3,5,1,5,4,4,1,4,0,1,1,2,63.26
Computer Science,Conductor,2.5575091232583365,9,2,1,0,6,1,3,3,2,1,4,2,4,0,Science,Masters,40+,3,1,59,Remote,Tier1_City,4,2,1,3,3,4,4,38.24,Other,5,3,2,2,3,4,1,1,4,1,0,1,2,5,55.85
Biology,Dentist,4.132476590760399,2,2,0,1,3,1,4,1,1,3,0,4,3,1,Science,Masters,25-30,5,0,0,Hybrid,Tier1_City,2,1,5,5,3,0,4,49.63,Finance,2,2,2,4,4,3,5,4,4,5,1,0,5,2,60.63
Education,Artist,4.634944556845637,5,2,4,1,6,1,2,3,2,3,3,1,0,1,Arts,High School,25-30,2,0,0,Remote,Tier2_City,2,2,5,2,0,0,2,9.25,Tech,4,2,4,3,2,1,1,4,4,1,1,0,1,1,39.01
Business,Curriculum Developer,3.472018732568208,7,2,4,1,3,1,0,0,0,3,2,0,4,0,Commerce,Bachelors,25-30,0,1,46,Remote,Tier2_City,5,4,1,5,2,2,1,36.62,Healthcare,1,3,2,4,2,0,2,5,1,5,0,1,4,5,35.09
Psychology,Credit Analyst,3.694378154175612,6,0,3,1,0,0,1,1,4,1,0,4,1,0,Arts,Masters,36-40,10,0,0,Remote,Tier3_City,2,5,2,2,4,0,1,49.02,Education,5,4,3,5,1,3,4,5,3,4,0,1,3,1,66.83
Architecture,Quantum Physicist,3.108016706763466,5,2,0,1,6,1,1,1,2,4,1,3,3,1,Interdisciplinary,High School,31-35,3,1,31,Remote,Any,4,3,1,2,5,1,1,24.74,Healthcare,4,3,5,4,4,4,1,5,5,4,1,0,4,1,50.34
Finance,Pharmacist,2.9570096939161044,0,0,1,0,6,1,2,3,1,3,0,0,0,1,Commerce,Bachelors,18-24,8,0,0,Hybrid,Tier1_City,2,1,2,2,3,1,1,37.47,Manufacturing,5,3,2,3,5,3,3,2,3,4,1,0,2,1,52.5
Business,Risk Analyst,3.489570905421311,2,1,1,0,1,1,3,1,1,4,0,2,4,0,Commerce,PhD,25-30,3,0,0,Remote,Tier1_City,4,5,3,2,4,2,3,48.84,Manufacturing,3,5,3,2,4,5,5,5,1,3,1,0,5,1,47.8
Marketing,Landscape Architect,3.10163235006944,5,1,1,1,2,0,3,2,2,4,3,4,2,0,Commerce,Masters,18-24,0,0,0,Hybrid,Any,5,1,2,2,5,4,2,28.73,Education,4,4,3,3,3,5,2,5,2,2,1,1,2,2,52.74
Business,Quantum Physicist,2.501905780797728,2,1,0,0,4,0,3,0,3,1,0,1,3,1,Commerce,Bachelors,31-35,13,0,0,Flexible,Any,4,3,1,4,1,0,2,35.85,Education,3,4,5,1,1,4,2,5,4,5,0,0,5,4,56.23
Medicine,Special Education Teacher,3.383281641056384,0,2,3,1,1,0,1,2,4,2,3,2,0,1,Science,Bachelors,25-30,3,0,0,Office,Tier2_City,5,1,3,5,4,3,3,3.94,Finance,1,2,3,4,3,4,3,5,3,2,1,0,3,3,49.33
Engineering,Doctor,2.7361339514463063,8,2,4,1,8,0,0,3,0,0,0,1,1,0,Science,High School,25-30,6,0,0,Office,Tier2_City,5,3,3,4,2,2,1,27.42,Finance,1,2,4,4,5,2,2,3,4,2,0,1,4,1,33.2
Engineering,Music Teacher,2.712390000947705,7,1,2,1,0,1,0,3,2,3,0,2,0,0,Science,Bachelors,31-35,2,0,0,Office,Tier1_City,5,5,1,4,5,5,5,15.02,Other,1,2,5,4,4,2,1,2,3,1,0,0,3,2,43.79
Law,Cybersecurity Analyst,3.0170151357219543,2,0,3,0,7,0,4,4,0,0,0,0,2,0,Arts,Masters,18-24,9,0,0,Hybrid,Tier2_City,1,4,2,1,2,0,5,9.17,Manufacturing,1,1,4,5,5,0,2,4,2,1,1,1,2,3,48.98
Marketing,Manager,3.0689180912546465,5,1,0,0,2,1,0,2,1,3,0,1,1,0,Commerce,Bachelors,18-24,5,0,0,Office,Tier1_City,3,3,1,1,4,2,3,36.3,Tech,3,4,2,5,0,1,1,2,3,5,1,0,1,2,50.55
Computer Science,Social Media Manager,4.023980418128779,0,0,4,1,9,1,4,4,3,2,4,1,4,1,Science,Masters,25-30,14,0,0,Office,Any,4,4,0,1,1,2,5,4.84,Finance,3,5,2,3,2,3,1,2,4,1,1,0,5,1,70.32
Psychology,Music Therapist,3.839530552757751,4,2,4,0,3,0,2,2,4,0,1,2,4,0,Arts,PhD,18-24,13,0,0,Remote,Tier1_City,2,2,1,3,2,4,4,45.53,Tech,2,2,3,2,4,1,5,2,2,1,0,0,1,2,53.9
Engineering,Physical Chemist,4.991850741488952,4,2,1,1,3,0,2,1,0,3,3,3,4,1,Science,Bachelors,25-30,0,1,31,Flexible,Tier1_City,3,5,3,1,3,3,2,27.34,Other,2,2,3,1,0,3,5,5,4,5,0,0,3,3,46.25
Computer Science,Conductor,3.0838481303121705,9,0,3,1,9,0,3,2,2,1,0,4,1,1,Science,Bachelors,40+,10,0,0,Hybrid,Tier2_City,3,3,2,5,5,0,5,33.47,Manufacturing,3,2,5,2,2,0,5,2,5,2,0,0,5,4,57.7
Physics,School Counselor,2.650737737078272,5,1,0,1,0,1,1,3,1,1,0,1,0,1,Science,Bachelors,36-40,3,0,0,Remote,Tier1_City,1,5,4,4,4,2,4,14.91,Finance,1,2,2,2,0,0,5,3,1,3,1,0,2,1,36.48
Medicine,Digital Marketing Specialist,3.25422173876009,9,0,3,0,6,0,2,2,0,0,0,0,0,1,Science,PhD,36-40,2,0,0,Hybrid,Tier2_City,4,4,2,5,1,2,2,11.56,Tech,2,2,1,1,1,3,3,4,5,2,0,1,2,1,37.83
Business,Judge,4.361405355301505,0,0,1,1,1,0,4,4,4,3,3,3,3,0,Commerce,Masters,36-40,13,0,0,Office,Any,4,4,3,1,3,0,4,14.46,Other,4,1,3,5,0,4,3,2,1,5,1,1,4,1,79.73
Architecture,Financial Controller,3.2653273910527383,8,0,3,0,0,1,0,3,4,2,3,3,0,1,Interdisciplinary,Bachelors,25-30,0,0,0,Hybrid,Tier2_City,2,5,5,3,4,2,2,13.92,Tech,3,5,5,4,5,2,4,4,1,2,0,0,2,2,45.42
Chemistry,Electrical Engineer,4.77755472084953,6,1,0,1,5,0,1,2,4,2,4,3,2,1,Science,Masters,25-30,2,1,30,Remote,Any,1,5,2,3,1,2,2,43.63,Finance,4,4,3,5,0,3,1,1,5,1,0,1,3,5,56.92
Marketing,Education Administrator,3.8513562566299138,8,2,3,1,5,1,3,2,4,4,3,4,3,1,Commerce,Masters,18-24,14,1,56,Hybrid,Tier1_City,3,4,3,4,3,2,5,40.0,Education,1,5,5,4,1,4,4,1,2,3,1,1,4,1,70.38
Marketing,Web Developer,2.816863345595383,6,1,4,0,6,1,4,0,0,4,4,3,0,0,Commerce,PhD,36-40,3,1,47,Hybrid,Tier1_City,4,5,4,5,2,1,3,43.08,Other,3,3,2,4,0,3,3,2,1,4,1,0,4,1,56.65
Chemistry,Microbiologist,2.840923011262104,4,1,0,1,6,0,3,0,4,0,4,0,2,0,Science,Bachelors,31-35,4,0,0,Flexible,Any,1,4,5,2,4,1,5,37.54,Other,2,4,3,5,2,3,4,3,3,1,1,0,3,2,51.71
Physics,Art Therapist,3.690371376598685,3,1,0,1,3,0,0,1,4,4,0,3,4,1,Science,Bachelors,18-24,5,0,0,Office,Tier1_City,5,2,5,5,4,3,1,33.25,Healthcare,2,2,3,2,0,5,1,1,5,5,1,1,3,2,56.56
Chemistry,Data Scientist,4.813250292794699,2,2,0,1,1,1,0,2,4,4,1,1,2,0,Science,Masters,25-30,1,1,31,Office,Tier3_City,4,4,1,1,2,4,4,27.81,Education,4,3,1,4,5,3,5,1,3,5,1,1,2,1,54.79
Medicine,Principal,4.972957258756996,4,0,3,0,0,0,1,3,2,4,4,0,1,0,Science,Bachelors,25-30,1,0,0,Remote,Tier2_City,3,1,5,2,0,0,1,15.48,Other,3,3,2,5,5,3,2,3,2,2,1,0,2,5,44.36
Art,Market Research Analyst,4.32624952729044,1,0,4,0,7,0,1,4,4,4,3,4,0,0,Arts,Bachelors,25-30,5,1,19,Hybrid,Tier2_City,5,4,0,3,3,4,2,36.15,Healthcare,1,3,5,2,0,3,3,5,2,4,0,0,5,2,60.52
Physics,Manager,4.256735821346012,9,0,1,1,6,1,3,0,4,3,3,4,1,0,Science,Bachelors,36-40,4,0,0,Hybrid,Tier2_City,5,2,2,4,2,4,5,9.42,Tech,5,3,1,1,1,4,1,2,5,4,1,0,4,2,62.02
Medicine,Nurse,3.230642497959786,0,1,4,0,5,0,2,4,3,2,2,1,0,1,Science,Bachelors,25-30,0,1,27,Hybrid,Tier3_City,5,4,4,4,4,1,1,27.02,Finance,5,2,5,4,2,0,2,1,3,2,0,0,2,1,48.76
Architecture,Dentist,4.765990759817573,4,1,3,1,0,1,1,2,0,4,3,1,3,0,Interdisciplinary,Bachelors,36-40,2,1,16,Remote,Any,3,5,2,3,3,3,1,12.18,Other,1,3,3,2,1,5,3,3,4,1,1,1,4,5,39.65
Biology,Social Media Manager,4.045896298748595,5,0,4,1,8,0,2,4,3,2,3,4,2,0,Science,PhD,25-30,10,0,0,Hybrid,Tier1_City,1,2,0,1,3,4,1,26.72,Manufacturing,2,5,4,4,0,2,1,1,1,3,0,0,4,3,68.53
Medicine,Financial Analyst,2.6348584386032154,8,0,3,1,4,0,3,3,2,1,3,4,4,0,Science,Bachelors,31-35,4,0,0,Hybrid,Tier2_City,4,3,0,3,0,4,2,16.81,Finance,5,2,3,2,1,2,3,4,4,4,1,0,1,3,52.33
Marketing,Software Developer,4.546613325246733,4,2,0,1,6,1,3,3,3,1,0,1,2,1,Commerce,Bachelors,36-40,14,0,0,Hybrid,Tier1_City,1,4,0,1,4,2,2,5.51,Education,1,3,2,1,5,4,1,1,4,2,0,0,5,1,56.41
Finance,Doctor,2.806371073686403,0,1,0,0,2,1,0,1,4,0,3,4,2,0,Commerce,Masters,36-40,12,1,23,Remote,Tier3_City,3,5,4,2,1,0,2,26.67,Healthcare,4,3,5,4,1,4,3,4,5,3,0,1,1,5,64.12
Law,Actuary,3.092666866544823,9,2,1,1,2,0,0,4,2,0,4,3,4,0,Arts,Bachelors,18-24,11,1,36,Hybrid,Tier1_City,2,3,5,3,0,3,1,11.55,Finance,2,5,1,5,0,3,3,5,4,2,0,1,5,5,57.56
Art,Game Developer,4.048212611334565,9,2,2,1,5,0,2,0,4,4,3,3,2,1,Arts,Bachelors,18-24,11,0,0,Office,Tier2_City,4,3,0,1,0,0,4,10.57,Healthcare,1,1,3,2,0,0,5,3,4,3,0,1,1,2,60.18
Psychology,Art Therapist,4.399706662211987,2,2,4,0,3,0,4,4,1,0,0,1,2,0,Arts,Masters,25-30,1,0,0,Hybrid,Tier1_City,4,3,0,2,1,1,5,21.07,Education,4,1,5,1,5,5,1,5,1,3,0,0,1,1,34.85
Education,Quantum Physicist,4.652036180893411,1,2,4,0,9,0,0,0,3,4,3,0,2,1,Arts,Masters,25-30,0,1,40,Office,Tier1_City,2,1,5,3,1,4,5,20.0,Education,3,5,1,4,5,0,4,4,2,1,0,1,4,3,36.17
Architecture,Biotechnologist,4.29395271691665,0,0,0,0,2,0,2,4,4,1,3,3,0,0,Interdisciplinary,Masters,31-35,8,0,0,Office,Tier3_City,5,5,0,4,0,4,2,43.75,Finance,5,1,3,1,5,1,2,1,1,5,1,0,4,2,59.3
Finance,Electrical Engineer,4.715968641980996,9,1,3,1,3,1,2,1,1,1,1,0,0,0,Commerce,Masters,36-40,14,1,35,Flexible,Tier1_City,4,1,0,3,3,5,1,29.54,Other,5,4,4,1,4,0,3,5,1,5,0,0,1,1,48.82
Physics,Financial Analyst,3.302077645350506,7,1,2,1,5,1,4,2,1,0,4,3,3,0,Science,Bachelors,18-24,4,1,9,Remote,Tier2_City,4,5,5,5,2,0,4,43.16,Manufacturing,5,4,4,4,0,3,5,4,5,4,1,0,3,2,55.98
Education,Counselor,3.279364974792146,1,2,3,0,1,1,2,0,3,4,4,1,2,0,Arts,PhD,25-30,1,1,56,Remote,Tier2_City,4,5,4,3,2,1,3,9.9,Other,1,4,3,4,0,1,4,5,2,5,1,0,1,1,55.1
Chemistry,Musician,4.055000562603799,9,1,3,1,6,1,3,2,4,4,0,2,3,1,Science,Bachelors,18-24,9,0,0,Hybrid,Tier1_City,3,2,2,5,0,5,2,19.79,Manufacturing,3,1,2,2,4,4,3,4,3,4,1,0,5,2,59.99
Law,Pharmacist,3.560856021770115,4,2,4,0,0,0,2,2,2,4,1,3,1,1,Arts,Masters,36-40,3,0,0,Flexible,Tier1_City,2,3,4,2,3,5,3,29.1,Healthcare,1,4,4,5,2,3,1,1,3,4,1,1,3,2,58.0
Biology,Dentist,4.614554216012668,8,0,1,0,1,1,3,2,4,0,1,2,4,1,Science,Bachelors,40+,2,0,0,Office,Any,4,4,5,3,1,2,5,10.2,Finance,1,4,5,1,4,5,2,5,4,3,0,0,3,5,45.99
Architecture,Conductor,4.8412499568248935,2,0,1,1,7,1,1,4,1,4,4,4,3,0,Interdisciplinary,PhD,25-30,6,1,58,Hybrid,Any,2,2,4,2,5,5,5,9.02,Tech,3,1,2,4,1,5,4,3,5,4,0,1,1,4,77.9
Biology,Legal Consultant,4.549442980263025,7,0,2,0,7,1,2,3,2,0,2,3,1,1,Science,Masters,18-24,0,0,0,Remote,Tier1_City,5,4,0,2,0,5,4,34.09,Education,4,5,2,1,4,5,2,5,2,2,0,1,5,1,38.48
Marketing,Market Research Analyst,2.936086729714424,0,1,0,1,4,1,1,3,2,1,0,3,2,0,Commerce,Masters,31-35,14,0,0,Hybrid,Tier1_City,4,3,1,1,4,2,4,33.73,Other,2,2,3,2,5,1,3,4,5,2,0,0,5,5,59.88
Music,Legal Consultant,3.868106706336085,5,1,4,0,5,0,1,3,3,2,1,1,2,0,Arts,Bachelors,31-35,9,0,0,Hybrid,Tier1_City,1,5,5,2,3,4,3,14.01,Healthcare,5,4,5,2,4,3,5,2,2,3,0,0,2,1,53.74
Education,Biochemist,4.321121763225921,7,0,4,1,6,1,1,0,4,2,2,0,1,1,Arts,Bachelors,25-30,11,0,0,Office,Tier3_City,1,2,2,2,4,4,5,13.67,Education,3,1,5,2,2,4,4,1,2,1,1,0,1,5,49.42
Engineering,Quantum Physicist,4.717077607530322,0,2,0,1,2,1,3,2,3,2,0,1,3,1,Science,Masters,36-40,11,1,19,Hybrid,Tier2_City,1,1,2,3,4,3,4,38.04,Healthcare,4,2,1,5,3,1,3,5,1,3,1,1,2,3,60.7
Art,Forensic Psychologist,3.359704047652337,3,2,4,0,1,0,1,0,1,3,0,2,1,1,Arts,Masters,40+,3,1,41,Hybrid,Tier1_City,1,5,1,3,0,5,4,8.5,Finance,3,2,4,3,2,3,3,4,2,3,1,0,5,5,37.93
Computer Science,Curriculum Developer,3.16355610357692,9,0,2,0,4,1,3,0,4,0,3,2,3,0,Science,Bachelors,25-30,6,0,0,Remote,Tier1_City,3,1,2,4,3,0,5,46.39,Healthcare,2,3,4,3,4,2,2,3,2,5,0,0,1,3,55.37
Business,Industrial-Organizational Psychologist,3.651807531610543,3,0,2,1,9,0,2,0,2,3,1,0,0,0,Commerce,PhD,25-30,10,0,0,Remote,Tier3_City,5,5,5,1,4,4,5,47.36,Healthcare,3,2,2,3,1,4,5,1,3,5,0,0,4,3,64.77
Biology,Principal,4.3571698378386685,2,1,2,0,3,1,0,2,3,3,3,0,0,0,Science,Masters,25-30,9,1,17,Hybrid,Tier2_City,4,5,0,2,3,1,1,43.94,Tech,3,4,2,5,1,1,4,1,4,3,1,1,4,2,61.72
Architecture,Surgeon,2.6069217102710054,8,0,1,1,3,0,0,0,4,1,0,0,2,1,Interdisciplinary,Bachelors,25-30,12,0,0,Hybrid,Tier3_City,5,3,0,1,2,0,4,12.9,Healthcare,4,5,3,5,3,2,2,3,3,2,1,0,2,4,48.12
Law,Pharmacist,4.3086427859483925,9,0,1,1,8,1,1,0,2,2,4,0,4,1,Arts,Masters,25-30,4,0,0,Hybrid,Tier1_City,1,2,0,5,5,3,3,3.79,Manufacturing,5,4,5,1,0,2,2,3,1,3,0,1,1,1,45.06
Medicine,Clinical Psychologist,4.199737555219743,0,0,0,0,0,0,2,1,4,1,2,0,3,1,Science,Bachelors,25-30,3,0,0,Office,Tier3_City,5,4,0,2,4,5,2,47.02,Healthcare,5,3,4,1,5,1,3,4,1,2,1,0,3,3,36.12
Physics,Quantum Physicist,3.297106006873856,8,2,1,1,5,0,0,0,1,4,0,0,0,0,Science,Bachelors,18-24,3,0,0,Remote,Tier2_City,5,3,3,1,4,2,2,19.17,Healthcare,4,2,1,2,5,0,3,5,5,1,1,0,4,1,37.86
Architecture,Financial Analyst,2.5386235831103927,3,0,2,0,9,0,4,1,3,2,1,0,3,1,Interdisciplinary,Bachelors,25-30,10,0,0,Hybrid,Tier2_City,3,4,0,4,3,3,5,17.59,Finance,4,3,4,5,5,0,3,1,1,5,0,1,1,2,59.6
Engineering,Financial Analyst,3.461653300036313,8,0,1,1,0,0,1,3,1,1,4,1,2,1,Science,Masters,18-24,11,0,0,Flexible,Tier2_City,1,5,3,4,5,0,3,15.3,Healthcare,1,4,4,3,4,3,1,2,4,4,1,0,4,4,64.64
Psychology,Conductor,3.643350486335096,5,2,3,0,2,0,3,0,0,4,0,4,2,0,Arts,Masters,25-30,13,0,0,Hybrid,Tier2_City,2,1,5,2,2,2,1,14.49,Tech,1,4,4,3,0,1,4,3,2,2,1,0,1,2,51.59
Art,Data Scientist,2.57465607261378,9,1,0,0,7,0,2,3,1,0,4,3,0,0,Arts,Bachelors,31-35,1,0,0,Hybrid,Tier2_City,5,4,2,5,4,1,4,37.52,Finance,2,4,2,1,1,1,4,3,3,2,1,0,1,4,41.32
Finance,Dentist,3.773671016110561,4,2,1,1,0,0,1,2,3,3,4,3,1,1,Commerce,Masters,31-35,7,0,0,Hybrid,Tier1_City,5,1,2,4,0,2,1,45.67,Education,1,5,5,2,0,2,5,1,5,1,1,0,2,3,59.15
Physics,Physicist,2.7297140155982627,8,0,0,0,6,0,2,3,4,0,4,3,3,1,Science,Masters,25-30,11,1,24,Hybrid,Any,1,4,3,4,3,2,3,39.94,Manufacturing,1,4,5,2,2,2,1,3,1,5,1,1,5,5,64.81
Computer Science,Physical Chemist,3.669851503814805,8,1,0,1,6,1,1,2,3,2,2,1,2,0,Science,Masters,25-30,3,0,0,Remote,Any,3,1,2,5,3,1,1,34.68,Manufacturing,3,4,4,4,5,5,5,3,1,5,0,0,5,4,51.7
Business,Credit Analyst,3.133512078406234,6,1,2,0,1,1,4,0,4,0,1,2,4,1,Commerce,Bachelors,36-40,1,0,0,Remote,Tier2_City,4,3,4,1,4,4,5,16.52,Education,3,2,5,5,2,2,5,5,4,5,1,0,1,2,52.13
Finance,Credit Analyst,3.5565007437129967,3,2,4,1,8,0,3,0,3,2,1,3,2,1,Commerce,Masters,25-30,8,0,0,Remote,Tier1_City,1,4,1,4,2,4,2,28.71,Healthcare,4,5,3,3,3,4,1,4,3,2,1,1,1,1,58.96
Biology,Manager,4.2557684112192575,0,1,4,0,0,0,2,2,3,0,3,0,4,0,Science,Bachelors,40+,13,1,41,Office,Tier1_City,4,3,4,3,4,2,5,14.14,Tech,5,2,2,3,0,0,1,4,5,5,0,1,4,3,67.07
Medicine,Music Teacher,3.667080354282173,9,0,0,0,6,1,0,1,0,1,3,3,1,0,Science,Bachelors,25-30,13,0,0,Remote,Any,2,3,3,4,1,2,4,8.24,Tech,2,3,2,1,3,3,1,3,3,5,1,1,1,4,49.42
Chemistry,Aerospace Engineer,2.5847609225846,6,2,0,1,9,0,2,0,2,0,3,2,1,1,Science,Bachelors,31-35,12,1,36,Flexible,Any,4,1,1,1,4,3,5,8.65,Tech,1,1,5,1,2,3,5,2,3,4,1,0,1,3,56.95
Chemistry,Legal Secretary,3.0180242008880604,1,1,2,0,8,1,1,1,1,2,4,4,2,0,Science,Bachelors,18-24,11,0,0,Office,Tier1_City,5,4,5,1,5,4,3,31.38,Tech,3,2,4,5,5,1,4,3,5,2,1,0,5,3,67.24
Chemistry,Industrial-Organizational Psychologist,4.039249493267643,4,0,2,1,5,1,3,1,1,3,3,0,1,1,Science,Masters,31-35,9,0,0,Office,Tier3_City,3,4,3,2,5,1,3,4.81,Healthcare,5,5,4,1,2,2,5,2,1,2,1,1,4,4,55.62
Biology,Civil Engineer,2.527445015582043,2,1,0,1,5,1,0,4,4,4,3,0,4,1,Science,Bachelors,36-40,12,0,0,Office,Tier2_City,2,2,0,3,1,5,4,48.74,Education,1,2,4,1,3,1,2,2,4,5,0,1,3,1,64.45
Physics,Web Developer,2.664580475734891,0,0,0,1,7,0,2,4,2,0,3,3,2,1,Science,Masters,36-40,6,0,0,Remote,Tier1_City,3,1,1,1,5,5,4,49.79,Education,5,1,5,3,2,0,3,2,4,3,1,0,4,3,64.84
Finance,Astronomer,3.225236551469619,3,2,3,1,9,0,3,0,1,3,0,1,4,1,Commerce,Bachelors,40+,14,0,0,Hybrid,Tier2_City,3,4,3,5,5,2,2,10.02,Manufacturing,3,2,4,5,0,4,4,2,4,5,1,0,5,3,63.75
Biology,Investment Banker,3.678435445217583,0,1,3,1,2,1,0,1,0,4,3,3,0,0,Science,Bachelors,25-30,2,0,0,Flexible,Tier2_City,4,5,0,3,0,2,1,23.08,Education,4,1,5,3,4,0,2,1,5,2,0,0,2,2,42.9
Art,Curriculum Developer,2.553735588489692,1,2,2,0,3,0,2,3,2,2,4,2,4,0,Arts,PhD,25-30,14,0,0,Remote,Tier1_City,3,2,2,3,3,5,2,39.1,Tech,1,5,1,3,4,1,4,3,3,2,1,1,1,3,67.62
Biology,Curriculum Developer,3.248257346473734,7,2,4,0,0,1,0,3,1,4,0,0,3,1,Science,Masters,25-30,6,0,0,Remote,Tier1_City,2,4,3,5,5,3,5,47.89,Healthcare,1,2,5,1,2,2,2,1,4,4,1,1,4,3,49.68
Business,Astronomer,4.429556712797776,2,2,2,1,1,0,2,3,3,2,0,2,1,1,Commerce,Bachelors,25-30,0,1,45,Remote,Tier1_City,3,1,5,4,3,3,1,44.89,Finance,2,5,3,3,4,1,3,2,4,1,1,1,4,3,41.27
Medicine,Inorganic Chemist,2.8428787122678227,2,1,1,1,0,0,0,4,1,0,3,2,1,0,Science,Bachelors,18-24,11,1,37,Hybrid,Any,2,5,1,5,2,3,4,14.97,Finance,1,5,4,5,4,2,3,5,3,5,1,1,4,3,58.14
Medicine,Nurse,3.247056554196448,9,1,3,1,0,0,3,4,3,1,2,0,4,0,Science,Bachelors,36-40,0,0,0,Remote,Tier2_City,5,4,2,5,4,0,3,7.0,Tech,3,3,4,1,4,2,4,4,1,1,0,1,4,1,34.45
Business,Industrial-Organizational Psychologist,3.500793486243726,1,1,0,0,0,1,1,4,0,0,2,1,0,0,Commerce,Bachelors,36-40,3,0,0,Hybrid,Tier2_City,5,3,3,4,0,1,5,16.57,Other,5,3,2,5,5,5,5,3,1,5,1,0,1,5,38.11
Architecture,Marketing Manager,4.366178826303143,7,1,2,1,4,1,1,4,0,0,4,0,3,1,Interdisciplinary,Masters,25-30,3,0,0,Office,Tier3_City,4,3,3,4,1,0,2,23.55,Manufacturing,5,2,5,2,5,1,2,3,4,4,1,0,1,5,49.18
Art,Forensic Psychologist,2.6078452759367043,6,2,4,0,8,1,3,4,0,1,2,3,2,0,Arts,Masters,25-30,3,0,0,Remote,Any,1,5,2,4,2,2,4,19.92,Finance,4,2,1,5,2,4,3,1,3,1,0,0,1,5,50.16
Physics,Financial Controller,4.297939508590898,0,0,3,0,3,1,2,2,1,1,2,2,4,1,Science,Bachelors,18-24,8,0,0,Office,Tier1_City,5,5,5,4,0,3,1,39.37,Other,4,5,4,5,4,5,2,2,1,3,0,1,5,3,46.59
Art,Surgeon,3.3827884607252834,4,0,0,0,2,1,0,1,0,4,3,1,1,1,Arts,PhD,31-35,5,0,0,Remote,Tier1_City,1,5,5,4,0,3,1,15.12,Tech,3,3,2,4,3,1,1,2,2,5,1,1,1,5,52.81
Engineering,Education Administrator,2.6543492967112856,3,1,0,1,6,1,1,2,4,2,2,3,4,0,Science,Masters,25-30,2,0,0,Remote,Tier1_City,2,5,0,5,1,5,3,43.36,Healthcare,5,2,5,5,5,0,5,1,2,5,0,0,3,1,56.23
Music,Teacher,3.676078525992639,7,2,1,0,8,0,4,1,3,2,3,2,2,0,Arts,Bachelors,36-40,5,1,49,Remote,Any,1,1,1,2,1,5,4,13.6,Finance,4,2,2,3,3,0,5,3,5,4,0,1,5,2,57.84
Medicine,Acoustics Specialist,4.978575265690238,1,2,1,1,3,0,1,1,2,0,0,1,2,0,Science,Bachelors,31-35,1,0,0,Office,Tier2_City,3,3,5,2,3,3,4,19.98,Tech,4,2,1,3,4,3,4,1,5,5,1,1,1,4,40.88
Finance,Teacher,2.679587227465661,3,2,3,1,4,0,1,2,4,0,2,4,3,1,Commerce,Masters,31-35,1,0,0,Flexible,Tier3_City,2,4,0,1,4,4,5,24.05,Finance,2,3,5,1,1,0,2,4,4,4,1,1,4,3,55.57
Law,Dentist,4.268646286306255,5,1,0,0,6,1,1,0,3,4,4,2,3,0,Arts,Masters,25-30,6,0,0,Remote,Tier1_City,3,4,1,2,2,5,5,16.69,Healthcare,2,2,4,2,1,5,2,3,3,5,1,1,2,3,64.07
Psychology,Investment Banker,3.5386418706004825,2,1,4,0,6,1,1,4,4,0,1,0,1,0,Arts,Bachelors,18-24,13,1,12,Remote,Tier2_City,1,3,2,2,4,1,1,39.02,Education,3,5,5,1,3,0,3,2,5,5,0,0,3,3,62.57
Chemistry,Music Therapist,4.708868373779414,7,2,4,0,3,0,1,3,0,4,0,2,0,0,Science,Bachelors,36-40,2,1,16,Office,Tier1_City,3,4,0,5,2,0,2,22.25,Education,3,2,4,5,3,1,1,5,3,3,1,1,5,2,42.19
Chemistry,Financial Analyst,3.6562476865163775,3,1,4,1,0,1,4,0,3,2,4,0,4,0,Science,Bachelors,31-35,6,0,0,Hybrid,Tier2_City,2,3,5,4,0,1,1,44.69,Healthcare,3,4,3,5,4,1,1,5,2,2,1,1,3,2,47.83
Education,Legal Secretary,2.579569567115053,9,2,2,0,1,1,4,2,2,4,2,3,3,1,Arts,Masters,40+,2,0,0,Remote,Tier1_City,3,2,4,4,5,5,5,48.29,Healthcare,3,1,4,3,2,4,2,3,3,5,0,1,5,5,63.86
Art,Mechanical Engineer,4.890232849315471,3,2,1,0,7,0,2,3,4,4,0,1,2,1,Arts,Bachelors,25-30,11,0,0,Hybrid,Tier2_City,1,3,4,5,5,3,5,43.41,Education,5,5,2,5,3,0,3,3,4,5,0,0,5,4,70.31
Biology,Software Developer,4.350802244877922,6,1,1,0,8,1,0,0,1,3,2,4,2,1,Science,Bachelors,31-35,11,0,0,Flexible,Tier3_City,3,4,3,2,1,2,5,27.56,Healthcare,1,2,1,5,4,4,5,2,1,1,0,1,4,1,46.48
Law,Microbiologist,4.3189315670974295,6,0,1,0,9,0,1,4,0,0,4,1,3,1,Arts,Masters,18-24,1,0,0,Remote,Any,3,2,0,5,1,4,1,26.96,Healthcare,3,4,5,3,3,4,4,5,5,4,0,0,3,4,51.93
Psychology,Clinical Psychologist,4.9793641760897565,9,0,0,0,2,0,4,2,0,3,3,3,1,1,Arts,PhD,31-35,3,1,39,Remote,Tier1_City,4,4,5,1,0,5,4,13.15,Healthcare,2,3,3,2,5,0,5,1,3,5,0,0,4,1,61.69
Psychology,Electrical Engineer,3.803314180091224,5,1,4,0,7,1,2,4,3,4,3,1,2,1,Arts,PhD,31-35,14,0,0,Remote,Tier3_City,2,1,3,4,0,1,2,30.84,Education,1,5,3,5,3,1,1,1,4,3,0,1,1,4,76.09
Biology,Surgeon,3.953200320774745,5,2,4,0,4,1,1,3,4,4,1,0,3,1,Science,Bachelors,31-35,3,0,0,Office,Any,4,4,5,3,2,2,2,47.78,Education,1,5,3,4,4,2,1,1,3,5,1,0,4,4,50.34
Education,Astronomer,2.966505934247829,1,2,3,0,3,0,4,1,2,2,4,0,1,0,Arts,Bachelors,31-35,2,1,48,Remote,Tier1_City,1,2,0,1,0,5,5,6.79,Other,5,2,2,2,4,2,2,1,4,4,0,1,2,4,48.22
Psychology,School Counselor,4.168982871301198,8,2,1,1,8,1,3,3,0,3,4,0,2,1,Arts,Bachelors,18-24,8,1,29,Office,Tier2_City,5,3,1,1,2,3,3,38.37,Finance,4,3,4,2,0,2,1,5,4,5,1,0,4,2,61.65
Architecture,Game Developer,4.33653654959566,3,1,0,0,8,1,3,3,1,4,1,2,0,0,Interdisciplinary,Bachelors,40+,5,0,0,Office,Tier2_City,1,4,1,5,4,3,1,43.87,Education,1,2,3,3,2,4,3,5,5,1,0,1,3,2,51.41
Marketing,Geneticist,2.9949238877251667,5,0,4,0,0,1,3,0,4,2,2,4,4,0,Commerce,PhD,40+,4,0,0,Hybrid,Tier1_City,1,3,2,2,1,3,4,49.38,Finance,5,4,1,1,5,2,5,2,1,4,0,0,3,4,58.14
Law,Principal,2.9360333199413584,8,0,3,0,9,1,3,4,0,2,2,1,1,0,Arts,Bachelors,18-24,12,0,0,Remote,Tier1_City,1,4,4,4,1,3,5,18.73,Education,5,1,1,5,0,5,2,3,3,2,0,0,4,3,56.04
Psychology,Risk Analyst,4.508443883940062,6,2,1,0,4,0,1,3,2,2,3,0,4,0,Arts,Bachelors,36-40,11,0,0,Flexible,Tier1_City,1,5,4,3,5,5,3,19.71,Manufacturing,5,3,5,5,0,3,3,5,2,1,0,0,3,4,55.33
Law,Landscape Architect,4.1419245545278685,1,2,0,1,8,1,4,1,0,0,3,3,4,0,Arts,Bachelors,25-30,11,1,58,Hybrid,Tier2_City,4,4,2,1,5,4,5,13.8,Finance,3,1,1,1,0,3,3,5,5,3,0,1,2,5,58.93
Art,School Psychologist,3.4383920716037144,1,2,4,0,6,0,2,3,3,4,3,4,3,1,Arts,Bachelors,31-35,5,1,24,Hybrid,Tier1_City,1,5,2,3,1,4,3,40.09,Healthcare,4,4,4,5,0,5,4,3,5,4,0,1,1,5,63.19
Marketing,Credit Analyst,3.786318102733144,3,0,3,1,9,0,1,2,1,4,4,0,0,0,Commerce,Masters,25-30,12,1,18,Flexible,Tier1_City,3,4,2,2,4,1,2,9.58,Manufacturing,3,5,4,4,5,4,1,4,5,3,0,0,1,3,68.61
Music,Astronomer,4.324352799811514,9,1,1,1,0,1,1,1,3,4,1,2,1,1,Arts,Bachelors,40+,10,0,0,Flexible,Tier3_City,1,4,5,2,4,5,3,15.59,Other,2,4,3,1,0,1,1,1,3,5,0,1,3,4,58.87
Art,Quantum Physicist,3.2853466339274564,9,1,4,0,7,0,4,4,0,4,3,2,0,0,Arts,Bachelors,18-24,7,1,7,Hybrid,Tier1_City,5,5,2,3,3,3,2,16.88,Education,4,1,4,3,5,0,3,5,5,1,0,0,3,3,62.08
Engineering,Biologist,3.667040285773336,8,2,1,1,9,0,3,3,0,2,4,0,3,1,Science,Bachelors,25-30,4,0,0,Hybrid,Tier1_City,2,1,0,4,2,4,2,20.62,Education,3,3,4,1,3,4,2,5,5,5,1,1,1,2,51.72
Finance,Credit Analyst,3.721188432492828,5,1,3,1,9,0,1,1,4,1,3,4,3,0,Commerce,Bachelors,25-30,12,0,0,Remote,Tier1_City,4,3,2,2,5,5,1,22.82,Other,4,2,3,2,0,2,3,1,5,2,0,0,2,3,62.36
Biology,Curriculum Developer,2.718729869114411,1,0,0,1,1,0,3,1,4,1,0,1,3,0,Science,Bachelors,25-30,14,0,0,Flexible,Any,4,2,3,3,2,2,3,29.27,Manufacturing,2,1,5,3,4,0,3,5,5,2,0,1,4,3,58.6
Physics,Investment Banker,3.8661107460330273,9,2,4,0,5,1,0,4,2,4,3,0,4,1,Science,Masters,31-35,12,0,0,Office,Tier1_City,4,4,2,1,5,4,4,47.57,Tech,3,3,4,2,5,5,1,3,1,1,1,1,1,5,52.67
Marketing,Software Developer,3.379188019325996,9,2,0,1,6,1,4,2,0,4,2,1,3,1,Commerce,Masters,18-24,3,1,27,Hybrid,Tier1_City,4,2,0,3,3,4,4,14.62,Healthcare,4,1,4,3,2,1,5,5,3,2,1,1,1,5,48.95
Law,Marketing Manager,3.048832507696746,9,1,4,0,3,1,1,4,4,0,4,3,0,0,Arts,Masters,31-35,6,0,0,Office,Tier1_City,1,1,4,3,1,1,3,39.62,Finance,2,5,2,1,1,2,1,2,4,3,1,0,1,1,61.35
Medicine,Civil Engineer,3.28554812907042,9,1,4,0,0,1,2,0,3,4,4,0,3,1,Science,PhD,40+,11,0,0,Office,Tier1_City,5,4,4,5,2,4,1,34.79,Manufacturing,5,5,5,2,1,5,4,5,2,5,1,1,3,1,69.17
Music,Biomedical Engineer,2.5709828478192738,2,0,4,1,9,0,1,3,0,0,1,1,0,1,Arts,PhD,36-40,13,0,0,Remote,Tier2_City,1,5,4,2,5,2,4,8.45,Finance,4,2,3,3,3,3,4,1,4,5,1,1,3,2,62.56
Biology,Mechanical Engineer,4.223109449417565,3,0,0,0,6,1,2,2,2,4,2,0,2,0,Science,PhD,36-40,4,1,34,Hybrid,Any,2,5,0,4,2,3,5,41.09,Education,2,5,2,5,5,3,2,3,5,4,0,0,5,3,65.25
Law,School Counselor,4.828597801983236,5,1,1,0,6,1,4,2,2,3,4,2,1,1,Arts,Bachelors,25-30,3,0,0,Remote,Tier2_City,2,4,2,4,1,0,4,7.26,Tech,5,4,2,2,0,4,5,5,3,2,0,0,1,5,49.93
Law,Analytical Chemist,3.192371025183768,3,0,1,1,2,1,3,0,0,2,0,0,3,1,Arts,Bachelors,25-30,13,0,0,Office,Tier2_City,1,5,1,5,0,1,1,37.73,Other,2,2,5,4,4,1,3,4,2,1,0,0,3,3,41.2
Psychology,Civil Engineer,3.867669418059786,4,1,4,1,7,0,1,2,0,4,4,3,4,1,Arts,Bachelors,25-30,4,1,32,Remote,Tier1_City,1,1,4,4,5,2,2,36.64,Tech,1,1,4,3,1,4,5,3,4,1,0,1,1,1,50.87
Computer Science,Physicist,2.7521639002635165,9,0,0,0,4,1,0,4,2,2,2,2,1,1,Science,Masters,18-24,10,0,0,Office,Tier1_City,1,3,4,3,0,1,2,35.4,Finance,2,4,3,5,0,5,1,3,3,1,1,0,4,3,52.97
Marketing,Construction Manager,3.5770204274197432,4,2,1,1,2,1,2,0,2,1,2,3,4,1,Commerce,PhD,36-40,3,0,0,Hybrid,Tier1_City,5,3,1,5,3,5,2,16.0,Other,3,3,5,5,1,1,1,4,5,5,0,0,3,3,59.53
Chemistry,Curriculum Developer,2.73055246704633,0,0,4,1,3,0,0,2,2,0,1,2,4,1,Science,Masters,18-24,7,0,0,Remote,Tier3_City,4,1,2,1,4,3,1,29.95,Education,3,1,2,1,1,4,3,5,5,5,0,1,1,5,59.68
Education,Paralegal,4.1074236804957245,8,2,4,0,6,0,1,2,0,0,4,4,0,0,Arts,Bachelors,36-40,7,0,0,Remote,Tier2_City,2,5,4,2,2,4,2,38.79,Other,3,5,1,1,0,0,3,2,5,5,1,0,3,3,55.05
Computer Science,Biotechnologist,4.30954121273397,7,2,3,0,4,1,2,2,0,0,4,3,3,0,Science,PhD,18-24,0,1,42,Office,Tier1_City,2,3,2,2,5,5,2,32.97,Other,3,1,3,2,2,4,4,1,2,5,0,0,2,5,54.39
Psychology,Human Resources Specialist,2.5803306814738254,7,1,1,0,6,0,1,2,4,3,0,4,1,1,Arts,Bachelors,36-40,13,0,0,Remote,Tier1_City,4,5,3,2,2,4,1,40.8,Tech,1,5,1,2,2,0,1,3,2,4,0,1,2,1,56.45
Physics,Credit Analyst,2.6267331181754514,6,2,1,0,9,1,1,4,2,1,0,4,2,0,Science,High School,18-24,11,1,26,Hybrid,Tier1_City,4,5,1,3,3,2,5,35.33,Healthcare,1,4,4,4,3,1,1,2,5,4,1,0,4,4,59.71
Biology,Architectural Technologist,4.51122832601868,1,2,3,1,6,0,2,2,4,4,0,1,3,0,Science,Bachelors,18-24,2,0,0,Hybrid,Tier3_City,2,2,0,1,3,3,4,15.9,Education,1,4,5,5,4,0,4,1,2,3,1,0,5,1,50.16
Art,Biologist,3.296440402508085,2,0,4,1,9,1,0,2,0,4,4,3,3,1,Arts,High School,31-35,10,1,45,Office,Tier2_City,2,3,2,5,2,0,1,10.19,Manufacturing,5,4,4,3,0,0,2,1,4,5,0,1,4,3,57.47
Engineering,Market Research Analyst,4.060975686949388,6,0,2,1,8,0,1,0,2,0,3,4,0,1,Science,Bachelors,25-30,3,0,0,Hybrid,Tier3_City,5,5,1,5,5,0,1,32.7,Manufacturing,4,2,5,4,1,4,2,5,1,3,1,1,1,1,44.32
Medicine,Advertising Manager,2.5294032940652302,5,1,4,1,5,1,0,0,0,3,1,3,1,0,Science,Bachelors,31-35,1,0,0,Hybrid,Tier2_City,2,2,1,2,1,4,3,38.71,Manufacturing,3,5,2,4,2,0,4,2,3,5,1,0,2,4,38.34
Computer Science,Biomedical Engineer,4.920067821108489,7,1,0,0,7,0,0,2,4,4,3,0,0,0,Science,Bachelors,25-30,13,0,0,Remote,Tier1_City,1,1,1,1,1,5,2,9.69,Healthcare,4,1,4,4,4,2,1,3,1,5,0,0,3,3,59.09
Marketing,Pharmacist,3.4115882225881613,3,1,3,1,5,1,4,2,0,2,0,4,4,1,Commerce,Masters,18-24,12,0,0,Hybrid,Any,1,3,5,1,4,3,5,11.22,Education,3,1,1,3,5,2,1,3,1,1,0,1,1,3,54.06
Medicine,Legal Analyst,4.783756210733872,8,2,3,1,3,0,1,1,1,2,2,3,2,1,Science,Masters,36-40,4,0,0,Hybrid,Tier1_City,4,1,0,1,2,3,3,3.57,Other,3,1,2,4,4,1,2,5,3,2,0,1,1,3,45.2
Architecture,Web Developer,3.1837640592588032,0,0,2,0,4,0,3,4,0,4,3,0,2,0,Interdisciplinary,Masters,25-30,10,0,0,Office,Tier1_City,4,1,5,4,2,2,5,27.99,Finance,3,2,5,1,0,2,3,3,4,3,0,1,3,5,63.66
Education,Acoustics Specialist,4.764387690822312,1,2,0,1,8,1,1,3,4,2,4,4,0,0,Arts,Bachelors,31-35,7,0,0,Remote,Tier3_City,1,4,4,4,5,5,2,28.49,Finance,1,2,2,1,0,4,3,1,2,2,0,1,4,3,57.42
Law,Psychologist,4.231975094731161,1,1,2,1,3,0,0,3,4,1,4,1,3,0,Arts,Masters,25-30,11,0,0,Office,Tier1_City,4,3,3,2,2,0,2,26.5,Education,5,5,1,1,0,0,4,5,1,2,0,0,4,3,53.38
Education,Chemist,4.819998768120049,8,2,4,1,2,0,0,4,2,0,1,3,3,0,Arts,PhD,31-35,1,0,0,Remote,Tier2_City,1,1,4,1,5,2,2,17.85,Healthcare,3,2,3,4,2,0,3,1,1,3,1,1,5,3,45.09
Music,Geneticist,2.696932614796569,3,0,1,0,3,0,0,1,1,2,1,2,0,0,Arts,Bachelors,25-30,13,0,0,Remote,Any,5,1,2,1,2,1,4,23.11,Education,3,4,5,4,3,1,2,1,4,4,0,0,5,3,55.08
Finance,Music Therapist,4.593400291827808,8,0,3,0,8,0,1,2,2,4,0,4,2,0,Commerce,Bachelors,18-24,8,1,58,Hybrid,Tier2_City,4,1,1,5,3,3,5,39.01,Finance,3,1,3,5,3,0,5,4,4,1,1,0,3,3,56.31
Physics,Legal Secretary,4.2306548172932095,3,1,3,1,5,1,2,0,0,0,0,4,2,0,Science,Bachelors,25-30,12,0,0,Remote,Tier1_City,3,5,4,5,0,0,5,11.54,Education,2,4,2,2,3,0,4,4,5,4,0,1,5,3,52.74
Medicine,Conductor,2.5505405000498067,3,0,4,0,4,1,1,3,4,3,2,4,4,1,Science,High School,25-30,6,1,23,Office,Tier2_City,2,3,0,2,2,2,3,12.47,Manufacturing,3,2,4,5,4,0,1,5,5,3,1,0,4,3,61.82
Art,Software Developer,2.670608112653849,0,0,1,0,8,1,4,0,4,4,3,1,2,1,Arts,Masters,25-30,5,0,0,Flexible,Tier3_City,1,3,0,1,0,4,1,34.35,Other,1,1,5,1,4,1,5,1,4,4,1,1,1,2,63.3
Art,Physician Assistant,3.5845536172064723,6,2,4,0,5,1,1,4,2,1,0,2,2,1,Arts,Masters,31-35,7,1,38,Remote,Tier2_City,2,3,5,2,1,1,2,43.74,Education,1,3,2,2,2,2,2,5,1,3,1,0,3,2,44.95
Art,Software Developer,4.4712661080655804,9,1,3,0,6,0,4,2,1,1,0,3,3,0,Arts,Bachelors,31-35,13,0,0,Hybrid,Tier2_City,2,3,5,5,4,2,2,19.0,Other,4,4,5,5,0,5,1,4,3,4,1,1,4,1,61.73
Architecture,Animator,4.482610842188295,7,1,3,0,7,0,3,0,2,4,3,1,0,0,Interdisciplinary,Masters,18-24,1,1,57,Flexible,Any,4,3,3,5,1,4,3,46.84,Tech,1,3,1,3,0,2,3,5,1,5,1,0,4,1,48.76
Psychology,Entrepreneur,4.67594077333597,6,2,1,1,0,1,3,3,1,4,1,1,0,1,Arts,Masters,25-30,13,0,0,Remote,Any,2,1,4,4,2,0,5,5.71,Education,4,5,2,3,1,3,4,2,5,5,1,0,5,3,69.8
Music,Sound Engineer,4.372366656104525,6,1,4,0,6,1,0,3,0,1,1,1,4,0,Arts,PhD,25-30,4,1,40,Hybrid,Tier2_City,3,2,5,2,5,0,4,8.57,Finance,5,4,4,3,1,4,3,5,1,3,0,0,4,3,44.04
Chemistry,Physicist,2.5742583944515527,8,0,2,0,3,1,0,4,0,3,4,2,3,0,Science,Bachelors,18-24,3,1,12,Remote,Tier1_City,4,4,5,2,1,1,5,24.62,Finance,2,1,5,1,1,3,4,2,2,2,1,0,1,3,37.99
Education,Fluid Mechanics Engineer,3.248180080742174,9,2,0,0,0,0,3,0,4,2,4,3,4,0,Arts,PhD,18-24,7,0,0,Hybrid,Tier3_City,1,3,0,1,3,4,4,37.0,Other,1,1,4,2,4,1,2,5,2,1,0,1,1,1,61.54
Medicine,Illustrator,3.372006590128651,4,1,1,1,8,1,2,1,2,0,0,0,4,0,Science,Bachelors,18-24,12,0,0,Office,Tier1_City,2,5,5,1,0,3,4,20.43,Finance,3,3,4,1,3,1,2,2,2,2,1,1,1,5,37.31
Chemistry,School Psychologist,4.6154924994528574,3,0,3,0,2,1,0,4,2,0,1,3,1,0,Science,Masters,40+,0,1,35,Office,Tier2_City,2,2,0,4,5,0,5,29.07,Manufacturing,5,1,1,3,2,5,1,2,4,4,0,1,2,1,46.07
Law,Composer,4.237853580886207,5,2,3,1,9,1,2,3,0,0,0,1,0,0,Arts,Bachelors,31-35,11,0,0,Hybrid,Tier1_City,5,5,5,3,5,5,2,4.34,Finance,3,4,3,4,3,2,4,2,1,5,0,0,2,3,52.8
Music,Risk Analyst,3.266947408777771,6,0,4,1,4,1,3,1,1,1,3,3,1,0,Arts,High School,18-24,2,0,0,Office,Tier3_City,1,1,3,3,2,3,4,24.71,Tech,4,2,2,1,0,5,5,2,3,1,0,1,1,4,35.3
Education,Civil Engineer,2.9871567353054447,8,1,0,0,7,0,2,1,3,3,0,2,3,0,Arts,Masters,18-24,9,0,0,Remote,Tier1_City,5,4,2,3,3,3,3,14.4,Education,4,2,3,2,1,5,3,3,5,1,0,0,2,2,60.35
Architecture,Analytical Chemist,2.74633397200252,3,2,3,0,1,1,0,0,3,1,1,0,2,0,Interdisciplinary,Bachelors,31-35,7,0,0,Flexible,Any,1,1,4,2,0,2,3,27.27,Healthcare,2,1,3,1,3,0,4,3,4,5,0,1,4,4,43.97
Art,Financial Controller,3.1387551034033194,3,0,3,0,5,1,0,3,0,4,0,1,3,1,Arts,Bachelors,25-30,4,1,34,Remote,Tier1_City,2,1,2,2,3,2,4,27.71,Finance,5,5,1,2,0,3,5,5,4,5,0,1,3,1,49.45
Marketing,Software Developer,3.675754915589615,3,1,2,0,9,0,2,4,4,2,1,1,3,1,Commerce,Bachelors,31-35,3,0,0,Remote,Tier1_City,2,3,1,5,1,0,2,38.4,Education,4,4,4,4,1,1,3,4,2,1,0,1,5,5,40.47
Law,Human Resources Specialist,3.5982954713849726,0,2,1,0,8,0,0,3,4,3,2,0,2,1,Arts,Masters,36-40,5,0,0,Flexible,Tier3_City,3,5,2,2,2,3,4,28.37,Manufacturing,3,5,4,5,3,4,2,1,2,5,1,0,2,4,54.6
Music,Surgeon,2.871873807064334,5,1,0,1,4,0,3,2,1,3,1,4,0,1,Arts,High School,25-30,11,0,0,Office,Tier2_City,4,3,0,2,5,2,3,31.87,Education,1,3,2,2,3,3,2,3,2,1,1,0,5,4,52.31
Music,Biologist,3.066635794162679,3,1,3,1,3,0,4,1,0,4,0,4,4,0,Arts,Masters,18-24,4,0,0,Office,Tier2_City,3,1,0,2,5,4,3,27.89,Finance,1,1,1,2,3,4,1,2,5,5,0,1,2,2,62.98
Education,Biotechnologist,2.6966382063448875,9,2,1,0,6,1,4,1,1,0,0,4,2,1,Arts,Bachelors,31-35,2,1,41,Remote,Any,1,4,2,4,1,4,5,49.55,Finance,5,3,5,3,5,5,2,3,2,4,1,1,5,1,41.34
Engineering,AI Researcher,4.070084546774336,3,1,1,1,9,0,4,3,3,4,0,1,2,1,Science,Bachelors,40+,12,0,0,Office,Tier2_City,1,2,2,2,5,4,2,40.21,Other,5,5,4,3,5,4,2,2,4,5,0,1,4,5,68.32
Physics,Social Media Manager,4.998698196812429,0,0,2,1,3,0,0,1,0,3,3,2,0,1,Science,Bachelors,25-30,10,0,0,Hybrid,Tier2_City,1,1,1,1,4,4,5,38.52,Finance,4,4,2,4,1,2,2,4,2,2,0,0,5,1,48.57
Medicine,Entrepreneur,4.539448103570125,5,0,1,0,6,0,4,2,4,2,3,3,0,0,Science,Bachelors,31-35,13,0,0,Office,Tier1_City,1,1,5,1,2,3,1,32.48,Tech,1,5,5,1,4,2,4,3,4,5,0,1,2,1,67.94
Law,Human Resources Specialist,3.116690787926517,2,1,0,0,8,0,1,0,2,2,3,0,2,0,Arts,Bachelors,25-30,4,1,20,Flexible,Tier2_City,4,1,1,5,1,4,4,27.83,Education,2,2,3,5,1,4,1,1,1,2,0,0,5,5,39.65
Marketing,Civil Engineer,4.174990120281064,8,0,4,1,7,0,4,4,1,2,1,4,3,1,Commerce,Bachelors,25-30,3,0,0,Remote,Tier1_City,2,5,4,4,2,3,5,19.2,Other,2,5,1,5,2,3,4,1,5,3,0,1,4,2,59.78
Education,Chemist,3.321118757961581,2,0,2,1,9,0,1,0,0,2,1,4,4,0,Arts,PhD,31-35,0,0,0,Hybrid,Tier2_City,3,2,0,1,0,0,2,39.85,Healthcare,2,5,5,4,5,2,5,3,1,2,1,0,5,3,37.76
Physics,Credit Analyst,3.183684310954121,6,0,1,0,2,1,4,3,4,2,4,2,4,1,Science,Masters,36-40,0,0,0,Office,Tier3_City,2,4,4,4,2,0,4,11.91,Tech,2,5,4,5,1,3,2,3,1,1,0,1,3,4,48.9
Education,Composer,4.469100833133375,0,2,2,0,6,0,2,0,0,2,2,1,0,0,Arts,High School,31-35,13,0,0,Hybrid,Tier2_City,5,1,4,4,2,4,4,4.72,Healthcare,4,5,2,1,3,2,5,1,3,3,1,1,2,1,45.85
Engineering,Surgeon,2.804743668478403,5,1,1,0,0,0,4,4,1,1,0,1,1,0,Science,Bachelors,31-35,14,0,0,Remote,Any,3,2,2,5,0,4,4,35.81,Finance,3,4,2,3,0,0,5,4,3,5,0,0,2,5,60.22
Marketing,Nurse,4.835616140471019,6,1,4,0,5,0,2,3,1,2,0,3,3,1,Commerce,Masters,18-24,6,0,0,Remote,Tier3_City,1,1,0,4,1,4,4,9.81,Healthcare,2,1,1,4,0,1,4,5,2,2,1,1,4,3,48.94
Education,Biochemist,3.573011626345535,6,0,1,1,5,1,1,3,3,2,1,2,4,1,Arts,Bachelors,18-24,3,1,59,Hybrid,Tier3_City,1,2,4,2,2,0,4,45.48,Healthcare,4,4,3,5,3,0,2,3,2,5,0,0,2,1,49.39
Medicine,Music Therapist,2.869067718974482,9,2,0,1,8,1,1,0,4,1,1,2,0,1,Science,Bachelors,25-30,0,1,57,Remote,Tier2_City,5,2,2,4,3,2,2,39.22,Tech,2,3,4,4,4,0,4,3,4,4,1,1,1,4,41.81
Medicine,Physician Assistant,4.448772144419032,5,1,0,0,3,1,2,0,3,1,4,3,4,1,Science,Masters,18-24,5,1,45,Remote,Tier2_City,3,5,3,5,2,0,1,31.31,Tech,2,2,3,4,4,1,3,1,4,2,0,0,3,4,55.56
Architecture,Quantum Physicist,2.952991872548844,5,0,3,1,0,1,1,4,0,4,4,0,0,1,Interdisciplinary,Masters,31-35,10,0,0,Hybrid,Tier1_City,4,5,1,5,1,4,3,17.75,Education,3,1,1,2,1,2,3,1,5,5,0,0,2,1,68.1
Psychology,Animator,3.391006892846767,0,2,1,1,0,1,0,4,3,4,3,2,1,0,Arts,Masters,25-30,11,0,0,Remote,Tier1_City,4,2,2,5,5,2,1,32.98,Healthcare,2,2,1,2,1,2,2,1,1,1,1,0,3,1,59.26
Marketing,Chemical Engineer,3.117222955304751,6,1,2,0,4,0,1,4,4,4,2,1,0,0,Commerce,Bachelors,31-35,14,0,0,Remote,Tier1_City,1,3,2,1,0,2,3,25.41,Tech,4,2,3,4,0,0,5,1,1,2,0,1,3,3,55.5
Medicine,School Counselor,2.9697017350119506,9,1,3,0,1,1,3,4,3,3,0,0,1,0,Science,Bachelors,36-40,10,1,9,Remote,Any,1,1,4,2,5,1,5,16.68,Education,4,1,5,2,3,2,4,3,5,1,1,1,4,4,61.35
Engineering,Composer,2.9001155976775967,3,1,4,1,5,0,2,2,4,1,4,2,2,1,Science,Masters,25-30,11,0,0,Flexible,Tier1_City,1,5,2,1,1,3,4,47.42,Healthcare,1,1,5,5,3,4,5,2,2,2,0,1,1,5,62.76
Music,Actuary,2.739730901196313,1,2,2,0,2,1,3,0,4,4,1,0,2,1,Arts,Bachelors,18-24,10,1,15,Remote,Tier3_City,5,2,5,3,4,4,5,10.61,Healthcare,5,3,1,4,1,4,3,1,2,2,1,0,5,1,55.0
Chemistry,Animator,2.995794049170309,1,0,2,0,4,1,1,0,1,1,0,2,4,0,Science,Bachelors,31-35,10,0,0,Office,Tier2_City,5,3,2,2,5,3,5,38.41,Other,2,4,5,2,2,2,4,4,2,3,0,0,4,5,44.05
Law,Human Resources Specialist,3.165432485172768,3,2,3,1,2,0,4,0,1,4,3,1,0,1,Arts,Bachelors,40+,0,1,31,Office,Tier2_City,2,2,5,4,2,1,3,40.6,Finance,2,1,5,5,5,4,4,4,2,5,0,1,5,3,47.6
Marketing,Pharmacist,4.368507530996691,7,2,0,1,0,1,0,3,0,0,2,0,0,0,Commerce,Bachelors,31-35,7,0,0,Hybrid,Tier2_City,5,4,4,5,2,3,2,47.73,Tech,4,3,2,3,1,1,4,3,4,5,0,1,4,1,50.37
Art,Geneticist,4.388195854961009,1,2,0,0,6,1,1,1,4,3,4,4,3,1,Arts,PhD,18-24,11,0,0,Remote,Tier1_City,3,2,2,3,0,4,4,28.82,Manufacturing,2,5,3,3,5,0,2,1,2,3,0,1,2,2,69.08
Education,Nurse,2.564362183651962,2,2,2,1,4,1,4,0,0,0,2,1,3,0,Arts,Masters,18-24,12,0,0,Flexible,Any,5,4,5,2,2,1,5,28.14,Other,4,1,2,4,1,2,2,5,2,4,0,0,4,2,53.91
Engineering,Financial Controller,4.696177942728287,5,1,4,1,5,0,0,1,0,0,1,2,3,1,Science,Masters,25-30,8,1,22,Hybrid,Any,3,5,1,1,3,3,1,46.25,Tech,1,4,2,1,4,5,2,1,1,3,0,0,3,5,40.67
Art,Physician Assistant,3.8368400125429183,8,0,2,1,8,0,0,0,1,4,2,0,1,1,Arts,Bachelors,18-24,10,1,43,Remote,Tier2_City,4,5,0,5,3,0,4,40.65,Other,2,5,1,5,5,0,4,3,3,5,0,1,1,1,54.8
Chemistry,Industrial-Organizational Psychologist,4.490429513311787,9,1,3,1,2,0,2,4,4,4,2,2,4,0,Science,Bachelors,36-40,2,1,21,Hybrid,Any,2,2,4,1,5,2,2,38.89,Finance,1,5,1,4,1,1,5,5,5,4,1,0,2,5,61.16
Medicine,Web Developer,4.064108636843507,2,0,4,0,2,0,3,4,0,0,1,4,2,1,Science,Bachelors,36-40,6,0,0,Remote,Tier1_City,5,5,3,2,1,1,4,40.09,Other,1,5,1,2,1,0,1,3,5,5,1,0,5,4,57.84
Education,Aerospace Engineer,4.494067651251301,5,1,0,0,7,0,0,0,3,0,0,0,1,1,Arts,Bachelors,25-30,12,1,34,Hybrid,Tier1_City,4,2,3,2,0,0,5,26.18,Other,5,5,2,3,2,2,5,2,5,4,1,0,4,3,48.06
Biology,Music Therapist,4.036142684423388,3,1,2,0,5,0,3,4,4,1,2,0,1,0,Science,PhD,25-30,14,0,0,Hybrid,Tier2_City,3,2,5,3,4,4,1,4.95,Education,4,2,4,2,0,1,3,4,3,2,0,1,4,1,64.59
Biology,Manager,4.242911297482189,9,2,0,1,0,0,1,2,4,4,2,4,4,0,Science,Bachelors,18-24,4,0,0,Hybrid,Tier3_City,2,4,0,4,5,2,5,12.32,Tech,1,4,2,5,0,5,3,3,4,1,1,0,2,2,59.57
Art,Social Media Manager,2.8743348254405765,9,2,4,1,8,0,3,1,3,0,3,3,4,1,Arts,Bachelors,36-40,2,0,0,Office,Tier1_City,4,1,1,1,1,1,2,33.22,Healthcare,4,3,2,4,1,1,2,1,5,3,0,0,5,5,54.12
Physics,Game Developer,2.972766211764274,4,2,2,0,1,1,4,4,0,0,0,0,3,1,Science,Bachelors,25-30,4,0,0,Flexible,Tier2_City,3,2,2,3,0,2,3,21.62,Manufacturing,5,1,2,3,3,4,1,1,5,4,0,1,3,2,45.22
Business,Legal Analyst,3.091423598675757,6,2,4,1,4,0,0,0,4,3,1,3,1,0,Commerce,Masters,31-35,9,0,0,Hybrid,Tier1_City,2,1,5,5,0,5,1,31.52,Education,4,3,5,5,1,2,2,3,5,5,1,1,5,5,65.56
Education,AI Researcher,3.3815205178298324,0,2,4,1,3,1,3,3,0,2,0,1,1,0,Arts,Bachelors,25-30,6,1,7,Hybrid,Any,1,3,3,4,5,5,2,28.93,Tech,5,2,5,3,4,1,5,4,5,2,0,1,3,2,52.55
Engineering,Geneticist,4.510105015518082,2,1,1,1,6,1,1,4,4,1,3,4,3,0,Science,Bachelors,31-35,6,0,0,Office,Tier3_City,5,5,2,3,1,1,2,23.62,Education,2,5,1,3,2,1,2,3,4,4,0,1,2,3,58.3
Education,Financial Controller,3.40492575082036,4,1,4,1,3,0,4,3,4,0,3,3,2,0,Arts,Bachelors,25-30,8,0,0,Hybrid,Tier1_City,1,3,1,1,1,1,5,14.03,Healthcare,5,1,2,4,1,5,3,3,2,5,0,0,2,1,66.83
Business,Sound Engineer,4.023065511103965,8,1,4,1,4,1,4,2,0,1,2,3,4,1,Commerce,Masters,25-30,7,0,0,Hybrid,Any,1,3,4,2,2,3,5,36.79,Other,5,4,2,4,0,5,3,1,4,2,1,0,1,4,60.24
Engineering,Dentist,4.61149409405463,0,1,2,0,5,0,4,0,4,2,4,3,1,1,Science,High School,31-35,3,0,0,Office,Tier1_City,1,2,0,5,4,2,5,45.73,Manufacturing,5,1,1,1,1,0,2,1,4,5,0,1,4,3,57.53
Computer Science,Surgeon,3.097213541941972,4,2,2,1,2,0,1,4,0,4,1,4,2,0,Science,PhD,25-30,14,0,0,Flexible,Tier2_City,4,3,5,1,3,5,3,39.19,Healthcare,3,1,3,1,5,4,5,1,1,3,1,1,4,4,60.54
Marketing,Brand Manager,4.473048304909828,1,0,4,1,0,1,3,4,3,3,3,3,3,1,Commerce,Masters,25-30,4,0,0,Hybrid,Tier1_City,1,2,1,4,2,5,4,8.64,Manufacturing,1,3,4,1,2,0,4,4,4,5,0,0,1,5,65.86
Education,Composer,3.839553153726358,1,0,3,0,5,1,4,2,3,2,4,3,2,0,Arts,Bachelors,18-24,4,0,0,Remote,Tier1_City,1,5,3,4,0,2,4,28.28,Education,4,5,4,1,2,1,5,1,1,1,0,0,4,3,47.53
Chemistry,Paralegal,3.562607735057914,5,1,2,1,6,1,0,3,4,1,0,4,0,1,Science,Masters,25-30,9,0,0,Hybrid,Tier1_City,4,5,3,2,4,5,5,42.26,Other,4,4,3,2,3,1,2,5,4,3,1,1,3,4,61.57
Marketing,Digital Marketing Specialist,3.3301514538103194,9,0,4,0,6,0,0,1,4,2,0,2,0,1,Commerce,High School,25-30,11,0,0,Hybrid,Tier1_City,5,3,0,2,4,0,5,30.78,Other,3,1,1,1,3,0,5,5,3,2,0,1,4,4,47.59
Engineering,Physical Chemist,3.085672077257529,3,1,2,1,4,0,1,1,0,3,4,2,0,0,Science,PhD,31-35,1,0,0,Hybrid,Any,2,2,4,5,1,5,3,23.66,Tech,2,2,3,2,3,0,3,3,1,1,1,0,1,2,40.24
Education,Art Therapist,2.94972417040346,7,2,2,1,2,0,1,3,0,1,1,3,4,0,Arts,Bachelors,36-40,11,0,0,Remote,Tier2_City,2,4,1,5,4,5,4,16.37,Manufacturing,1,2,4,3,1,1,1,3,3,2,0,0,2,5,51.77
Marketing,Composer,2.844375408142352,2,2,3,0,0,1,0,3,4,0,1,4,3,1,Commerce,Bachelors,18-24,6,0,0,Hybrid,Tier1_City,5,4,3,2,5,4,3,18.53,Healthcare,1,5,3,2,0,1,3,2,4,1,0,1,1,5,53.14
Architecture,Marketing Manager,3.139534121605549,7,0,1,1,1,1,2,3,1,4,2,4,3,0,Interdisciplinary,Bachelors,18-24,6,0,0,Hybrid,Tier2_City,4,1,5,2,4,0,2,14.38,Manufacturing,1,1,2,3,4,4,3,5,3,3,1,0,2,2,59.7
Marketing,Graphic Designer,3.5391086163943086,1,1,3,1,1,1,4,0,2,4,3,1,1,1,Commerce,Bachelors,18-24,8,0,0,Remote,Tier2_City,1,1,3,4,0,3,4,12.2,Education,1,5,5,1,0,1,4,4,4,4,1,0,4,5,55.18
Education,Architect,3.818758013814573,9,2,0,1,0,0,0,3,2,4,3,0,1,1,Arts,PhD,25-30,12,0,0,Flexible,Any,2,1,4,2,5,1,5,30.68,Other,3,1,2,2,2,5,2,3,1,5,1,1,2,3,65.53
Computer Science,Organic Chemist,3.4646700037518525,6,2,3,0,1,1,0,3,1,3,3,4,4,0,Science,High School,25-30,8,0,0,Flexible,Tier2_City,5,3,3,3,5,5,1,26.94,Education,4,4,4,3,0,1,4,3,3,5,1,1,4,5,59.43
Computer Science,Electrical Engineer,4.181786895798205,1,2,0,0,9,0,3,4,4,4,0,1,2,1,Science,Masters,31-35,3,0,0,Office,Tier3_City,5,2,3,1,2,3,2,37.54,Education,2,2,5,1,1,2,4,4,4,3,0,0,3,2,57.38
Computer Science,Inorganic Chemist,4.724835703981374,5,0,2,1,4,0,0,0,0,3,3,1,4,1,Science,Bachelors,18-24,4,1,24,Hybrid,Tier1_City,1,1,2,2,4,3,1,17.47,Tech,2,3,5,3,3,3,2,5,2,5,0,1,5,1,43.66
Biology,Construction Manager,2.897581192813181,6,2,0,0,4,1,3,0,0,2,1,2,2,1,Science,PhD,25-30,6,0,0,Hybrid,Tier1_City,5,2,0,5,1,0,3,24.66,Education,2,5,3,4,0,3,5,2,2,1,1,0,3,1,47.36
Physics,Electrical Engineer,2.852820318995064,3,1,3,0,1,1,4,4,0,4,3,4,4,0,Science,Bachelors,36-40,9,1,32,Office,Tier2_City,4,3,5,3,2,1,3,34.98,Tech,3,4,2,3,2,1,1,4,4,5,1,1,3,2,70.29
Architecture,Industrial-Organizational Psychologist,3.460486651023873,4,1,0,0,2,1,1,1,4,0,3,1,0,0,Interdisciplinary,Bachelors,36-40,14,1,18,Hybrid,Tier2_City,4,2,2,5,1,4,3,48.27,Finance,3,2,3,1,2,4,4,2,1,5,1,1,2,3,50.08
Law,Forensic Psychologist,4.469081267326917,0,1,0,1,2,1,0,3,3,1,0,3,2,0,Arts,Bachelors,40+,6,1,43,Hybrid,Tier2_City,2,2,3,3,4,3,5,19.4,Manufacturing,5,4,4,5,4,2,4,2,5,2,0,0,4,4,56.22
Art,Game Developer,3.4826808266212144,9,1,1,0,0,1,2,0,2,3,3,2,1,0,Arts,Masters,31-35,10,0,0,Remote,Tier2_City,3,3,4,2,2,4,3,17.02,Other,3,3,5,4,0,1,5,3,3,1,1,1,2,4,59.24
Finance,Electrical Engineer,3.5332499745764,6,0,0,0,1,0,1,0,1,3,4,0,2,0,Commerce,Bachelors,36-40,9,1,31,Hybrid,Tier2_City,5,4,5,1,4,1,1,24.12,Other,1,1,3,2,1,2,2,5,5,1,0,1,4,2,51.52
Psychology,Software Developer,2.7587125005426536,0,0,3,1,7,1,4,2,4,0,0,4,2,0,Arts,Bachelors,18-24,10,0,0,Flexible,Any,4,2,0,5,0,1,2,37.02,Healthcare,4,1,5,4,2,0,3,2,3,3,1,1,2,1,60.27
Art,Aerospace Engineer,3.3185795087752017,4,0,1,1,5,0,3,4,0,1,3,1,2,1,Arts,Bachelors,18-24,7,0,0,Remote,Any,1,2,1,3,2,0,5,48.19,Other,2,4,2,1,4,4,5,4,3,3,0,0,1,3,49.14
Music,School Counselor,4.04964739142221,3,1,1,0,5,0,0,0,4,4,0,2,3,1,Arts,Masters,18-24,7,0,0,Hybrid,Tier2_City,1,5,1,4,1,2,2,28.22,Tech,3,4,4,3,5,3,3,5,2,1,0,1,3,4,47.23
Biology,Astronomer,4.883533951471264,3,1,2,1,8,0,2,2,3,3,4,0,1,1,Science,Bachelors,31-35,1,1,35,Hybrid,Tier2_City,3,5,4,2,0,5,3,41.18,Other,4,5,2,5,2,2,1,1,3,1,1,1,4,5,41.67
Physics,Teacher,3.8606759221430136,1,2,3,0,0,1,4,4,2,0,1,3,3,1,Science,Masters,36-40,11,0,0,Office,Tier2_City,3,1,1,1,3,0,4,24.83,Tech,1,4,3,1,4,5,4,1,4,3,0,0,5,5,67.48
Psychology,Special Education Teacher,4.771349963155881,2,0,3,0,0,1,2,1,2,3,0,1,3,0,Arts,Bachelors,18-24,8,1,36,Remote,Tier1_City,3,1,5,2,1,4,5,4.87,Other,3,1,3,3,2,5,1,4,3,2,1,1,1,1,46.69
Biology,Architect,3.611553212063841,5,2,3,0,1,1,2,0,0,0,4,1,0,1,Science,Masters,31-35,10,0,0,Flexible,Any,1,3,2,4,4,0,3,45.03,Healthcare,3,4,1,1,1,1,3,1,4,5,0,0,1,1,62.33
Marketing,Physician Assistant,3.341267356035483,5,0,0,1,1,0,0,1,3,3,0,3,2,1,Commerce,PhD,31-35,3,1,57,Remote,Tier1_City,5,3,3,1,1,1,5,16.62,Manufacturing,4,2,2,5,1,0,3,5,4,1,1,0,5,3,50.49
Marketing,Legal Secretary,3.407204401037069,2,0,4,1,7,0,0,0,0,3,1,4,1,0,Commerce,Bachelors,36-40,0,1,47,Flexible,Tier2_City,4,5,1,4,3,3,4,9.52,Education,1,2,4,3,2,4,3,5,5,3,0,0,2,1,42.13
Marketing,Actuary,4.812335729491055,3,1,1,0,4,0,4,1,3,4,3,3,2,1,Commerce,Bachelors,31-35,0,1,46,Remote,Tier1_City,1,5,5,2,1,5,1,49.82,Manufacturing,3,1,5,5,5,5,4,3,2,4,0,1,2,1,54.18
Architecture,Biochemist,4.425123245176647,3,1,0,1,4,0,0,2,0,1,2,1,1,0,Interdisciplinary,Bachelors,40+,4,0,0,Remote,Tier3_City,4,1,5,3,0,5,1,19.33,Tech,4,4,1,3,5,2,2,5,1,3,0,0,2,1,30.19
Art,Animator,2.703581272049409,7,0,3,1,6,1,3,4,3,1,3,3,3,1,Arts,High School,25-30,6,1,22,Office,Tier1_City,3,5,5,2,5,2,1,9.42,Education,1,4,4,4,3,0,2,2,1,3,1,1,2,5,53.52
Education,Financial Advisor,4.323455297940342,6,0,2,0,0,1,0,0,1,4,1,2,3,1,Arts,Bachelors,25-30,4,1,29,Flexible,Any,2,2,5,2,1,1,4,17.64,Finance,3,4,2,1,1,5,4,3,1,2,0,0,4,3,32.68
Psychology,Curriculum Developer,2.6726311273828656,6,0,4,0,2,1,4,1,0,2,4,1,3,1,Arts,Masters,25-30,14,0,0,Flexible,Tier1_City,5,2,2,2,2,5,2,27.15,Healthcare,3,2,5,2,1,2,2,2,4,3,1,1,1,4,64.58
Marketing,Mechanical Engineer,3.62017998236457,1,1,3,0,1,0,4,2,4,1,3,4,2,0,Commerce,Bachelors,25-30,12,0,0,Remote,Any,3,5,0,5,3,5,4,7.13,Manufacturing,2,1,4,2,4,2,2,5,3,4,0,1,5,4,70.84
Architecture,Surgeon,4.9974904348904285,2,2,2,1,9,0,0,3,3,0,2,3,1,0,Interdisciplinary,PhD,18-24,2,1,32,Hybrid,Any,3,3,4,4,1,3,4,19.57,Education,5,5,1,1,4,2,4,3,5,2,0,1,5,4,49.23
Architecture,Special Education Teacher,2.558844098705807,5,1,1,0,2,0,4,0,4,4,2,2,2,1,Interdisciplinary,Bachelors,31-35,10,0,0,Remote,Tier3_City,4,1,5,4,3,4,3,34.44,Healthcare,1,2,5,2,0,4,2,4,4,3,0,0,4,1,67.17
Physics,Judge,4.159022313330748,3,2,0,1,3,1,0,2,3,1,4,0,1,1,Science,Masters,31-35,6,1,56,Remote,Tier2_City,1,2,0,4,5,4,1,46.05,Manufacturing,4,1,2,5,0,4,2,4,4,3,1,0,5,2,60.52
Computer Science,Microbiologist,3.075191951193461,8,0,3,1,1,1,2,0,0,4,3,3,2,0,Science,Bachelors,31-35,0,0,0,Remote,Tier1_City,2,3,0,5,0,4,5,21.68,Tech,2,1,5,2,1,3,5,4,1,2,1,0,1,3,35.08
Marketing,Entrepreneur,2.9942401669143823,5,0,1,0,2,1,4,2,0,1,1,1,2,1,Commerce,Bachelors,25-30,10,0,0,Remote,Any,5,5,2,3,2,0,2,29.53,Tech,3,5,2,1,5,2,1,3,4,3,0,0,2,2,55.03
Marketing,Landscape Architect,2.753262001482823,5,0,1,0,8,0,2,1,0,1,3,3,0,1,Commerce,Bachelors,25-30,0,0,0,Flexible,Tier3_City,2,1,5,2,4,4,5,32.89,Tech,4,3,3,4,1,0,1,5,1,5,1,1,4,4,40.56
Education,Biologist,3.860497236637179,1,1,1,1,3,0,0,2,4,2,3,3,4,0,Arts,Bachelors,25-30,11,0,0,Remote,Tier1_City,3,1,5,3,1,4,3,6.33,Finance,2,5,3,1,2,5,1,5,1,4,0,0,2,5,53.98
Finance,Counselor,4.351500281408817,1,1,3,0,0,0,3,0,4,4,3,2,0,1,Commerce,Bachelors,18-24,1,0,0,Hybrid,Tier2_City,2,3,1,5,0,0,3,19.08,Other,2,5,2,1,3,1,5,3,1,2,1,0,3,5,38.81
Biology,Art Director,2.860516048552552,4,0,1,0,0,1,2,0,2,1,2,1,0,1,Science,Masters,25-30,0,1,11,Hybrid,Tier1_City,5,3,2,4,3,3,2,35.16,Tech,5,1,4,3,2,2,1,3,4,3,1,0,1,2,43.86
Finance,Financial Controller,2.5795806705244537,7,1,2,0,2,0,4,3,4,2,0,0,3,1,Commerce,PhD,18-24,8,0,0,Remote,Tier2_City,3,3,1,2,5,1,5,37.58,Tech,2,3,1,2,5,3,3,1,5,5,1,1,2,1,70.99
Engineering,Conductor,3.965294621877143,0,2,2,1,9,0,4,3,0,3,2,4,0,1,Science,Bachelors,18-24,3,1,59,Flexible,Tier1_City,5,5,3,1,3,5,2,19.73,Other,1,3,3,2,5,5,1,1,2,3,1,0,4,2,48.67
Business,Marketing Specialist,2.928216106509727,7,0,4,0,5,1,3,0,0,0,4,0,1,0,Commerce,High School,31-35,6,1,32,Hybrid,Tier2_City,2,5,4,1,5,2,2,3.32,Tech,5,4,4,3,1,5,4,3,3,3,1,1,1,1,46.96
Architecture,AI Researcher,4.797314097081372,3,1,0,0,2,1,1,3,2,1,2,0,2,1,Interdisciplinary,Bachelors,18-24,4,0,0,Flexible,Tier2_City,3,3,3,3,5,5,1,3.32,Education,5,5,5,5,4,4,1,4,1,5,1,0,1,4,50.43
Law,Game Developer,2.756345564563264,2,2,0,0,4,0,0,2,1,1,3,3,0,1,Arts,Bachelors,40+,13,0,0,Flexible,Tier1_City,3,5,5,4,0,4,5,28.29,Healthcare,3,5,3,5,0,3,3,5,4,1,0,1,2,1,50.65
Art,Illustrator,3.9040317590438542,1,2,1,1,6,1,2,3,2,4,3,1,3,0,Arts,Bachelors,25-30,6,0,0,Flexible,Any,5,1,1,1,1,4,1,28.92,Finance,3,3,4,3,5,3,1,4,2,5,1,0,3,2,55.81
Medicine,Music Therapist,4.100050255794763,4,2,3,0,6,0,4,3,4,1,0,4,1,0,Science,Masters,40+,12,0,0,Office,Tier3_City,1,4,1,3,4,5,1,29.12,Manufacturing,1,3,1,2,3,2,2,2,4,2,0,0,1,5,68.85
Finance,Zoologist,4.617903308740064,7,0,0,1,0,0,4,2,3,3,0,1,4,0,Commerce,PhD,18-24,12,0,0,Remote,Tier2_City,3,5,0,5,1,5,1,36.92,Other,4,3,5,5,4,2,3,2,4,2,0,1,1,3,69.76
Chemistry,Digital Marketing Specialist,4.776210105628713,2,2,1,1,2,1,0,2,4,3,2,2,4,1,Science,PhD,25-30,14,0,0,Remote,Any,5,1,1,3,2,4,4,46.3,Other,1,1,3,5,1,0,4,2,3,1,1,0,5,4,65.38
Biology,Interior Designer,4.093148573389769,3,1,1,0,5,1,1,0,0,3,1,2,1,0,Science,Bachelors,25-30,6,1,43,Hybrid,Any,5,4,0,3,1,0,3,49.54,Other,5,1,3,4,3,0,2,4,1,2,1,1,4,3,39.96
Computer Science,Advertising Manager,2.5095781092905565,1,2,3,1,9,1,2,0,1,3,1,0,2,1,Science,Masters,36-40,0,0,0,Hybrid,Tier2_City,5,4,5,3,5,0,3,35.95,Finance,3,1,1,5,5,3,2,1,4,1,1,1,2,1,44.62
Law,Physical Chemist,3.286389196403756,1,0,3,1,2,0,0,0,1,1,3,1,2,0,Arts,Masters,25-30,0,0,0,Office,Tier1_City,1,3,0,2,5,0,4,27.16,Healthcare,1,5,2,2,3,0,5,2,3,5,0,0,3,2,41.57
Psychology,Musician,4.542793380916545,2,0,2,0,8,1,1,1,3,0,3,0,0,1,Arts,Bachelors,25-30,10,1,46,Office,Tier2_City,4,3,4,3,2,2,2,9.63,Tech,3,3,3,4,0,5,2,3,4,3,1,0,2,3,52.57
Art,Music Teacher,4.442132626593276,8,1,3,0,0,1,0,2,2,4,3,2,1,1,Arts,Bachelors,36-40,2,1,36,Remote,Any,3,1,1,3,3,1,5,21.06,Other,1,1,2,4,3,0,1,5,2,3,0,1,5,2,47.86
Biology,Marketing Manager,4.762889537070855,6,2,1,0,9,1,1,4,3,2,2,2,4,0,Science,Masters,25-30,9,1,8,Remote,Tier2_City,2,3,5,2,5,4,5,29.91,Tech,1,4,1,2,1,1,2,1,5,1,0,1,1,1,66.11
Biology,Music Teacher,4.726303476014429,5,2,4,1,5,0,1,3,1,4,2,0,3,1,Science,Bachelors,18-24,1,1,43,Remote,Tier2_City,5,4,3,2,2,3,5,49.99,Manufacturing,2,3,1,3,0,0,2,2,5,3,1,0,1,4,45.14
Medicine,Curriculum Developer,4.082283077695225,6,1,3,1,7,0,1,2,0,1,1,0,1,0,Science,Bachelors,25-30,13,0,0,Hybrid,Any,2,1,2,5,5,5,1,8.97,Other,1,3,4,1,1,3,5,5,1,1,0,0,5,5,36.97
Psychology,Conductor,2.934172121963768,9,1,4,0,6,0,0,2,2,2,4,4,4,0,Arts,Bachelors,31-35,6,1,57,Remote,Tier1_City,5,1,0,4,4,5,5,40.27,Finance,3,3,3,5,3,2,1,5,5,2,1,1,2,4,57.52
Finance,Special Education Teacher,4.6601931713332805,6,0,3,1,8,1,0,3,1,0,3,0,3,0,Commerce,Masters,25-30,2,1,29,Office,Tier1_City,5,1,5,1,5,4,5,49.95,Finance,1,1,5,3,5,4,1,1,3,2,1,1,1,5,40.36
Law,Curriculum Developer,4.908991743136154,4,1,4,0,3,0,3,4,1,0,4,4,4,0,Arts,Bachelors,25-30,6,0,0,Office,Any,3,3,2,1,0,4,5,40.85,Manufacturing,4,2,5,1,1,2,2,4,3,4,0,0,1,3,52.9
Biology,Conductor,3.3176831202379025,2,2,4,1,0,1,3,2,2,1,1,3,3,1,Science,PhD,18-24,8,0,0,Remote,Tier1_City,1,3,0,3,2,4,3,39.06,Finance,2,4,1,2,4,3,4,5,5,4,1,0,3,3,63.99
Psychology,Counselor,4.049501177163711,7,1,3,1,5,0,1,3,1,2,4,0,3,0,Arts,Masters,25-30,11,0,0,Hybrid,Tier1_City,1,3,3,5,1,5,4,15.16,Finance,1,4,5,5,3,4,4,1,3,2,0,0,5,2,56.2
Education,Architectural Technologist,3.6496277871202336,1,0,0,0,8,1,0,1,0,1,2,4,0,1,Arts,Masters,31-35,10,0,0,Hybrid,Any,2,5,0,3,2,4,2,3.16,Finance,4,2,5,3,5,5,1,2,4,2,0,0,4,4,55.32
Architecture,Market Research Analyst,2.973149830587801,8,2,2,1,4,1,2,4,3,1,1,1,2,0,Interdisciplinary,Bachelors,25-30,0,0,0,Hybrid,Tier2_City,4,5,4,1,3,5,4,13.62,Other,3,4,5,1,2,1,4,1,4,2,0,1,1,5,38.2
Business,Illustrator,4.235679051860849,2,2,4,0,4,0,0,4,3,2,0,4,3,1,Commerce,Masters,25-30,14,0,0,Flexible,Tier2_City,1,5,0,2,5,1,5,40.12,Manufacturing,4,1,4,2,2,3,1,4,3,4,0,0,3,1,66.93
Medicine,Financial Advisor,2.719153453842122,5,1,4,0,4,1,1,3,3,0,4,4,1,1,Science,Bachelors,18-24,2,0,0,Remote,Tier2_City,1,1,1,4,2,3,2,8.04,Other,2,3,4,4,4,3,1,2,2,5,1,0,4,5,54.58
Music,Lawyer,4.752954993309048,9,2,0,1,8,0,2,1,1,1,3,0,0,1,Arts,Bachelors,18-24,12,0,0,Hybrid,Tier1_City,4,3,4,5,4,0,2,16.92,Manufacturing,3,2,1,4,2,5,3,4,1,3,1,1,4,2,51.71
Art,Art Director,2.914048114861339,9,2,2,0,0,0,1,4,0,4,2,0,1,0,Arts,Bachelors,18-24,10,0,0,Flexible,Tier2_City,1,5,0,2,2,3,4,29.44,Healthcare,1,3,5,4,2,3,1,5,3,3,1,1,1,2,58.0
Engineering,Industrial-Organizational Psychologist,2.5621285225658794,0,2,2,0,3,0,2,0,1,0,3,2,2,1,Science,Bachelors,25-30,14,1,8,Hybrid,Tier2_City,3,1,0,4,4,4,4,30.25,Finance,1,4,1,2,0,2,3,1,1,4,1,0,4,1,48.54
Finance,Biochemist,3.904020663266388,5,1,0,0,8,0,4,1,1,3,0,1,3,0,Commerce,Masters,25-30,14,0,0,Hybrid,Tier1_City,3,4,2,5,5,3,4,28.52,Healthcare,4,5,1,1,5,5,2,3,5,3,1,1,4,3,61.37
Music,Mechanical Engineer,2.820487282802857,6,2,4,0,1,0,1,3,1,1,3,2,0,0,Arts,Bachelors,36-40,5,0,0,Office,Tier3_City,2,5,0,5,1,4,4,49.1,Education,1,4,1,2,5,4,5,4,2,1,0,1,2,3,39.71
Marketing,Data Scientist,4.653866833370962,0,1,3,0,6,1,4,2,2,3,3,4,4,0,Commerce,Bachelors,18-24,14,0,0,Office,Tier1_City,2,1,5,1,5,3,1,3.58,Education,3,4,4,4,1,1,1,1,4,4,1,0,1,5,71.57
Engineering,Architectural Technologist,2.607061698503137,0,1,4,1,4,1,2,1,0,0,0,0,3,1,Science,Bachelors,25-30,12,0,0,Remote,Tier1_City,2,2,5,2,3,2,3,25.92,Finance,3,2,4,2,5,0,2,3,3,2,0,1,1,3,42.84
Medicine,Ecologist,3.861134632276417,1,2,1,0,3,0,0,1,4,2,0,1,1,1,Science,PhD,25-30,8,0,0,Hybrid,Tier1_City,3,5,4,5,0,3,3,26.71,Tech,1,3,3,5,3,4,1,3,2,5,1,0,2,5,59.67
Finance,Art Therapist,4.660002537418642,7,1,4,0,0,0,2,2,0,1,0,1,2,0,Commerce,Masters,25-30,4,0,0,Hybrid,Tier2_City,2,4,5,5,1,0,5,16.79,Education,4,2,5,1,5,3,1,1,1,1,0,0,5,1,33.68
Education,Physicist,4.618991942253244,0,0,1,0,0,1,2,1,4,4,2,1,1,1,Arts,Masters,36-40,2,1,12,Hybrid,Any,2,1,0,4,1,0,1,27.68,Tech,1,1,2,5,2,3,5,2,3,1,0,0,5,5,47.89
Biology,Entrepreneur,4.262672030819608,1,0,1,0,8,1,4,3,1,4,0,1,2,0,Science,Bachelors,18-24,7,0,0,Hybrid,Tier2_City,3,5,2,1,0,3,2,34.64,Healthcare,5,3,4,4,3,3,3,3,4,4,1,0,3,1,54.23
Education,Conductor,2.740515627075572,4,2,1,0,8,0,3,0,1,1,1,4,3,1,Arts,Bachelors,18-24,12,0,0,Office,Tier1_City,4,5,3,3,2,5,4,34.62,Finance,1,1,2,1,4,3,1,1,4,2,0,1,1,1,53.75
Business,Chemical Engineer,4.049131439166412,0,1,1,1,0,0,4,1,1,4,3,4,0,0,Commerce,PhD,31-35,13,0,0,Office,Tier1_City,2,2,2,1,5,5,5,7.13,Healthcare,2,1,5,5,2,1,1,1,3,2,0,0,4,2,73.71
Medicine,Mechanical Engineer,2.579240455155708,1,0,0,0,0,1,0,2,2,3,1,2,1,0,Science,Bachelors,25-30,11,0,0,Remote,Tier2_City,1,1,2,3,2,5,2,40.72,Other,1,2,5,2,0,2,3,2,3,1,1,1,1,2,49.17
Law,Physical Chemist,2.970707021606366,2,1,1,1,7,0,1,4,1,4,3,1,4,1,Arts,Bachelors,18-24,4,1,13,Remote,Tier1_City,3,1,0,2,2,3,3,46.74,Healthcare,5,4,4,3,3,4,4,1,2,2,1,1,4,5,43.56
Law,Psychologist,4.645897866404736,2,2,1,1,5,1,1,1,3,0,3,2,4,0,Arts,Masters,25-30,14,0,0,Hybrid,Tier1_City,4,1,3,2,5,5,2,8.81,Manufacturing,2,5,2,2,4,1,5,4,4,2,0,1,1,5,60.6
Law,Advertising Manager,3.057248520119177,2,2,3,0,8,1,2,3,1,4,3,4,0,1,Arts,High School,25-30,5,1,31,Remote,Tier3_City,1,3,5,5,3,1,4,22.58,Finance,4,4,1,4,0,1,5,4,1,2,0,0,5,2,46.79
Physics,Legal Secretary,3.327486253711589,4,0,1,1,4,1,2,4,3,0,2,1,3,0,Science,Masters,31-35,12,0,0,Office,Tier3_City,1,2,4,2,1,3,4,27.05,Manufacturing,2,4,1,3,5,1,1,2,4,3,0,0,3,3,63.23
Art,Chemist,3.767680752954752,9,0,2,1,1,0,2,2,4,3,0,1,0,0,Arts,Bachelors,18-24,1,1,11,Hybrid,Any,5,1,5,5,4,0,3,9.34,Healthcare,3,3,4,1,5,1,5,5,3,5,1,1,5,2,48.17
Computer Science,Urban Planner,4.5362638765199,5,2,3,0,3,1,0,3,1,3,1,3,0,0,Science,Bachelors,25-30,3,1,53,Remote,Tier3_City,4,2,4,1,0,5,4,26.66,Tech,5,2,2,3,1,1,4,1,1,4,0,0,4,2,39.3
Physics,Musician,3.8076628055994113,6,0,3,1,4,0,1,4,4,2,2,1,2,1,Science,Bachelors,25-30,0,1,37,Flexible,Tier1_City,5,3,5,2,1,2,1,12.72,Finance,3,3,4,1,4,1,1,4,3,4,0,1,3,2,46.51
Art,Actuary,4.673988634546301,2,2,2,1,4,1,1,0,0,1,4,4,1,0,Arts,Bachelors,25-30,14,1,10,Hybrid,Tier3_City,3,1,1,1,2,5,5,46.96,Finance,3,5,1,5,0,1,3,4,4,3,0,1,1,2,58.36
Computer Science,Financial Controller,4.505101725183792,3,1,1,0,3,0,0,2,3,1,3,4,2,0,Science,Masters,40+,13,0,0,Remote,Tier2_City,4,2,2,1,0,0,3,24.08,Education,2,2,5,5,3,2,3,1,2,3,1,0,5,2,57.08
Law,Advertising Manager,4.35688864966446,0,0,1,1,3,0,4,4,2,0,0,4,2,0,Arts,Masters,18-24,12,1,51,Remote,Tier1_City,5,2,2,2,4,1,3,49.76,Tech,2,4,4,5,0,2,1,1,1,4,0,0,4,1,65.4
Computer Science,Ecologist,4.358526758257167,4,2,0,1,5,0,4,2,3,0,2,4,4,0,Science,Bachelors,40+,3,0,0,Hybrid,Tier2_City,3,3,1,1,1,3,2,5.19,Other,3,1,1,5,4,5,3,3,2,4,1,1,4,4,49.87
Finance,Mechanical Engineer,2.932970942694351,8,2,4,0,2,0,1,1,1,3,3,0,4,0,Commerce,Bachelors,25-30,0,1,8,Hybrid,Tier1_City,2,2,0,2,1,5,3,9.0,Tech,4,4,5,5,1,1,3,2,5,2,0,0,5,2,43.6
Art,Astronomer,2.524837588954993,1,1,1,1,1,1,4,4,1,0,1,2,3,1,Arts,Masters,31-35,3,0,0,Flexible,Tier1_City,1,3,4,2,3,2,5,23.83,Healthcare,1,4,4,3,1,3,1,3,1,3,0,1,5,2,48.7
Engineering,Financial Advisor,4.059265474602755,1,0,3,0,3,1,0,2,1,4,0,2,0,0,Science,Masters,25-30,13,0,0,Hybrid,Tier1_City,3,5,5,2,1,0,1,44.09,Healthcare,1,2,4,1,4,0,2,2,4,3,1,1,4,1,50.96
Finance,Game Developer,3.1523768166953245,7,2,2,1,1,1,0,2,4,2,3,2,0,0,Commerce,Bachelors,25-30,1,1,15,Flexible,Any,4,2,4,3,1,2,2,29.1,Healthcare,5,4,1,5,5,1,5,3,2,5,1,0,1,5,48.09
Education,Software Developer,2.5530139590249554,0,1,2,1,1,0,3,1,3,3,1,1,2,1,Arts,Bachelors,36-40,5,0,0,Remote,Tier3_City,1,3,1,1,4,4,5,37.42,Education,2,5,1,5,3,4,5,2,2,1,0,1,5,5,50.58
Education,Urban Planner,3.6736982650670855,3,1,3,0,0,0,3,2,1,1,4,4,4,1,Arts,Bachelors,36-40,5,0,0,Office,Tier2_City,1,4,1,4,4,0,3,22.91,Tech,1,4,5,1,1,4,2,1,4,5,0,1,4,3,61.87
Medicine,Entrepreneur,3.902616766492066,8,2,4,1,3,0,0,1,1,4,1,4,3,1,Science,Masters,18-24,7,1,6,Flexible,Tier1_City,3,1,5,2,0,4,4,4.9,Manufacturing,4,1,3,3,2,1,3,2,3,2,0,1,5,3,47.97
Education,Physical Chemist,3.219999556141021,7,0,1,0,5,1,2,2,2,1,1,3,3,1,Arts,PhD,18-24,8,0,0,Remote,Tier1_City,2,1,1,1,2,2,4,33.45,Tech,5,2,5,5,5,2,5,4,5,2,0,0,1,4,64.89
Education,Electrical Engineer,3.215689091695128,2,1,0,1,6,1,2,0,3,0,2,3,2,1,Arts,Bachelors,25-30,7,0,0,Remote,Tier2_City,3,1,3,5,4,3,5,32.8,Manufacturing,2,5,4,3,2,5,4,5,4,2,0,0,3,1,54.02
Education,Advertising Manager,3.54335398258498,6,1,1,0,8,0,2,1,1,3,3,1,4,1,Arts,Masters,36-40,0,0,0,Hybrid,Tier2_City,5,3,2,2,0,3,1,6.36,Finance,1,2,4,5,1,4,2,4,2,5,0,1,3,1,47.39
Engineering,Doctor,4.026063136149976,0,2,0,1,7,1,3,2,0,2,0,2,4,1,Science,Bachelors,25-30,12,0,0,Flexible,Tier3_City,5,3,4,2,1,3,4,11.03,Manufacturing,3,1,4,3,3,2,3,2,1,1,0,0,2,2,45.38
Physics,Education Administrator,3.4275499408454047,1,0,4,1,0,0,2,3,1,3,3,4,0,1,Science,Bachelors,31-35,2,0,0,Hybrid,Tier1_City,5,1,0,4,0,4,5,25.38,Finance,4,3,1,4,3,0,4,2,5,1,0,1,5,4,47.4
Architecture,Market Research Analyst,4.872832405734631,8,1,4,1,4,1,1,3,4,0,0,3,2,0,Interdisciplinary,Bachelors,31-35,5,0,0,Hybrid,Tier2_City,4,3,3,3,0,3,2,23.99,Other,4,5,4,5,3,3,2,2,4,2,0,1,1,1,49.31
Medicine,Interior Designer,3.791365699221084,9,1,1,1,9,1,4,1,1,2,0,1,2,0,Science,Masters,31-35,0,0,0,Office,Any,3,2,2,3,0,1,3,38.36,Other,2,1,4,5,3,2,3,5,2,2,1,1,2,4,38.21
Engineering,Microbiologist,3.893518006663783,4,2,1,1,2,0,2,4,1,2,1,1,2,1,Science,Bachelors,25-30,7,0,0,Remote,Tier1_City,1,2,3,2,5,0,1,21.21,Healthcare,4,3,5,2,3,4,1,5,5,1,0,1,5,3,55.21
Architecture,Clinical Psychologist,2.9077223627617013,7,0,0,1,6,1,4,0,3,2,0,3,2,0,Interdisciplinary,Bachelors,25-30,13,0,0,Hybrid,Tier2_City,4,2,2,1,0,0,1,34.18,Tech,2,1,1,2,0,5,3,3,3,1,1,0,4,3,51.52
Engineering,Digital Marketing Specialist,4.937708152027163,7,0,3,1,4,0,0,0,1,4,4,0,1,0,Science,Bachelors,40+,5,1,38,Remote,Tier1_City,5,5,1,5,4,2,2,36.11,Healthcare,4,3,5,3,1,0,4,2,5,3,1,1,4,2,50.93
Law,Teacher,3.811956123954187,0,1,2,0,1,1,4,1,1,4,3,3,2,0,Arts,Bachelors,31-35,0,0,0,Hybrid,Tier1_City,4,1,0,5,5,5,1,33.32,Tech,1,3,3,2,4,3,5,3,4,4,1,1,3,2,51.53
Chemistry,Cybersecurity Analyst,4.935025441303171,5,0,2,0,5,0,4,1,3,0,4,1,1,0,Science,Bachelors,31-35,9,1,21,Office,Tier3_City,1,4,1,1,2,4,5,31.02,Manufacturing,2,2,5,3,5,5,2,4,1,5,0,0,5,5,59.65
Marketing,Illustrator,2.542368652049174,6,0,4,1,5,0,4,4,3,1,3,4,2,1,Commerce,Masters,25-30,1,0,0,Office,Tier2_City,4,1,4,2,0,0,1,40.87,Tech,4,4,5,5,2,5,1,5,2,5,1,0,5,1,62.42
Medicine,Inorganic Chemist,4.762103498299908,0,1,2,0,9,1,4,4,1,4,3,0,3,1,Science,Bachelors,31-35,5,0,0,Flexible,Tier2_City,2,2,4,5,3,4,1,33.88,Manufacturing,1,4,3,5,1,2,2,1,4,4,1,1,1,1,61.33
Medicine,Education Administrator,4.211892796401915,0,0,2,0,0,1,0,0,2,0,1,1,1,0,Science,Masters,25-30,9,0,0,Remote,Tier1_City,5,1,4,3,1,2,1,42.21,Tech,1,1,5,4,2,3,3,5,1,4,1,0,2,5,46.94
Art,Inorganic Chemist,2.693055563045488,9,0,0,1,2,0,3,3,3,4,2,4,0,0,Arts,Bachelors,18-24,13,1,18,Hybrid,Tier3_City,3,5,4,1,1,3,5,32.92,Finance,1,3,4,4,1,0,1,3,2,3,1,1,2,1,66.3
Finance,Teacher,3.866813810406008,8,1,2,1,9,1,0,1,2,2,3,1,4,0,Commerce,Bachelors,31-35,7,1,53,Office,Tier1_City,5,2,3,4,5,5,3,10.47,Manufacturing,2,4,4,2,1,0,5,1,4,1,0,1,2,1,50.58
Education,Landscape Architect,3.523467495277348,3,1,2,0,8,0,3,0,4,1,0,3,0,1,Arts,Bachelors,25-30,4,1,13,Remote,Tier1_City,5,5,0,2,1,2,4,17.54,Healthcare,2,1,2,5,2,1,2,1,3,1,0,0,3,2,45.76
Architecture,Microbiologist,4.944382166916572,9,0,0,0,4,0,2,2,2,3,0,2,3,1,Interdisciplinary,Bachelors,31-35,0,0,0,Remote,Any,3,5,0,1,1,1,1,18.53,Healthcare,4,1,1,3,3,1,2,1,1,3,1,0,5,4,34.41
Art,Investment Banker,4.413739766035818,1,2,0,0,1,1,3,3,2,4,3,3,1,0,Arts,Bachelors,25-30,13,1,9,Hybrid,Tier3_City,3,5,4,5,5,3,2,7.41,Healthcare,3,5,4,2,2,2,4,5,1,1,1,1,1,3,56.38
Law,Biologist,2.8714233300372225,0,0,2,0,4,0,4,4,0,2,4,1,0,0,Arts,Bachelors,25-30,9,0,0,Hybrid,Tier3_City,1,2,2,2,1,3,2,35.54,Healthcare,3,2,1,4,2,4,3,2,5,3,1,0,4,3,64.62
Chemistry,Industrial-Organizational Psychologist,2.8056434979330818,1,0,1,1,0,1,1,2,0,3,3,0,0,0,Science,Masters,25-30,1,1,50,Flexible,Tier2_City,1,5,1,3,0,3,5,30.97,Finance,5,2,5,1,2,1,4,1,3,2,1,1,2,3,36.98
Education,Biomedical Engineer,3.5038443611847367,5,2,1,0,5,0,0,2,1,3,2,2,1,1,Arts,Masters,25-30,3,0,0,Hybrid,Tier1_City,2,5,4,2,2,2,3,30.72,Finance,3,3,2,3,3,2,1,4,2,3,0,0,4,1,44.04
Physics,Web Developer,4.622117587430316,2,1,1,1,6,0,3,0,4,3,2,4,1,1,Science,Bachelors,25-30,3,0,0,Flexible,Any,4,4,2,2,5,1,1,25.49,Education,3,4,4,1,1,3,2,4,5,2,0,0,2,5,56.55
Education,Surgeon,4.423166070743913,7,2,3,0,5,1,4,1,0,3,1,1,2,1,Arts,Bachelors,31-35,6,0,0,Flexible,Tier2_City,4,1,5,3,3,5,5,28.53,Education,4,3,5,2,4,0,1,1,3,2,1,1,2,5,43.33
Education,Industrial-Organizational Psychologist,3.7588957316846106,9,2,0,1,8,0,2,3,2,1,0,0,3,1,Arts,Bachelors,36-40,1,0,0,Remote,Tier1_City,4,4,0,3,5,4,4,3.38,Education,2,4,2,2,4,1,5,4,4,2,1,1,3,3,42.12
Art,Electrical Engineer,3.630416999399481,2,2,4,0,8,1,1,1,0,3,1,1,4,0,Arts,Bachelors,25-30,6,0,0,Office,Tier1_City,5,1,1,2,4,2,3,7.52,Other,3,4,5,1,1,2,5,4,1,4,1,1,3,2,39.91
Law,Biotechnologist,4.610562537680875,0,1,3,0,6,0,0,1,2,3,2,1,1,1,Arts,High School,25-30,6,0,0,Remote,Tier1_City,5,2,0,3,3,0,3,35.12,Education,5,4,1,2,2,5,4,4,5,4,1,0,1,5,46.4
Engineering,Interior Designer,3.1499450366328032,7,1,4,1,7,1,3,3,0,4,2,3,1,1,Science,Masters,31-35,6,0,0,Remote,Tier1_City,3,4,0,1,4,0,5,15.29,Tech,4,4,5,2,1,5,4,3,1,1,0,1,4,2,49.26
Engineering,Lawyer,3.057854262880226,9,2,4,0,7,1,3,3,4,0,1,2,4,1,Science,Bachelors,31-35,12,1,10,Flexible,Tier1_City,2,3,3,3,5,2,2,8.07,Other,1,4,5,5,0,0,4,3,3,2,0,0,1,1,62.67
Biology,Aerospace Engineer,3.8701441895179336,1,0,1,0,8,1,2,3,0,2,0,1,2,1,Science,Bachelors,31-35,2,0,0,Remote,Tier1_City,2,2,1,3,4,4,3,18.45,Manufacturing,1,5,5,3,1,3,2,4,1,4,1,0,4,1,40.0
Architecture,Curriculum Developer,3.781972955206212,9,0,1,0,3,0,2,2,1,2,3,0,0,1,Interdisciplinary,Bachelors,31-35,5,1,43,Hybrid,Tier1_City,4,2,3,2,3,0,2,14.96,Healthcare,5,5,2,4,0,1,5,2,5,2,1,0,4,4,48.94
Architecture,Zoologist,4.901866554031463,1,1,3,0,6,1,0,2,4,3,3,4,2,0,Interdisciplinary,Bachelors,25-30,11,1,53,Hybrid,Tier1_City,3,1,5,1,0,4,3,4.38,Tech,2,4,5,5,5,1,5,4,4,4,1,1,5,1,67.51
Medicine,Physical Chemist,3.3307105769236385,4,0,4,1,5,1,0,1,0,3,4,0,4,0,Science,Masters,25-30,5,1,34,Remote,Tier1_City,4,1,4,4,5,3,3,22.3,Other,1,1,2,2,5,3,4,3,5,4,1,1,3,1,53.32
Art,Mechanical Engineer,3.34562012538885,8,2,2,0,5,0,0,4,2,0,0,3,1,1,Arts,Bachelors,25-30,3,1,31,Hybrid,Tier1_City,5,5,1,4,5,2,3,4.27,Finance,2,1,2,4,4,5,5,1,2,5,0,0,3,2,48.39
Finance,Paralegal,3.4022097592644345,2,1,0,1,4,0,0,3,0,4,0,1,4,0,Commerce,Bachelors,18-24,0,1,27,Hybrid,Tier1_City,3,3,2,5,1,3,4,3.02,Healthcare,3,2,3,2,4,4,2,4,1,5,0,0,4,5,33.64
Education,Chemist,3.7700444871417855,7,2,1,1,1,1,0,3,2,3,0,4,4,0,Arts,Masters,31-35,8,0,0,Hybrid,Tier1_City,4,2,0,3,5,0,2,40.25,Manufacturing,3,4,5,3,4,2,3,5,5,2,1,0,5,5,63.25
Law,Paralegal,2.7109799266926693,5,1,1,0,1,1,1,2,2,3,1,4,4,0,Arts,Bachelors,18-24,1,0,0,Flexible,Tier2_City,2,2,0,3,5,4,4,17.8,Manufacturing,3,1,4,2,2,3,2,3,5,4,0,0,4,3,52.92
Law,Doctor,3.2989533875254,7,2,2,1,0,0,4,4,2,0,2,0,0,1,Arts,Masters,36-40,8,0,0,Hybrid,Tier2_City,1,4,3,1,0,3,2,29.68,Finance,1,2,2,1,0,5,1,3,4,5,1,0,5,2,57.99
Computer Science,Graphic Designer,4.55931686591457,0,0,1,1,6,1,0,0,0,2,3,2,0,0,Science,Masters,36-40,7,0,0,Remote,Tier1_City,5,1,5,4,1,0,4,16.99,Healthcare,1,1,5,1,0,0,1,3,1,1,1,0,5,2,39.81
Art,Nuclear Physicist,2.98936328621014,1,1,2,1,3,0,0,2,4,0,0,1,1,0,Arts,Bachelors,36-40,0,0,0,Remote,Tier1_City,4,4,3,5,2,1,4,46.71,Education,2,2,4,1,0,0,4,1,1,2,1,0,5,4,27.84
Art,Principal,4.789923903188967,1,0,2,1,8,0,1,4,0,4,3,0,1,1,Arts,Masters,36-40,10,0,0,Office,Any,3,1,5,1,4,3,4,37.27,Healthcare,2,3,1,1,1,4,1,5,2,4,1,0,4,1,58.18
Physics,Chemical Engineer,4.102542847495418,1,0,1,0,7,1,0,4,2,0,0,1,3,0,Science,Bachelors,25-30,6,0,0,Hybrid,Tier2_City,3,1,3,3,3,1,5,20.35,Healthcare,5,1,4,4,2,3,4,5,3,4,0,0,1,5,49.72
Chemistry,Judge,4.359882904118884,0,2,1,0,7,0,1,1,4,0,3,0,4,1,Science,Bachelors,36-40,12,1,55,Flexible,Tier3_City,4,4,1,4,2,1,4,12.9,Manufacturing,3,4,2,1,5,5,3,5,3,5,1,1,3,3,58.36
Business,Software Developer,3.858028238444784,4,1,0,0,2,1,3,2,1,1,2,0,1,0,Commerce,Bachelors,18-24,9,0,0,Office,Tier2_City,2,4,0,5,1,5,3,9.48,Finance,4,4,2,2,4,2,2,3,1,1,0,0,1,4,41.29
Music,Biologist,3.8513466651789248,3,0,1,1,4,1,0,3,0,4,1,1,3,0,Arts,Bachelors,18-24,2,0,0,Remote,Tier1_City,4,4,5,2,0,0,1,38.83,Healthcare,4,5,2,5,5,3,5,4,5,2,0,1,1,4,41.72
Biology,Architect,4.048971126055189,3,1,3,1,7,0,2,2,1,3,0,2,2,1,Science,Masters,31-35,9,0,0,Remote,Tier2_City,5,1,5,4,3,2,4,24.29,Tech,3,3,3,2,1,4,1,4,3,2,0,0,5,1,54.52
Engineering,Psychologist,4.699187300828623,4,0,4,1,3,0,3,4,0,2,0,1,4,1,Science,Masters,18-24,12,0,0,Hybrid,Tier2_City,3,3,2,5,4,4,1,13.9,Tech,5,3,4,2,2,1,3,5,3,5,1,1,4,5,64.07
Medicine,Nurse,2.994707087280232,0,0,4,1,2,1,0,2,2,2,2,4,2,1,Science,PhD,40+,9,1,44,Office,Tier1_City,5,4,5,1,5,0,1,46.22,Finance,2,1,5,2,4,5,2,3,5,3,1,0,5,3,67.3
Psychology,Pharmacist,4.90628490731569,4,1,0,0,7,1,2,2,2,2,4,3,0,0,Arts,Masters,31-35,13,0,0,Remote,Tier2_City,1,1,5,2,5,5,3,21.33,Education,1,2,5,2,0,3,3,4,2,1,0,1,4,2,62.4
Medicine,Nurse,3.3498830577100014,4,2,0,0,2,0,0,4,1,3,4,4,4,1,Science,Bachelors,31-35,13,0,0,Hybrid,Tier3_City,2,4,1,5,2,5,1,28.54,Other,5,5,2,5,0,4,2,2,2,1,1,1,3,1,58.84
Architecture,Curriculum Developer,2.808771298686758,8,0,4,1,8,0,4,0,1,2,4,2,0,0,Interdisciplinary,Bachelors,18-24,13,0,0,Flexible,Tier1_City,4,3,0,5,4,3,1,43.32,Healthcare,5,3,4,1,5,4,1,4,1,2,0,0,2,3,52.71
Engineering,Judge,3.809374821356651,0,0,4,0,7,1,0,4,1,0,1,4,0,0,Science,Bachelors,31-35,8,0,0,Office,Tier1_City,4,3,4,3,1,4,1,42.17,Other,3,3,1,3,0,1,4,4,3,3,1,0,3,1,48.38
Art,Legal Secretary,3.602642718815659,3,2,0,0,2,0,0,0,1,1,0,2,2,0,Arts,Bachelors,18-24,4,0,0,Office,Tier1_City,2,5,4,4,4,5,2,32.98,Healthcare,2,4,4,4,3,4,2,2,5,4,1,1,5,2,44.46
Business,Web Developer,4.850022583761661,5,2,4,0,6,1,2,2,3,0,1,1,0,0,Commerce,Bachelors,36-40,10,0,0,Office,Tier1_City,3,5,3,3,0,2,4,44.77,Manufacturing,4,4,5,5,0,2,2,4,2,4,1,0,3,2,52.69
Physics,Urban Planner,4.380006131467256,6,0,2,1,2,1,3,0,3,1,1,3,1,1,Science,PhD,18-24,2,0,0,Remote,Tier1_City,4,3,5,2,2,0,4,47.75,Healthcare,4,2,2,5,4,4,3,1,5,3,1,1,5,3,57.9
Chemistry,Special Education Teacher,3.6849149340381016,7,0,4,1,9,1,3,0,1,1,4,4,4,0,Science,Bachelors,31-35,7,0,0,Remote,Tier1_City,2,4,3,5,2,2,1,46.95,Other,4,1,4,5,1,1,1,3,1,5,1,0,4,1,53.85
Marketing,Urban Planner,3.8467544559895575,1,2,1,0,1,1,4,2,1,4,2,0,4,0,Commerce,Bachelors,18-24,11,1,16,Remote,Tier1_City,4,5,3,3,0,3,3,19.4,Education,5,2,3,4,1,5,3,1,1,4,1,1,2,2,58.65
Business,School Psychologist,4.444574786194057,7,2,4,1,3,1,0,2,3,0,0,2,2,1,Commerce,Bachelors,18-24,2,0,0,Remote,Any,3,1,0,4,4,0,2,21.67,Healthcare,1,1,2,2,3,3,4,1,2,2,1,1,5,4,33.34
Computer Science,Composer,4.907162541966864,1,2,4,1,1,1,3,1,0,0,1,0,0,0,Science,Masters,25-30,6,0,0,Flexible,Tier2_City,2,3,3,2,0,3,3,14.3,Healthcare,2,5,3,4,3,4,5,3,3,5,1,0,5,2,48.41
Music,Entrepreneur,3.279251560061896,4,0,0,0,7,0,0,2,2,1,1,1,4,0,Arts,Masters,18-24,13,0,0,Remote,Tier2_City,3,4,2,1,3,4,3,42.33,Manufacturing,1,3,2,5,4,4,3,1,5,1,0,0,3,3,54.97
Art,Dentist,4.926433534682241,3,1,3,0,0,1,2,3,2,2,4,2,2,0,Arts,Masters,31-35,6,0,0,Office,Tier1_City,4,1,2,3,0,4,1,8.73,Tech,4,2,5,2,2,2,5,4,3,5,1,0,1,5,62.95
Psychology,Art Therapist,3.4516456210157016,7,1,1,0,5,1,3,0,4,0,2,0,1,1,Arts,Bachelors,18-24,6,1,39,Office,Tier1_City,2,3,4,2,4,2,5,19.69,Tech,1,1,1,5,3,1,3,5,2,5,1,1,1,2,57.35
Marketing,Brand Manager,2.615500289564597,3,1,0,1,1,0,3,3,0,3,3,2,2,0,Commerce,Masters,25-30,13,0,0,Hybrid,Tier3_City,1,3,1,1,0,2,1,3.46,Education,5,5,4,3,5,1,2,5,1,2,1,0,5,4,58.13
Computer Science,Manager,4.896933052325107,0,2,2,0,9,1,3,4,3,3,2,2,1,1,Science,High School,25-30,11,1,48,Hybrid,Tier1_City,4,4,5,3,1,4,5,30.95,Finance,3,2,4,1,3,5,4,1,1,5,0,1,1,5,56.94
Music,Organic Chemist,4.401419601256022,4,1,0,0,6,0,2,0,4,2,1,4,3,1,Arts,Masters,25-30,0,0,0,Hybrid,Tier1_City,2,4,0,2,5,1,2,33.94,Finance,1,3,2,1,4,1,5,5,2,1,1,0,3,5,43.05
Music,Forensic Psychologist,4.571772886759403,8,2,4,1,6,0,3,1,4,0,2,0,1,1,Arts,Bachelors,25-30,10,1,27,Hybrid,Tier3_City,1,2,1,2,0,4,5,14.7,Manufacturing,1,5,1,5,5,1,5,1,1,2,0,1,1,3,51.68
Music,Interior Designer,4.379660224626651,9,1,3,1,0,0,2,1,4,2,2,1,4,1,Arts,Bachelors,36-40,4,0,0,Flexible,Tier1_City,2,4,3,3,5,0,1,37.63,Other,1,4,1,2,1,5,3,3,4,5,0,1,2,4,54.75
Law,Pharmacist,3.4087620556811835,3,2,4,0,7,0,2,2,2,2,0,0,2,0,Arts,Bachelors,18-24,11,0,0,Remote,Tier1_City,5,1,0,2,0,3,1,20.93,Other,4,3,5,3,4,1,4,2,1,4,0,1,5,2,46.46
Psychology,Financial Analyst,4.807521511239736,0,0,1,0,7,0,0,4,0,2,0,4,2,0,Arts,Masters,18-24,10,0,0,Remote,Any,5,5,3,5,4,4,3,17.65,Healthcare,1,4,3,3,0,0,3,1,4,2,1,1,3,2,56.59
Law,School Counselor,3.995510610150541,7,1,1,0,0,0,3,3,1,2,4,0,2,1,Arts,High School,25-30,0,0,0,Hybrid,Tier1_City,2,4,1,3,3,4,1,47.94,Manufacturing,2,5,4,2,2,3,5,2,4,4,0,1,5,4,44.26
Law,Accountant,3.497878766251392,0,2,2,1,5,1,1,0,1,1,1,1,0,0,Arts,Masters,25-30,6,0,0,Hybrid,Tier3_City,2,4,4,2,3,5,1,30.67,Other,5,5,2,2,3,4,4,4,4,2,0,0,4,2,46.54
Business,Chemist,4.593916166772445,6,1,1,1,7,0,2,1,3,2,3,1,2,0,Commerce,Bachelors,25-30,12,0,0,Hybrid,Any,5,5,2,1,5,3,4,14.86,Tech,2,4,1,3,2,4,3,3,3,4,0,0,3,1,63.6
Marketing,Actuary,3.7907691929058607,3,1,2,1,8,1,1,3,1,2,3,0,0,1,Commerce,Bachelors,25-30,12,1,28,Flexible,Tier1_City,4,5,2,1,4,5,4,49.21,Education,2,1,4,1,4,4,2,5,2,1,0,1,1,3,45.78
Biology,AI Researcher,4.222376109024881,9,1,3,0,0,1,3,0,1,3,0,4,4,1,Science,Bachelors,31-35,7,0,0,Office,Any,5,3,2,5,4,3,3,21.21,Finance,4,5,4,1,1,2,4,1,2,2,0,1,5,3,44.64
Art,Financial Analyst,3.930937969934964,1,0,3,1,7,0,0,3,2,2,4,3,2,0,Arts,Bachelors,18-24,6,0,0,Flexible,Tier2_City,5,3,0,3,4,0,5,33.45,Healthcare,1,2,4,3,2,1,2,1,2,2,0,1,3,2,49.3
Business,Brand Manager,3.7067640193479785,9,0,0,0,6,1,0,2,1,4,3,1,3,0,Commerce,Bachelors,25-30,0,1,34,Hybrid,Any,5,5,3,2,1,3,5,37.02,Finance,5,2,1,4,3,3,4,4,4,4,0,1,4,3,42.22
Education,AI Researcher,3.486285229718973,1,2,3,1,1,1,4,4,4,0,1,0,4,1,Arts,Bachelors,25-30,2,0,0,Remote,Tier1_City,3,5,2,2,2,2,4,22.85,Tech,5,5,5,3,0,4,5,3,4,2,1,1,3,3,44.68
Marketing,Industrial-Organizational Psychologist,2.5016932119281496,1,0,3,0,2,0,2,1,1,4,4,4,0,1,Commerce,Masters,31-35,14,1,57,Office,Any,4,5,3,1,0,4,2,28.19,Healthcare,5,4,4,5,2,5,4,2,4,4,0,0,3,4,72.46
Physics,Curriculum Developer,4.200211449248741,1,1,1,0,6,1,4,4,0,4,0,3,3,0,Science,Bachelors,40+,9,0,0,Office,Tier2_City,3,1,2,5,4,3,4,14.27,Tech,1,4,1,4,4,1,2,3,1,5,0,1,4,1,63.48
Physics,Physician Assistant,4.90812991566351,5,2,0,1,7,0,3,0,2,0,3,0,3,1,Science,PhD,25-30,2,0,0,Hybrid,Tier2_City,4,2,1,1,4,0,2,24.89,Finance,5,3,1,2,5,1,3,4,5,2,0,0,2,4,51.66
Law,Human Resources Specialist,3.25591104360769,6,2,0,1,3,0,3,1,3,3,0,0,2,1,Arts,Masters,40+,14,0,0,Flexible,Tier3_City,3,1,4,1,4,3,5,17.61,Finance,5,4,2,3,4,1,5,2,5,3,0,0,2,4,65.87
Computer Science,Brand Manager,2.612660766905914,8,1,4,0,6,1,0,0,4,4,1,0,1,1,Science,Masters,25-30,6,1,19,Flexible,Tier2_City,3,2,3,5,3,4,4,28.73,Tech,3,1,5,3,2,2,2,2,1,2,0,1,2,4,48.58
Engineering,Illustrator,3.4876318993109487,3,0,2,0,6,0,4,4,0,4,0,4,3,0,Science,Bachelors,18-24,3,1,22,Hybrid,Tier1_City,2,3,0,3,4,1,1,34.48,Healthcare,3,1,5,4,4,3,1,1,5,3,1,1,1,2,58.16
Marketing,Pharmacist,3.72280909407912,0,1,4,1,3,1,4,0,0,2,4,3,0,0,Commerce,Bachelors,18-24,11,1,21,Remote,Tier1_City,5,5,2,2,0,3,2,31.86,Tech,5,2,5,3,5,5,4,1,5,3,0,0,5,2,61.77
Engineering,Special Education Teacher,4.611081195601296,3,1,1,1,6,0,1,2,0,2,0,1,1,1,Science,Bachelors,25-30,2,0,0,Hybrid,Tier1_City,2,1,1,3,4,2,2,39.51,Healthcare,2,5,1,5,2,4,1,3,3,5,1,1,1,4,45.6
Physics,Animator,3.688992511306844,8,1,4,0,7,1,2,2,4,1,3,0,2,0,Science,Masters,25-30,5,1,14,Flexible,Tier2_City,2,5,2,4,0,4,2,4.95,Manufacturing,1,2,1,1,2,0,2,2,5,3,0,0,1,4,54.68
Psychology,Composer,4.093593363544808,9,2,0,1,3,1,0,1,4,3,4,1,1,0,Arts,Masters,18-24,11,0,0,Remote,Tier3_City,2,5,4,4,1,0,5,6.69,Manufacturing,2,5,5,3,1,2,1,1,1,4,1,1,4,1,57.13
Business,Surgeon,2.6506298830747754,0,1,1,0,4,0,4,3,1,3,2,3,4,1,Commerce,Bachelors,25-30,9,0,0,Hybrid,Tier2_City,1,5,5,4,2,4,3,12.65,Healthcare,2,2,1,1,4,5,2,2,4,4,0,0,1,5,61.99
Business,Actuary,3.445475069243429,0,1,3,1,9,0,2,3,3,2,1,4,1,1,Commerce,Bachelors,25-30,5,1,9,Office,Tier2_City,4,1,2,5,3,5,1,49.33,Tech,1,5,5,2,5,2,5,2,3,2,0,0,5,4,52.56
Biology,Clinical Psychologist,3.9454225606694577,1,1,1,0,1,0,0,1,3,3,0,2,3,0,Science,Masters,18-24,9,0,0,Remote,Tier3_City,2,5,4,1,0,1,4,40.61,Healthcare,1,5,2,2,1,0,3,5,5,1,0,1,3,1,52.48
Computer Science,Legal Secretary,3.759601605290156,7,1,0,1,2,1,3,2,0,0,2,4,4,1,Science,Bachelors,25-30,4,0,0,Hybrid,Tier1_City,2,3,3,3,5,0,2,46.43,Finance,4,2,3,3,5,2,3,1,1,5,0,1,4,2,52.3
Marketing,Musician,4.723803356558035,1,0,3,0,5,1,4,0,4,2,0,2,2,0,Commerce,Masters,36-40,11,0,0,Hybrid,Tier2_City,1,2,4,2,1,1,5,15.79,Tech,4,3,3,2,4,4,4,1,2,5,0,1,2,1,63.03
Finance,Social Media Manager,3.576945286809793,2,1,4,1,4,1,3,0,1,1,0,2,4,1,Commerce,Bachelors,25-30,14,1,42,Flexible,Tier1_City,1,4,1,4,2,1,2,29.97,Other,4,1,3,3,1,3,5,1,2,5,1,0,1,1,49.35
Computer Science,Landscape Architect,4.92032206570239,2,2,3,1,1,0,2,0,4,1,3,3,0,1,Science,Masters,31-35,5,0,0,Office,Tier1_City,5,3,5,3,2,2,4,29.08,Healthcare,5,4,3,1,0,3,1,5,3,5,1,1,4,5,60.48
Finance,Paralegal,3.189996697753563,8,1,4,1,6,0,2,1,2,4,2,1,4,0,Commerce,Bachelors,31-35,2,0,0,Office,Tier2_City,2,2,1,4,2,3,1,29.77,Finance,5,1,2,4,4,4,5,4,2,5,0,0,1,5,45.19
Computer Science,Astronomer,2.5158239354015177,0,0,2,0,6,1,0,3,2,0,3,0,2,1,Science,Bachelors,25-30,13,1,6,Remote,Tier1_City,4,4,3,4,0,2,2,36.73,Education,5,4,1,3,1,4,1,5,1,1,0,1,5,4,42.45
Psychology,Quantum Physicist,3.941257608796532,1,1,3,1,4,0,3,2,3,2,0,2,3,0,Arts,Masters,18-24,14,0,0,Remote,Tier1_City,2,5,0,2,1,2,5,21.52,Finance,4,5,2,4,5,3,5,4,2,2,1,1,2,5,55.29
Art,Aerospace Engineer,4.003929636584445,2,1,1,1,1,1,0,3,1,4,0,0,3,1,Arts,PhD,25-30,12,0,0,Flexible,Tier2_City,5,3,1,5,4,5,5,34.83,Other,1,2,4,1,0,5,3,3,2,2,0,1,3,3,51.89
Engineering,Legal Secretary,3.194617967111527,2,0,4,1,7,0,0,4,2,2,0,1,1,0,Science,Bachelors,25-30,9,0,0,Hybrid,Tier2_City,2,4,3,1,5,2,3,40.06,Healthcare,5,2,1,1,0,4,4,1,5,5,0,0,3,2,59.49
Music,Financial Advisor,3.8172930836703673,2,1,4,1,7,1,1,0,0,4,0,1,2,0,Arts,Bachelors,25-30,4,1,57,Remote,Tier2_City,1,4,5,5,1,0,5,16.59,Tech,1,4,5,4,5,2,3,4,1,1,0,0,2,3,27.59
Computer Science,Dentist,4.051570049298864,5,0,3,0,5,0,0,2,4,2,4,3,0,1,Science,Masters,18-24,8,0,0,Remote,Any,1,4,3,3,1,3,3,47.45,Tech,4,2,4,3,0,3,3,2,1,1,1,1,3,2,52.02
Biology,Legal Secretary,3.1930986139699704,4,0,1,0,4,0,1,1,4,0,0,0,4,1,Science,PhD,18-24,3,0,0,Hybrid,Tier2_City,5,5,1,5,1,3,1,27.35,Manufacturing,1,2,4,4,1,0,5,4,1,1,1,0,2,5,36.49
Engineering,Financial Analyst,3.0822836015984056,0,2,2,0,5,0,1,2,0,2,4,2,3,0,Science,Masters,36-40,10,0,0,Remote,Tier2_City,5,2,3,3,0,0,4,37.44,Other,5,2,2,3,0,0,1,4,4,3,1,1,5,2,58.51
Architecture,Music Teacher,2.606868253527002,1,1,0,0,1,1,3,3,2,1,3,1,0,1,Interdisciplinary,PhD,25-30,1,0,0,Hybrid,Tier1_City,1,2,3,3,5,2,3,37.26,Healthcare,1,1,4,3,3,4,5,2,1,4,1,0,5,4,51.35
Architecture,Paralegal,2.79472875441992,2,0,4,0,0,0,2,3,4,2,4,3,1,1,Interdisciplinary,High School,31-35,4,0,0,Office,Tier2_City,1,3,2,1,0,2,2,29.57,Finance,4,2,2,4,4,0,1,3,5,1,1,1,3,1,51.36
Art,Construction Manager,3.9055891820386512,3,0,4,0,3,0,3,0,1,4,3,1,3,1,Arts,Bachelors,25-30,2,0,0,Hybrid,Tier1_City,2,5,3,2,5,1,2,18.17,Finance,5,3,4,1,3,0,2,1,2,3,0,1,4,2,42.49
Art,Music Teacher,2.800337886326256,7,2,4,1,5,1,2,3,3,2,0,1,2,1,Arts,Masters,36-40,11,0,0,Flexible,Tier2_City,5,2,1,1,5,1,4,34.35,Other,5,4,2,5,3,3,4,5,2,5,0,1,1,5,64.32
Music,Software Developer,4.838928471102255,0,2,0,1,0,1,2,2,3,2,1,2,2,1,Arts,Masters,25-30,14,1,9,Remote,Tier1_City,2,3,1,5,0,5,5,7.1,Healthcare,4,1,1,2,4,2,1,3,2,3,0,0,3,3,57.73
Marketing,Music Teacher,3.743675679201047,0,0,2,1,4,1,3,3,3,2,0,4,2,1,Commerce,Bachelors,25-30,2,1,20,Hybrid,Tier1_City,1,2,1,3,5,4,2,49.13,Finance,2,1,4,5,3,1,2,5,1,4,0,0,3,3,54.71
Art,Dentist,4.700521089025088,9,0,0,0,7,0,3,3,0,3,2,1,3,1,Arts,Bachelors,36-40,3,1,12,Remote,Tier2_City,4,1,2,4,1,1,3,11.65,Education,3,5,2,1,0,0,4,5,1,1,0,0,1,5,34.72
Psychology,Software Developer,4.81471921824225,4,0,4,0,9,0,1,1,3,1,3,0,1,0,Arts,Masters,31-35,11,0,0,Flexible,Tier2_City,5,5,1,4,0,3,4,15.95,Other,4,5,3,2,2,4,1,3,3,4,1,0,5,5,53.99
Computer Science,Organic Chemist,4.055996189040227,5,2,3,0,3,0,1,3,4,1,3,1,4,1,Science,Bachelors,18-24,3,0,0,Flexible,Tier1_City,2,1,3,3,5,0,2,47.86,Manufacturing,1,2,3,4,3,1,3,4,3,2,1,1,3,2,52.24
Psychology,Aerospace Engineer,3.4143919645059,9,0,3,1,0,1,0,2,4,1,4,2,4,1,Arts,Bachelors,18-24,4,0,0,Hybrid,Tier2_City,5,2,4,1,2,2,5,11.77,Tech,2,1,4,5,5,0,4,3,3,4,1,1,2,4,56.09
Law,Illustrator,2.605440699980348,8,2,4,0,1,1,4,1,4,1,4,3,4,0,Arts,Bachelors,31-35,6,1,28,Hybrid,Tier2_City,4,2,2,2,0,4,5,10.99,Finance,4,1,2,3,4,2,4,5,4,1,0,0,1,2,54.51
Art,Microbiologist,3.721568266675397,6,1,1,0,4,1,0,3,1,2,0,3,2,1,Arts,Masters,36-40,3,0,0,Remote,Tier3_City,3,1,4,1,3,1,2,40.81,Education,3,2,1,1,1,5,5,3,3,5,0,1,1,1,47.13
Biology,Human Resources Specialist,3.506086495419217,1,0,3,0,7,0,3,4,2,1,3,4,1,0,Science,Masters,25-30,10,1,11,Flexible,Tier1_City,1,5,0,3,0,4,4,14.81,Healthcare,5,4,4,1,1,0,4,2,5,4,1,1,4,5,68.96
Medicine,Construction Manager,3.1531369241182152,2,0,2,0,0,1,2,4,1,3,0,2,3,1,Science,Bachelors,25-30,6,0,0,Office,Tier2_City,4,3,5,3,0,0,1,7.45,Finance,3,1,1,1,0,4,5,4,1,2,0,1,5,5,42.59
Engineering,Chemical Engineer,3.1183372229041906,1,1,2,0,4,1,2,4,4,3,0,1,1,0,Science,Masters,31-35,8,0,0,Flexible,Tier1_City,3,4,4,2,0,0,2,13.65,Other,3,5,2,5,3,2,2,4,4,3,0,0,5,4,64.32
Computer Science,Industrial-Organizational Psychologist,4.239865123909302,5,1,4,0,7,0,2,0,1,4,3,1,1,0,Science,Masters,25-30,2,0,0,Remote,Tier1_City,2,1,3,5,5,4,5,44.75,Healthcare,4,2,3,3,2,4,4,5,5,2,0,0,3,2,51.14
Art,Composer,3.2023878341830603,1,2,3,1,9,0,2,3,1,3,2,0,3,1,Arts,Bachelors,31-35,4,0,0,Hybrid,Tier2_City,4,5,2,5,0,4,1,16.18,Education,5,1,2,5,1,4,1,4,2,3,0,0,1,2,45.35
Physics,Chemical Engineer,3.0994794248512045,3,0,3,0,1,1,2,1,1,0,2,3,3,1,Science,Masters,18-24,3,0,0,Office,Tier1_City,3,5,1,2,3,5,4,35.67,Education,5,5,1,3,2,4,4,5,3,2,0,1,2,1,45.82
Finance,Surgeon,3.631502003901352,3,2,2,1,1,0,0,3,4,2,1,1,1,0,Commerce,Bachelors,40+,14,0,0,Flexible,Tier2_City,4,4,1,5,4,4,5,21.57,Tech,3,3,3,2,5,4,4,2,3,1,1,0,5,1,52.23
Art,Accountant,2.954755504187499,8,0,1,0,7,0,4,3,4,2,0,1,3,1,Arts,Bachelors,31-35,8,0,0,Hybrid,Any,3,3,4,4,0,2,4,15.32,Healthcare,4,1,4,4,0,4,1,5,1,3,0,0,2,2,53.63
Finance,Clinical Psychologist,3.488261864012776,1,0,1,0,9,0,0,4,1,2,3,4,0,1,Commerce,Bachelors,31-35,4,0,0,Hybrid,Tier2_City,2,3,4,5,2,3,2,9.77,Manufacturing,5,2,3,1,5,2,4,2,5,1,1,0,4,1,49.64
Law,Nurse,4.624712641320064,3,0,3,0,3,1,4,2,0,2,2,1,1,0,Arts,Bachelors,25-30,9,0,0,Flexible,Tier3_City,2,2,4,5,3,1,4,48.69,Tech,5,5,4,3,4,3,5,2,5,4,1,1,4,3,63.93
Marketing,Construction Manager,3.614968411741763,1,0,2,1,8,0,1,3,0,1,4,1,3,1,Commerce,Bachelors,18-24,1,1,51,Remote,Tier2_City,2,2,3,5,4,1,5,27.49,Healthcare,1,1,4,5,4,2,1,4,3,3,0,0,2,4,44.4
Physics,Marketing Manager,4.739950905506646,5,0,2,1,4,1,4,3,2,2,3,0,2,1,Science,Masters,25-30,9,0,0,Hybrid,Any,2,1,1,4,5,1,2,8.39,Healthcare,3,5,3,5,0,3,3,4,3,4,1,0,2,3,70.91
Medicine,Web Developer,4.846646869328177,3,1,1,0,4,1,0,3,1,4,2,2,1,0,Science,Masters,31-35,0,0,0,Hybrid,Tier1_City,2,3,5,5,0,4,5,12.34,Education,2,2,3,1,5,5,4,5,5,5,1,0,3,2,49.93
Finance,Industrial-Organizational Psychologist,4.489897830356506,5,1,3,1,4,1,1,2,3,1,2,0,1,0,Commerce,Masters,31-35,6,0,0,Remote,Tier2_City,3,1,0,4,4,4,5,22.14,Other,3,1,1,1,2,2,4,5,5,2,1,1,1,4,53.06
Finance,Counselor,4.950863478664398,9,1,0,1,1,1,2,3,2,3,0,1,4,1,Commerce,Bachelors,25-30,10,1,39,Hybrid,Tier2_City,2,2,3,2,2,5,1,28.58,Education,4,2,3,1,5,4,5,4,2,2,0,1,1,4,50.87
Psychology,Biologist,3.182194274967926,8,2,4,1,0,1,2,2,1,3,4,2,4,1,Arts,Bachelors,31-35,0,0,0,Office,Any,4,1,5,1,3,4,3,11.54,Healthcare,5,4,5,2,2,2,1,5,3,2,0,1,4,4,40.03
Education,Illustrator,4.722141706743566,1,2,0,1,0,0,2,3,2,0,3,2,4,0,Arts,Bachelors,36-40,7,1,39,Hybrid,Tier1_City,4,4,1,2,3,5,4,16.05,Other,5,1,3,4,2,2,4,3,3,5,1,0,5,5,60.1
Engineering,Legal Consultant,4.37626305106607,7,0,0,1,3,1,4,4,3,3,0,2,0,0,Science,Bachelors,18-24,14,0,0,Hybrid,Tier1_City,2,1,1,1,5,5,4,39.83,Other,1,1,1,3,0,3,5,5,5,5,1,1,5,2,71.48
Finance,School Counselor,3.705381938969576,1,1,1,1,2,0,3,4,2,1,0,3,3,1,Commerce,Bachelors,25-30,8,0,0,Office,Any,4,2,1,2,5,2,1,22.62,Education,5,5,5,1,1,2,3,3,1,1,1,0,3,3,47.23
Business,Electrical Engineer,2.8798835611640943,1,2,2,1,5,1,2,3,1,3,1,2,3,0,Commerce,Masters,31-35,6,0,0,Flexible,Tier1_City,2,2,1,1,5,2,4,3.07,Healthcare,5,1,5,3,1,5,3,5,5,3,0,0,5,4,62.86
Computer Science,Accountant,3.3141342399038494,1,2,4,1,9,0,2,1,2,3,0,4,2,1,Science,PhD,25-30,8,0,0,Office,Tier1_City,4,4,2,1,4,2,1,5.54,Healthcare,2,4,2,5,3,2,5,3,3,3,0,0,4,2,66.5
Computer Science,Architectural Technologist,3.652526577516759,9,0,2,1,5,0,2,1,4,1,0,4,0,1,Science,Bachelors,31-35,9,0,0,Office,Tier2_City,5,4,1,3,0,2,4,23.65,Other,3,5,5,4,4,0,1,2,2,3,1,1,4,2,52.24
Business,Doctor,4.1934492523539735,0,2,4,0,2,0,4,0,2,2,1,4,0,1,Commerce,High School,25-30,5,0,0,Flexible,Tier2_City,1,3,4,1,1,0,4,5.83,Tech,5,5,4,4,5,4,4,1,3,4,1,1,1,4,46.6
Art,Construction Manager,4.757077636195975,8,0,2,0,7,0,3,4,0,1,4,1,0,1,Arts,Masters,40+,14,0,0,Office,Tier3_City,4,4,1,1,3,2,5,11.17,Tech,4,3,1,3,4,4,5,5,4,5,0,1,3,5,68.68
Architecture,Special Education Teacher,2.8827172304862536,9,1,2,1,1,1,1,4,0,4,2,0,2,0,Interdisciplinary,Bachelors,18-24,14,0,0,Flexible,Tier2_City,4,4,5,3,1,2,1,37.21,Manufacturing,2,1,2,5,3,0,5,5,3,5,0,0,4,1,58.55
Marketing,Human Resources Specialist,3.028952423857897,6,2,3,1,7,0,2,4,1,4,3,1,4,0,Commerce,Masters,25-30,6,1,24,Office,Tier2_City,1,3,0,5,3,2,4,25.58,Tech,2,3,3,5,2,5,5,2,3,5,1,1,1,5,63.7
Art,Credit Analyst,3.9377738892678,0,0,1,1,9,1,3,4,1,3,0,3,0,1,Arts,Masters,18-24,2,0,0,Office,Tier1_City,5,4,2,5,5,5,3,25.68,Finance,1,4,5,2,0,2,2,4,3,2,0,0,3,1,48.2
Law,Psychologist,4.147023289425544,9,1,4,0,0,1,3,0,4,2,4,4,0,0,Arts,PhD,18-24,13,0,0,Office,Tier2_City,1,5,0,3,0,1,1,31.12,Finance,4,1,2,1,4,1,3,4,5,4,1,0,3,1,73.73
Architecture,Education Administrator,3.904818743434245,4,0,2,1,4,1,2,1,3,0,3,1,4,1,Interdisciplinary,Bachelors,25-30,13,1,40,Flexible,Tier1_City,4,5,0,4,0,1,1,40.06,Education,2,3,4,5,2,2,2,4,1,5,1,1,2,4,54.8
Business,Graphic Designer,3.673791158832287,3,0,0,0,5,0,3,3,0,2,1,1,3,1,Commerce,Masters,18-24,8,0,0,Office,Tier1_City,2,5,0,1,3,1,1,10.45,Other,3,3,2,1,1,4,5,2,3,5,0,0,5,2,58.78
Law,Animator,3.439589866177365,5,2,3,0,1,1,4,1,1,4,0,4,3,1,Arts,Bachelors,40+,2,0,0,Office,Any,5,4,3,1,4,3,5,11.13,Finance,4,5,4,1,2,2,3,1,3,3,0,0,5,2,47.49
Medicine,Acoustics Specialist,4.30046304256285,9,2,0,1,8,1,0,4,1,2,3,3,3,0,Science,Masters,36-40,5,1,13,Remote,Tier1_City,4,2,1,3,5,0,1,8.71,Tech,3,3,2,3,3,1,4,4,3,3,0,0,1,1,57.04
Chemistry,Special Education Teacher,4.163733455373597,4,2,1,0,6,0,3,0,4,0,1,0,3,1,Science,Bachelors,25-30,3,0,0,Flexible,Tier2_City,2,2,5,3,0,5,5,47.03,Other,1,3,2,1,0,0,4,4,3,5,0,1,5,1,44.42
Education,Software Developer,2.672879080785714,2,1,4,0,3,1,3,3,1,1,1,4,0,1,Arts,Bachelors,31-35,8,1,22,Hybrid,Any,2,3,1,4,0,4,3,30.13,Manufacturing,1,1,3,3,5,4,2,5,3,2,0,0,5,3,53.24
Computer Science,Lawyer,3.208195225529045,5,1,1,1,6,0,0,4,1,1,1,3,3,0,Science,Bachelors,25-30,0,0,0,Remote,Tier1_City,5,2,0,5,2,5,2,7.35,Healthcare,5,1,3,4,4,1,2,2,2,5,0,0,4,1,40.23
Biology,Web Developer,2.681992375092027,0,0,3,0,9,0,4,1,0,4,0,0,4,1,Science,Bachelors,36-40,8,0,0,Office,Tier1_City,4,2,1,2,0,2,5,13.37,Manufacturing,3,5,3,5,3,1,3,2,5,3,1,0,1,2,55.48
Education,Data Scientist,4.668084727598286,4,0,3,1,3,1,0,2,1,4,2,1,4,0,Arts,Masters,31-35,11,0,0,Hybrid,Tier2_City,3,3,3,5,2,1,4,37.1,Tech,3,1,2,3,1,1,4,3,5,4,0,0,1,4,64.92
Physics,Paralegal,4.071155579259509,6,0,0,1,7,0,4,0,1,0,4,4,4,1,Science,Masters,18-24,3,0,0,Remote,Tier1_City,2,5,1,1,0,5,1,4.36,Tech,1,4,5,2,1,3,2,5,3,2,1,0,5,4,46.1
Computer Science,Marketing Manager,3.814795698854884,0,1,1,1,7,1,0,1,1,4,2,0,0,0,Science,Masters,31-35,9,0,0,Remote,Tier3_City,1,3,1,3,0,0,2,37.11,Tech,3,5,2,3,5,0,5,3,2,1,0,0,5,1,42.3
Business,Aerospace Engineer,3.927433450563761,0,0,1,1,1,1,4,1,1,0,4,3,2,0,Commerce,Bachelors,31-35,4,0,0,Remote,Tier1_City,3,2,0,4,4,2,5,45.84,Education,4,4,3,1,0,4,5,3,4,4,0,1,5,3,57.03
Architecture,Art Director,2.608712469653152,4,0,3,1,2,1,4,3,2,0,3,2,1,1,Interdisciplinary,Masters,25-30,10,1,38,Remote,Any,1,2,2,5,4,3,4,5.65,Finance,5,1,2,2,5,0,2,1,4,4,0,1,3,2,72.41
Engineering,Art Director,2.9372905386593744,3,1,0,1,6,0,2,0,4,2,2,3,3,0,Science,Bachelors,36-40,12,1,18,Hybrid,Any,5,3,2,4,5,4,2,11.76,Tech,5,1,5,1,5,5,1,4,2,2,0,1,1,2,56.67
Engineering,Interior Designer,2.5298163679225567,1,1,2,1,2,1,1,3,0,1,1,4,3,0,Science,Masters,36-40,0,1,29,Flexible,Any,2,4,1,5,0,2,3,3.11,Healthcare,4,5,4,2,5,3,2,2,4,2,0,1,3,2,37.64
Education,Analytical Chemist,3.666518001619505,6,1,3,1,4,0,4,1,3,1,1,3,2,0,Arts,PhD,25-30,13,1,49,Hybrid,Tier1_City,2,2,0,1,5,4,5,8.12,Finance,2,3,1,3,4,5,1,3,5,5,0,0,5,3,78.55
Finance,Electrical Engineer,3.644571625213384,4,0,2,1,2,0,4,1,1,3,3,2,4,0,Commerce,Bachelors,31-35,0,0,0,Hybrid,Tier1_City,5,2,2,2,5,5,5,32.0,Finance,3,2,3,1,1,4,4,5,4,1,1,1,5,3,41.65
Engineering,Entrepreneur,3.312983931602302,0,1,2,1,2,1,2,3,2,0,3,1,0,1,Science,Masters,40+,5,1,27,Office,Tier1_City,2,3,5,4,5,2,3,5.11,Education,2,2,2,3,3,2,2,2,3,2,0,0,1,1,54.93
Education,Legal Secretary,4.58712345919213,0,2,2,0,1,1,0,4,1,2,1,4,4,1,Arts,High School,25-30,9,0,0,Hybrid,Tier2_City,3,2,2,4,5,3,5,23.01,Manufacturing,2,1,5,5,1,0,4,4,1,2,0,1,4,3,47.33
Law,Inorganic Chemist,2.8452573505871155,0,0,2,1,5,0,0,4,4,0,3,0,0,1,Arts,Bachelors,25-30,14,0,0,Office,Tier1_City,3,4,4,2,3,5,1,26.66,Other,3,4,3,2,4,3,2,2,2,4,0,1,4,4,53.74
Computer Science,Curriculum Developer,4.486799026032307,5,2,4,0,5,0,2,0,3,3,0,2,4,1,Science,Bachelors,18-24,12,1,45,Hybrid,Tier3_City,5,4,2,4,3,0,5,45.61,Finance,1,5,3,4,2,2,2,1,1,5,1,0,1,2,58.49
Physics,Art Director,4.235156724617419,4,2,2,1,4,1,1,3,1,0,4,3,0,1,Science,Bachelors,36-40,14,0,0,Hybrid,Tier2_City,4,3,5,4,0,4,1,25.29,Finance,3,3,4,4,1,5,5,4,2,5,0,0,1,2,58.35
Education,Composer,4.38899197482907,7,1,4,0,9,0,3,4,1,4,2,2,2,0,Arts,Masters,31-35,14,1,46,Remote,Tier2_City,2,1,3,5,3,4,5,9.7,Tech,1,1,1,3,1,3,5,4,2,3,1,0,3,2,64.69
Biology,Musician,4.37600023412863,7,1,2,1,4,1,3,4,0,4,2,3,0,0,Science,High School,18-24,0,0,0,Flexible,Tier2_City,3,5,5,5,0,0,4,16.6,Healthcare,4,4,2,2,1,4,1,2,2,1,1,1,4,3,34.54
Architecture,Legal Secretary,4.040590403910209,1,2,2,1,8,0,1,1,1,0,4,3,2,0,Interdisciplinary,Bachelors,40+,12,0,0,Remote,Tier2_City,1,4,4,2,4,4,4,34.59,Tech,1,1,2,2,2,5,4,5,5,3,1,1,2,5,62.47
Chemistry,Psychologist,2.7894465982590133,9,0,0,0,5,0,1,2,4,0,3,1,4,0,Science,Masters,31-35,1,0,0,Hybrid,Tier1_City,2,4,0,1,1,5,2,8.27,Healthcare,2,2,3,3,4,0,3,3,5,5,0,1,3,3,51.99
Marketing,Geneticist,4.344658987517867,8,1,0,0,7,0,2,0,2,4,4,4,0,0,Commerce,Masters,36-40,12,0,0,Remote,Tier1_City,3,5,5,4,2,1,4,13.89,Finance,2,1,5,4,3,3,1,3,2,4,1,0,2,1,65.85
Business,Risk Analyst,4.36693123488033,0,2,3,0,4,1,3,3,1,1,4,3,3,1,Commerce,PhD,18-24,13,1,34,Hybrid,Tier2_City,3,3,4,1,3,0,3,49.8,Healthcare,2,4,3,5,4,5,2,3,3,4,1,0,2,3,75.32
Engineering,Principal,4.289977383560329,5,1,2,0,8,1,3,0,2,4,2,4,0,1,Science,Masters,25-30,2,1,34,Hybrid,Tier2_City,3,2,2,2,3,3,2,3.26,Tech,1,2,4,4,0,4,2,2,4,1,0,0,1,4,54.87
Art,Entrepreneur,3.0151902627124327,9,2,2,0,8,0,2,4,3,2,0,3,0,1,Arts,Masters,31-35,6,0,0,Hybrid,Tier1_City,4,3,4,2,4,2,4,10.15,Tech,2,1,1,1,5,3,5,5,3,5,0,0,4,4,63.45
Marketing,Astronomer,2.867216893983205,3,1,3,1,8,0,3,2,2,2,2,2,3,1,Commerce,Bachelors,25-30,1,0,0,Remote,Tier3_City,5,1,0,5,3,2,1,42.65,Manufacturing,5,2,4,4,3,1,1,2,5,4,1,0,4,2,54.96
Law,Dentist,3.301011513929408,7,1,4,1,4,1,1,0,4,2,1,0,1,0,Arts,High School,31-35,4,0,0,Remote,Tier3_City,4,1,1,4,0,0,5,7.76,Education,3,5,5,1,2,5,2,3,2,2,0,0,5,4,31.39
Marketing,Pharmacist,2.917654295494906,0,1,1,0,3,0,2,2,2,4,1,3,3,1,Commerce,Bachelors,36-40,8,1,36,Office,Tier1_City,1,5,3,3,0,1,4,4.58,Manufacturing,2,4,2,1,0,5,4,3,5,1,0,0,3,5,53.37
Chemistry,Illustrator,3.177465456849798,1,2,3,1,4,1,1,0,3,2,3,2,0,0,Science,Bachelors,25-30,11,0,0,Remote,Tier2_City,1,1,1,2,1,5,1,8.7,Finance,1,4,5,5,1,5,3,3,4,2,1,0,3,1,57.37
Biology,Surgeon,3.935293047979743,0,1,3,0,2,0,4,1,2,0,1,2,1,1,Science,Masters,36-40,11,1,22,Office,Tier1_City,5,1,0,4,1,3,2,35.6,Healthcare,2,5,4,5,1,0,3,5,1,5,0,0,1,1,60.6
Physics,Biomedical Engineer,2.720734340316162,1,2,0,1,7,1,3,2,0,0,2,0,4,0,Science,Bachelors,18-24,9,0,0,Hybrid,Tier1_City,5,5,1,1,1,2,5,49.68,Tech,1,4,2,4,5,5,4,1,1,5,0,1,4,2,46.3
Music,Physician Assistant,2.509264717794549,1,1,2,0,1,1,0,4,1,0,4,4,1,0,Arts,Masters,25-30,7,1,38,Remote,Tier3_City,3,5,3,5,0,2,4,30.76,Tech,3,4,1,3,4,5,1,3,3,2,0,0,1,2,53.96
Engineering,Chemical Engineer,4.559552304414805,7,0,4,1,7,0,4,4,4,2,3,0,2,0,Science,Bachelors,18-24,11,0,0,Remote,Any,1,5,0,1,5,5,2,8.84,Tech,1,1,3,4,2,1,1,3,2,3,0,1,3,1,66.24
Biology,Microbiologist,4.463770842873841,7,0,4,0,4,0,2,2,2,4,2,4,4,0,Science,Bachelors,25-30,7,0,0,Flexible,Tier2_City,3,5,1,2,5,1,4,11.64,Other,3,3,1,5,2,3,3,5,5,1,1,0,5,2,62.73
Finance,Physician Assistant,4.4045540910678325,9,2,1,1,2,0,2,4,2,0,3,4,0,0,Commerce,Bachelors,25-30,10,0,0,Hybrid,Any,5,5,3,2,1,4,2,28.27,Tech,2,1,3,1,1,2,3,2,3,2,1,1,1,3,53.98
Finance,Digital Marketing Specialist,2.5715240442760376,5,1,4,0,9,0,0,3,1,3,0,1,1,1,Commerce,Masters,36-40,1,1,10,Remote,Tier2_City,1,4,4,1,1,0,4,36.64,Other,5,5,1,1,1,4,4,4,3,2,1,1,1,5,35.46
Business,Clinical Psychologist,3.3341463631799466,8,0,3,0,5,1,4,4,2,3,3,0,4,0,Commerce,Masters,31-35,0,1,6,Office,Tier2_City,3,2,1,2,0,1,1,34.16,Finance,2,5,2,3,5,2,3,4,3,3,0,0,3,3,50.99
Marketing,School Psychologist,4.292157457867083,9,2,4,0,3,0,4,3,0,2,0,0,1,1,Commerce,Masters,25-30,8,0,0,Office,Tier2_City,2,5,4,4,4,1,3,30.01,Education,3,3,2,4,5,2,4,5,4,4,1,0,4,4,58.37
Physics,Analytical Chemist,4.894823393428643,0,0,2,1,0,0,1,3,3,4,2,0,2,1,Science,Bachelors,31-35,9,0,0,Hybrid,Tier1_City,2,2,2,2,3,1,1,49.35,Manufacturing,4,1,2,3,5,1,4,1,3,1,0,0,3,4,51.34
Psychology,Music Therapist,3.9599547655598144,1,2,0,0,1,0,4,4,1,1,4,0,4,0,Arts,PhD,18-24,11,1,8,Hybrid,Tier1_City,3,1,5,5,2,1,5,12.31,Other,4,1,3,3,2,5,5,2,2,3,0,0,5,3,65.51
Medicine,School Counselor,4.826525571738667,6,1,1,0,8,0,0,2,0,0,4,0,1,1,Science,Bachelors,18-24,3,1,41,Remote,Tier2_City,4,4,4,4,5,4,4,11.13,Manufacturing,4,1,2,4,2,4,5,3,4,2,1,0,4,4,41.89
Engineering,Graphic Designer,4.037820343176062,7,0,3,1,2,1,0,2,4,0,3,2,1,1,Science,High School,31-35,8,0,0,Remote,Tier2_City,3,5,4,3,5,5,3,43.38,Other,2,2,5,2,4,5,2,2,1,4,0,1,5,5,50.25
Education,Manager,4.39945480931061,6,1,0,0,1,0,4,4,3,4,1,4,2,1,Arts,PhD,31-35,10,0,0,Hybrid,Tier2_City,1,4,2,2,0,3,3,16.67,Tech,1,2,3,4,1,3,4,1,1,5,0,0,3,2,72.4
Education,Web Developer,4.34115698507546,0,0,0,0,1,0,0,3,4,1,4,1,0,1,Arts,Bachelors,31-35,13,0,0,Office,Tier2_City,5,3,0,2,0,1,5,18.63,Tech,5,1,2,3,2,3,4,3,1,4,0,0,4,1,54.9
Medicine,Biomedical Engineer,3.431445572309726,3,0,0,0,7,0,2,3,3,1,1,1,1,0,Science,Masters,25-30,11,1,20,Hybrid,Tier1_City,3,2,5,5,2,1,5,28.79,Healthcare,5,2,2,2,0,3,2,5,2,5,1,1,3,3,63.0
Marketing,Composer,2.6814823676768054,9,0,1,0,8,0,0,0,1,4,0,2,0,1,Commerce,Bachelors,31-35,10,0,0,Hybrid,Tier1_City,1,5,2,5,2,0,3,20.92,Tech,2,1,1,3,0,3,5,5,2,3,1,0,1,4,46.16
Business,Forensic Psychologist,4.018728739499954,2,1,4,0,5,1,4,3,2,0,2,0,0,1,Commerce,Masters,31-35,6,0,0,Hybrid,Tier2_City,1,2,5,1,1,2,5,16.52,Manufacturing,3,5,5,3,0,5,4,3,4,5,0,1,1,4,57.37
Art,Paralegal,2.98830963963018,9,2,4,1,8,1,1,2,4,1,4,2,1,1,Arts,PhD,40+,11,0,0,Hybrid,Tier1_City,2,2,5,1,2,4,5,46.11,Healthcare,2,1,5,3,3,1,1,3,1,5,0,1,4,3,70.3
Architecture,Curriculum Developer,4.067713385166374,1,0,4,0,8,1,1,2,1,2,3,0,0,0,Interdisciplinary,Bachelors,18-24,5,0,0,Hybrid,Any,3,3,4,1,3,1,4,9.08,Healthcare,4,2,3,1,0,4,3,5,4,2,1,0,4,4,43.87
Biology,Software Developer,4.297816216238466,6,2,2,1,1,1,2,3,3,3,4,1,1,0,Science,Masters,25-30,9,0,0,Hybrid,Tier2_City,4,2,0,5,3,3,1,22.0,Tech,3,3,5,4,2,3,3,1,1,5,0,1,5,3,68.28
Chemistry,Ecologist,2.6943330488321715,3,0,3,1,7,0,4,4,2,1,2,0,1,0,Science,Bachelors,31-35,12,0,0,Remote,Tier1_City,4,1,1,1,5,3,2,3.14,Healthcare,5,5,2,5,3,0,2,1,1,5,1,1,3,4,66.37
Biology,Illustrator,4.433220584495198,5,2,0,1,6,1,0,4,3,3,4,3,2,0,Science,Masters,40+,8,0,0,Office,Tier3_City,5,2,3,1,3,3,3,40.95,Education,2,4,3,1,5,3,5,5,1,1,1,1,5,1,56.15
Education,Geneticist,3.788928402016624,8,1,4,1,4,1,0,0,4,0,2,4,0,0,Arts,Bachelors,18-24,9,1,28,Remote,Tier2_City,5,3,0,3,3,0,2,10.92,Tech,1,3,4,4,1,1,3,2,1,2,1,1,3,2,51.06
Biology,Risk Analyst,2.6640168291978057,4,0,1,0,0,0,2,4,0,4,2,2,1,1,Science,Bachelors,25-30,3,1,18,Hybrid,Tier2_City,2,3,5,1,3,3,3,39.33,Education,1,3,1,1,2,0,2,1,4,3,1,1,2,5,50.07
Biology,Astronomer,2.747964615322046,0,2,4,0,1,0,4,3,4,3,4,3,4,1,Science,Bachelors,25-30,13,0,0,Hybrid,Any,3,5,4,2,1,5,3,9.98,Tech,5,4,1,4,0,2,2,1,2,3,0,0,5,4,70.64
Education,Physicist,3.752049791315879,1,1,3,1,4,1,1,3,3,1,2,0,4,1,Arts,Bachelors,25-30,0,0,0,Office,Tier2_City,5,1,1,5,5,0,1,22.59,Other,3,5,4,2,5,1,5,1,1,3,0,0,4,1,37.24
Engineering,Game Developer,3.748488198829124,1,2,3,0,8,1,3,2,2,3,1,4,1,1,Science,PhD,18-24,4,0,0,Office,Any,3,2,0,4,0,4,3,37.22,Education,4,4,3,5,5,5,5,4,3,3,0,1,1,3,62.13
Computer Science,Software Developer,3.526377321318896,2,2,1,0,5,1,2,3,0,3,1,1,1,1,Science,Bachelors,18-24,12,1,32,Remote,Any,4,3,3,3,5,3,3,15.73,Tech,1,5,4,2,1,3,1,4,5,4,0,0,3,4,61.51
Art,Game Developer,4.237183481501219,3,0,0,1,1,0,2,0,1,0,0,3,3,1,Arts,Bachelors,25-30,5,1,30,Office,Tier1_City,1,3,5,5,5,2,1,17.75,Manufacturing,1,5,5,2,5,4,2,3,2,1,0,1,5,5,37.84
Business,Inorganic Chemist,4.928527348269863,6,2,3,0,3,1,1,0,3,4,3,0,1,0,Commerce,Bachelors,25-30,5,1,27,Remote,Tier1_City,4,2,4,5,5,1,5,34.36,Other,2,5,2,4,0,4,2,1,2,2,1,1,3,5,46.82
Finance,Advertising Manager,3.1556228774312864,9,2,3,0,0,1,2,2,0,1,0,2,0,1,Commerce,Bachelors,18-24,11,1,39,Remote,Tier2_City,2,2,2,2,2,4,2,11.82,Other,5,3,4,3,4,0,1,4,4,2,0,0,5,4,48.56
Medicine,Architect,3.6075723989523647,6,1,3,1,3,1,4,4,1,4,3,2,3,1,Science,Masters,25-30,0,0,0,Flexible,Tier3_City,3,5,5,1,0,5,3,47.73,Other,1,5,4,3,3,1,4,1,5,4,0,0,4,3,57.88
Architecture,Legal Consultant,4.390252945066445,3,0,1,0,5,1,2,1,0,0,4,0,2,1,Interdisciplinary,PhD,18-24,14,0,0,Remote,Tier3_City,1,5,3,2,2,2,1,11.87,Tech,2,4,5,3,5,0,5,1,4,2,0,0,2,4,60.21
Education,Industrial-Organizational Psychologist,4.608877413143626,0,2,3,1,1,1,1,0,3,4,1,3,4,1,Arts,Bachelors,40+,6,0,0,Remote,Tier3_City,1,1,3,1,1,4,3,38.25,Manufacturing,3,3,3,3,1,5,1,3,2,3,1,1,5,3,49.23
Physics,Financial Controller,4.808355130208298,2,1,0,0,6,0,1,1,1,3,3,4,2,1,Science,Masters,25-30,7,1,34,Remote,Tier2_City,2,5,3,1,1,5,1,40.72,Finance,1,5,2,5,0,0,3,5,1,4,1,1,3,3,56.34
Chemistry,Civil Engineer,3.495229344281889,0,2,4,1,6,1,0,0,2,3,4,2,4,0,Science,Masters,36-40,11,0,0,Hybrid,Tier3_City,1,5,3,5,4,3,2,20.6,Other,5,2,2,2,4,5,2,5,1,3,1,1,5,4,58.33
Chemistry,Forensic Psychologist,2.885154365937576,2,0,2,0,8,1,2,1,2,1,4,3,3,0,Science,Bachelors,25-30,4,1,35,Flexible,Tier3_City,3,4,1,1,4,4,4,10.34,Finance,2,2,1,1,3,4,2,1,4,4,1,1,5,3,55.95
Biology,Mechanical Engineer,4.0770957031117065,2,1,2,1,3,1,0,2,2,3,2,2,1,0,Science,Masters,36-40,1,1,25,Remote,Tier1_City,4,2,5,3,1,4,5,10.8,Tech,3,5,2,5,0,1,5,3,2,3,0,0,3,2,45.12
Computer Science,Quantum Physicist,3.6594678101895255,2,2,4,1,3,0,4,2,2,0,3,4,0,1,Science,Bachelors,25-30,1,1,52,Hybrid,Tier1_City,3,5,5,3,1,4,4,49.32,Other,2,2,2,4,2,4,4,4,2,5,1,1,5,3,53.16
Chemistry,Zoologist,4.565070762103446,8,2,3,0,8,1,1,3,0,1,1,3,3,0,Science,Masters,25-30,10,0,0,Hybrid,Tier2_City,5,4,0,3,2,0,1,37.09,Manufacturing,4,1,2,5,4,1,4,2,2,2,1,1,1,1,55.47
Psychology,Quantum Physicist,4.757628742978644,4,0,4,0,9,1,2,2,4,3,3,0,4,0,Arts,Masters,25-30,4,0,0,Hybrid,Tier2_City,1,4,3,5,1,2,3,24.15,Manufacturing,5,3,2,5,1,4,5,3,3,1,1,1,2,3,50.8
Business,Construction Manager,3.470109900861236,8,0,4,1,9,1,2,1,4,4,3,3,2,1,Commerce,Bachelors,31-35,6,1,39,Hybrid,Tier2_City,1,5,3,2,0,5,5,15.1,Other,5,1,5,4,0,1,5,1,1,3,1,1,4,2,52.57
Engineering,Manager,2.620397061925361,1,2,2,0,3,1,3,2,2,1,3,2,1,0,Science,PhD,25-30,6,0,0,Hybrid,Tier1_City,3,3,4,4,2,3,2,3.89,Healthcare,1,3,1,1,1,2,4,5,4,2,0,0,2,2,56.34
Computer Science,Web Developer,3.161799958053902,5,1,3,0,4,0,3,2,2,4,2,2,3,0,Science,Masters,25-30,12,0,0,Hybrid,Tier1_City,2,5,2,1,1,1,5,34.51,Healthcare,2,4,4,2,2,4,5,4,4,2,0,1,5,5,62.46
Biology,Game Developer,3.0895600123671745,5,1,1,0,9,1,1,4,2,0,3,0,4,1,Science,Bachelors,18-24,3,1,36,Flexible,Tier3_City,3,5,4,4,2,3,3,47.98,Other,3,2,1,5,1,5,4,3,1,4,0,0,5,2,43.04
Finance,Software Developer,4.694548312282807,9,2,4,0,6,0,1,0,2,2,1,0,2,0,Commerce,Masters,31-35,10,1,56,Remote,Any,4,2,0,2,2,3,4,8.02,Education,1,2,3,4,4,2,1,5,4,2,1,0,2,4,55.12
Engineering,Geneticist,4.832206015439628,1,0,0,0,8,0,4,1,4,3,3,0,3,0,Science,Bachelors,25-30,13,0,0,Remote,Any,2,3,1,2,3,0,1,38.46,Healthcare,5,2,4,4,3,0,2,3,4,5,0,1,2,4,72.66
Architecture,Music Teacher,3.431051508076785,7,2,0,1,3,0,0,3,3,3,3,3,4,0,Interdisciplinary,PhD,18-24,2,1,19,Flexible,Tier2_City,1,1,2,5,4,0,4,10.2,Tech,2,5,1,1,0,4,5,2,4,4,1,1,3,3,59.99
Chemistry,Astronomer,3.990862824327343,0,0,3,0,5,0,3,0,2,3,2,3,1,0,Science,Masters,25-30,8,0,0,Office,Any,1,5,5,3,2,4,5,40.23,Healthcare,3,3,1,5,5,5,3,3,4,2,0,0,3,2,61.48
Law,Special Education Teacher,3.1682710619111147,1,1,1,1,4,1,4,2,1,4,0,0,3,1,Arts,High School,25-30,11,0,0,Office,Tier1_City,2,5,4,3,5,3,3,20.42,Healthcare,5,5,1,4,3,0,3,2,4,3,0,1,4,4,59.84
Law,Music Teacher,4.907902191530356,1,1,2,1,7,1,4,4,2,4,3,4,1,0,Arts,Bachelors,36-40,13,0,0,Hybrid,Any,2,2,4,2,2,2,1,36.47,Tech,3,2,1,1,0,4,3,4,2,4,0,0,2,2,67.68
Art,Urban Planner,4.688982593640373,6,1,4,0,5,0,2,2,3,0,3,2,1,1,Arts,Masters,18-24,13,1,13,Hybrid,Tier2_City,2,1,5,5,5,0,3,46.54,Tech,2,4,1,1,1,0,4,1,3,1,0,1,1,2,61.17
Medicine,Physician Assistant,4.088525828338233,1,1,3,0,4,1,1,4,4,3,1,3,3,1,Science,Bachelors,25-30,6,0,0,Hybrid,Tier3_City,1,4,1,5,3,5,3,32.15,Education,3,2,1,4,1,3,1,1,5,1,1,0,2,5,60.01
Law,Animator,4.324213383421759,2,2,0,1,6,1,3,4,3,2,2,0,4,1,Arts,High School,36-40,1,0,0,Remote,Tier1_City,1,3,5,1,1,0,5,46.27,Manufacturing,1,5,5,4,4,1,1,2,2,2,1,1,2,4,38.8
Business,Software Developer,3.540516898962507,8,2,2,1,7,1,0,4,3,0,0,3,3,1,Commerce,Bachelors,31-35,0,0,0,Office,Any,1,1,1,3,2,2,4,14.05,Healthcare,1,2,5,5,1,0,5,4,2,5,0,0,2,3,44.86
Art,AI Researcher,2.764480895410683,8,0,4,1,7,0,4,1,3,4,1,4,2,1,Arts,Bachelors,25-30,10,1,44,Hybrid,Tier2_City,1,5,5,2,3,0,3,48.97,Other,2,1,4,5,2,1,1,3,2,5,0,0,5,4,70.79
Chemistry,Urban Planner,3.721377771224008,9,2,2,1,7,0,1,4,2,2,1,4,4,1,Science,Bachelors,36-40,1,0,0,Flexible,Tier1_City,1,4,2,4,0,2,3,44.02,Other,5,1,2,2,4,0,3,3,2,5,1,1,2,5,46.91
Art,Digital Marketing Specialist,3.4326490125097937,2,2,0,0,7,0,3,3,1,0,4,0,0,1,Arts,Bachelors,25-30,12,0,0,Hybrid,Tier1_City,3,2,3,3,3,1,3,8.06,Finance,4,5,1,4,0,4,1,4,4,1,0,0,2,3,54.84
Architecture,Dentist,3.596013163297214,3,0,2,1,8,0,2,3,2,4,3,1,2,0,Interdisciplinary,Bachelors,25-30,11,0,0,Remote,Tier1_City,3,5,1,1,4,2,1,22.44,Manufacturing,4,1,2,3,1,1,5,2,5,2,0,0,5,3,66.31
Medicine,Landscape Architect,3.3995127123996665,6,0,1,0,9,1,4,0,2,3,0,2,3,0,Science,Masters,40+,2,0,0,Hybrid,Tier2_City,3,2,4,5,4,1,3,46.57,Tech,4,3,5,3,0,5,2,2,5,1,0,0,4,2,52.03
Biology,Curriculum Developer,4.166770553875688,9,0,2,1,4,1,3,1,2,1,3,4,4,0,Science,Bachelors,36-40,4,0,0,Remote,Tier1_City,2,3,4,2,1,5,3,6.67,Other,5,3,3,2,1,1,3,1,4,2,1,0,5,4,46.35
Art,AI Researcher,4.70031206665112,6,2,0,1,6,0,2,4,1,1,3,0,4,0,Arts,Bachelors,25-30,13,1,43,Office,Tier2_City,1,2,3,3,5,4,5,24.33,Healthcare,1,5,1,4,4,2,4,1,4,1,1,0,4,1,55.33
Marketing,Credit Analyst,4.871656839390792,1,1,3,0,7,1,1,3,0,3,4,2,4,0,Commerce,Bachelors,18-24,14,0,0,Hybrid,Tier3_City,3,1,3,4,1,4,3,37.01,Education,1,1,4,1,5,5,3,4,5,3,0,1,1,1,56.56
Computer Science,Conductor,3.2889583628812016,5,2,4,0,0,0,1,2,3,0,0,1,3,1,Science,Masters,25-30,2,1,37,Hybrid,Any,2,1,1,1,5,0,3,4.57,Finance,1,3,2,3,2,5,5,3,2,4,1,0,1,1,44.1
Computer Science,Industrial-Organizational Psychologist,3.525335790317492,8,0,3,1,2,1,4,0,2,3,0,4,2,0,Science,Bachelors,18-24,9,0,0,Flexible,Tier1_City,4,3,3,1,5,2,5,38.38,Manufacturing,2,1,4,5,0,5,3,5,4,4,1,0,5,2,68.0
Chemistry,Biochemist,3.40933244503104,7,2,2,0,1,1,2,2,1,4,2,0,0,1,Science,Bachelors,18-24,8,0,0,Flexible,Tier1_City,5,3,4,3,5,0,1,19.98,Healthcare,1,2,1,3,3,1,1,2,2,1,1,1,3,1,49.21
Marketing,Geneticist,4.521131014062739,2,2,2,1,9,0,1,2,3,0,2,1,4,1,Commerce,Bachelors,25-30,9,0,0,Flexible,Tier1_City,4,3,1,4,5,2,4,14.72,Tech,1,1,2,4,1,1,5,4,2,2,0,1,3,1,49.24
Architecture,Accountant,4.976418612115159,6,0,0,1,4,1,0,0,3,4,2,0,1,1,Interdisciplinary,Masters,36-40,3,0,0,Remote,Tier1_City,4,1,2,1,4,0,5,30.07,Manufacturing,1,1,2,3,4,1,5,5,4,2,1,0,4,3,46.39
Architecture,Nurse,3.712514514232069,3,1,1,1,3,0,2,4,1,1,4,3,4,1,Interdisciplinary,Masters,36-40,6,1,57,Office,Tier3_City,5,5,0,2,4,4,1,28.58,Finance,4,5,1,2,0,5,2,4,4,5,1,1,4,3,65.01
Art,Marketing Manager,4.443028157874336,5,0,0,1,4,1,3,1,1,4,2,0,3,1,Arts,Masters,25-30,3,1,58,Flexible,Tier2_City,2,1,1,1,2,5,4,44.08,Tech,3,2,3,5,4,0,3,3,5,5,0,0,1,1,61.29
Art,Pharmacist,3.8963285120384095,4,2,4,1,5,1,4,1,2,3,1,1,2,0,Arts,Masters,25-30,2,0,0,Hybrid,Tier2_City,5,2,5,4,4,4,3,34.77,Finance,1,3,1,2,0,5,3,5,4,1,0,0,1,2,46.37
Computer Science,Artist,2.968350741569944,3,0,3,1,2,1,4,4,4,1,0,2,0,1,Science,Masters,18-24,9,0,0,Remote,Tier1_City,2,3,2,5,1,0,5,22.83,Healthcare,3,3,4,1,2,5,3,2,1,2,0,0,3,5,56.06
Medicine,Cybersecurity Analyst,2.9699687947935143,5,2,1,1,6,1,4,1,2,0,1,4,3,1,Science,Bachelors,18-24,0,0,0,Office,Tier3_City,4,4,4,5,4,2,3,33.56,Manufacturing,1,1,5,1,5,3,5,4,2,3,1,1,1,2,42.51
Computer Science,Marketing Manager,4.836326524620969,7,2,2,0,1,1,4,4,3,3,4,1,0,1,Science,Masters,18-24,13,0,0,Flexible,Any,5,1,1,3,1,3,5,38.26,Education,4,4,5,1,1,1,1,4,2,4,0,0,5,5,68.66
Art,Doctor,4.74461408729001,6,1,3,1,0,0,4,2,4,1,0,2,4,1,Arts,High School,31-35,11,1,51,Office,Tier2_City,4,4,1,4,0,5,4,47.05,Healthcare,4,4,5,1,0,3,2,1,3,2,0,0,5,3,50.03
Biology,Art Director,3.046948939814066,9,2,4,0,3,0,0,3,1,2,2,0,2,0,Science,Masters,18-24,8,1,59,Remote,Any,5,5,1,1,4,2,1,36.1,Other,3,3,2,4,3,5,2,3,2,5,0,1,1,1,56.74
Law,Organic Chemist,2.770559869577374,9,0,4,1,1,0,1,3,3,1,2,3,2,1,Arts,Masters,36-40,12,0,0,Remote,Tier1_City,5,1,3,1,1,0,5,28.56,Healthcare,4,1,2,4,1,1,4,4,1,1,0,1,4,4,55.57
Business,Industrial-Organizational Psychologist,2.682153619521022,7,0,3,1,3,1,0,1,4,4,3,0,3,0,Commerce,Bachelors,31-35,10,0,0,Hybrid,Tier1_City,1,5,3,5,5,2,1,20.53,Education,2,1,1,4,1,4,2,2,2,2,1,1,2,5,57.55
Education,Brand Manager,4.043954777624997,7,2,3,0,5,0,2,3,3,0,4,4,2,0,Arts,Bachelors,18-24,0,0,0,Hybrid,Any,3,5,4,5,3,1,3,44.9,Education,5,2,2,2,4,3,3,5,2,2,0,0,5,1,46.91
Law,Quantum Physicist,3.5522763995246684,4,0,0,1,9,0,3,4,4,4,0,4,4,1,Arts,Bachelors,18-24,10,1,36,Office,Tier3_City,3,1,2,2,5,2,3,40.25,Other,5,5,4,2,1,2,4,1,3,1,0,1,5,3,66.36
Medicine,Entrepreneur,4.290631731481534,0,2,2,0,1,0,1,1,0,4,1,0,4,0,Science,Masters,31-35,12,0,0,Remote,Tier1_City,4,1,1,5,2,4,4,6.63,Other,1,4,1,3,0,1,4,5,2,3,0,1,1,1,52.33
Art,Art Therapist,2.503651164235581,2,1,2,0,8,1,0,0,0,2,2,3,4,1,Arts,Masters,36-40,0,0,0,Remote,Tier1_City,4,5,0,2,1,4,4,35.88,Tech,4,1,4,5,2,4,1,5,1,4,0,0,3,1,35.83
Marketing,Human Resources Specialist,3.570387841574292,6,0,3,0,1,1,4,1,2,3,1,4,1,0,Commerce,Masters,31-35,14,0,0,Hybrid,Tier2_City,4,3,0,1,5,1,2,28.32,Finance,5,3,5,2,0,3,2,1,4,3,1,1,5,4,69.54
Medicine,School Psychologist,4.300805252358044,1,1,3,1,4,0,4,3,4,1,4,4,3,0,Science,Bachelors,25-30,0,0,0,Remote,Tier3_City,1,1,0,2,4,5,2,7.87,Healthcare,3,4,4,3,5,5,2,4,4,3,0,1,4,5,56.27
Law,Legal Consultant,4.060327812751093,2,1,4,0,5,0,4,3,2,4,4,4,0,0,Arts,Masters,25-30,13,0,0,Hybrid,Tier3_City,1,5,3,2,4,2,4,29.55,Tech,3,5,5,1,1,4,3,3,2,5,1,1,3,1,75.05
Chemistry,Zoologist,3.069646342297468,2,1,3,0,9,0,3,2,4,2,4,3,2,1,Science,Masters,25-30,4,1,24,Hybrid,Tier1_City,4,2,4,3,0,5,3,12.05,Other,3,1,2,1,3,2,1,3,4,4,0,1,2,5,61.58
Physics,Biochemist,4.376213894677031,7,1,0,1,1,1,1,4,4,1,1,2,3,1,Science,Masters,40+,6,1,15,Office,Tier2_City,1,4,1,5,3,3,1,36.28,Tech,1,4,1,2,5,2,5,5,5,3,0,0,4,5,59.08
Law,Chemist,4.360657834116701,4,2,4,0,2,1,2,1,0,1,3,0,4,0,Arts,Bachelors,31-35,6,0,0,Office,Tier2_City,5,2,4,2,1,2,4,16.09,Healthcare,5,1,3,4,3,2,5,5,5,2,0,1,1,2,43.88
Engineering,Mechanical Engineer,4.697336670970671,5,2,0,1,1,1,1,2,1,1,2,3,0,0,Science,Bachelors,31-35,9,0,0,Remote,Tier2_City,5,1,3,1,5,4,1,10.07,Finance,5,5,4,3,5,2,5,3,1,2,1,1,3,4,48.04
Business,Clinical Psychologist,4.444981289733346,6,2,2,0,2,1,2,2,2,2,1,0,0,1,Commerce,Masters,25-30,0,0,0,Flexible,Tier2_City,5,1,1,4,3,4,2,6.85,Education,5,2,1,5,0,4,4,2,2,5,0,0,5,3,49.12
Business,Surgeon,2.5936500824187227,8,1,4,1,2,1,4,3,1,0,0,3,3,1,Commerce,Masters,31-35,5,1,30,Office,Tier2_City,3,1,1,2,0,5,1,26.07,Healthcare,3,4,3,3,0,5,5,2,4,4,1,1,4,2,54.24
Engineering,Advertising Manager,4.722597821792522,2,0,0,0,1,1,2,3,1,4,3,2,1,0,Science,PhD,25-30,8,0,0,Hybrid,Tier1_City,5,1,5,5,2,0,4,12.38,Finance,3,5,1,4,0,3,3,5,4,1,1,1,5,3,62.43
Business,School Psychologist,4.916826046237736,2,2,3,0,2,1,3,0,3,3,0,3,2,1,Commerce,Bachelors,18-24,5,1,33,Flexible,Tier2_City,3,2,4,3,3,4,3,43.19,Education,1,2,3,4,0,2,5,3,1,2,0,1,1,2,47.28
Marketing,Chemical Engineer,4.27100966916772,4,2,4,1,3,0,1,3,3,4,2,3,1,1,Commerce,Bachelors,25-30,14,1,20,Remote,Tier1_City,5,3,0,1,0,0,4,3.14,Manufacturing,2,2,1,2,4,4,2,1,5,1,1,0,4,5,61.44
Art,Chemist,3.166103373691241,9,0,2,0,8,1,4,3,1,4,3,1,2,0,Arts,PhD,36-40,3,0,0,Hybrid,Tier1_City,4,5,0,3,1,4,5,42.65,Healthcare,5,5,5,4,0,5,1,4,2,5,0,0,1,1,62.19
Education,Music Therapist,4.750649521652125,6,0,3,1,7,0,3,4,0,4,1,3,1,1,Arts,Bachelors,31-35,14,0,0,Remote,Tier1_City,3,5,5,4,2,4,5,27.49,Other,1,3,3,4,4,4,1,1,5,2,0,1,4,5,62.51
Education,Physician Assistant,4.981999108774244,7,0,0,1,2,1,1,2,4,4,1,0,1,0,Arts,Masters,18-24,9,1,25,Hybrid,Tier1_City,1,5,2,2,4,3,5,46.34,Healthcare,3,5,1,5,1,3,2,2,1,2,0,0,4,1,56.41
Business,AI Researcher,3.5977446218433813,4,0,2,0,6,0,1,1,1,4,2,0,3,1,Commerce,Bachelors,36-40,8,0,0,Hybrid,Tier2_City,3,4,2,2,0,0,3,12.62,Other,2,1,3,4,0,4,1,2,2,3,0,0,5,1,44.41
Music,Nurse,4.243968382395265,8,2,1,0,2,0,0,1,0,3,1,3,0,1,Arts,Bachelors,25-30,12,0,0,Hybrid,Tier1_City,2,1,4,5,4,0,4,7.81,Finance,4,3,5,1,0,5,1,2,1,5,0,0,5,2,47.25
Medicine,Teacher,3.990509449480568,5,1,3,0,6,0,0,0,2,3,1,3,0,1,Science,Masters,18-24,2,0,0,Remote,Tier2_City,3,2,5,2,2,4,5,32.37,Tech,2,2,3,4,3,0,2,5,1,5,1,1,5,5,43.05
Music,Forensic Psychologist,4.308182010421179,1,0,4,1,1,0,0,0,3,2,4,3,3,0,Arts,Masters,25-30,12,0,0,Remote,Any,5,2,1,1,0,0,4,36.22,Tech,1,4,3,1,1,5,3,5,4,3,0,0,4,4,59.07
Music,Art Director,4.185112392273834,9,0,3,1,9,0,2,3,4,0,2,0,3,0,Arts,Bachelors,25-30,9,1,53,Hybrid,Tier1_City,5,2,3,4,0,4,2,20.51,Finance,2,2,1,5,1,3,4,1,5,5,1,0,5,2,60.39
Art,Inorganic Chemist,3.8785331765160014,1,1,2,0,7,1,1,2,1,3,0,3,3,1,Arts,Bachelors,25-30,3,0,0,Remote,Tier1_City,5,3,3,3,2,4,5,3.64,Healthcare,3,4,4,2,0,5,5,1,1,3,1,0,4,3,40.21
Business,Nuclear Physicist,4.86223846954362,0,2,0,1,0,0,2,1,3,2,3,1,4,0,Commerce,Masters,25-30,3,0,0,Office,Tier2_City,1,1,2,4,1,5,5,22.13,Healthcare,2,4,5,1,1,4,2,1,1,3,0,1,4,4,45.25
Law,Advertising Manager,3.4877183833659413,0,2,4,1,4,0,2,2,3,0,1,3,3,0,Arts,Bachelors,31-35,3,1,9,Office,Tier1_City,4,5,2,2,0,2,3,13.99,Other,3,5,1,2,2,1,2,2,2,3,1,1,3,2,39.31
Finance,Construction Manager,4.15466900255232,4,2,0,0,5,0,3,3,4,4,4,2,0,0,Commerce,Masters,25-30,5,0,0,Hybrid,Tier2_City,3,5,3,3,2,0,4,19.33,Healthcare,2,5,2,2,5,1,1,4,2,4,1,1,5,3,63.9
Law,Biologist,3.3190392222474854,0,1,0,1,7,0,2,4,1,4,3,1,0,0,Arts,Bachelors,31-35,12,1,49,Remote,Tier1_City,1,1,5,5,3,1,3,26.82,Manufacturing,1,2,3,1,3,2,5,4,5,2,1,1,1,3,64.68
Psychology,Curriculum Developer,2.789723480216101,7,2,2,1,1,1,1,2,2,4,1,1,3,1,Arts,Masters,18-24,10,0,0,Remote,Tier1_City,2,5,0,4,4,5,3,36.01,Other,4,5,2,3,1,3,4,3,5,2,0,0,2,4,61.79
Music,Musician,2.777898666896556,1,2,1,1,0,0,0,1,4,0,3,4,2,0,Arts,PhD,31-35,14,0,0,Office,Any,3,5,4,3,0,0,4,48.27,Tech,5,2,1,4,2,5,4,3,5,2,1,1,5,4,63.84
Medicine,Accountant,3.092802942588303,5,2,2,1,9,1,2,3,3,2,4,0,0,1,Science,Masters,31-35,14,0,0,Flexible,Tier1_City,5,1,2,3,3,0,2,9.77,Manufacturing,2,5,4,5,0,4,2,2,4,4,0,0,4,2,71.11
Chemistry,Industrial-Organizational Psychologist,4.829333879390891,1,1,2,0,5,0,2,2,2,0,3,1,3,1,Science,Bachelors,31-35,10,1,55,Hybrid,Tier1_City,1,2,2,3,0,3,4,34.96,Healthcare,4,5,5,2,3,4,3,3,4,2,0,0,1,1,50.11
Engineering,Biochemist,2.511697480542081,4,0,1,0,1,0,3,4,0,0,1,0,2,0,Science,Masters,25-30,6,1,57,Office,Tier1_City,1,4,3,1,1,1,2,13.96,Tech,2,4,1,3,5,0,3,4,1,3,0,1,4,1,44.44
Chemistry,Interior Designer,2.938119219268582,0,2,0,0,7,0,0,0,2,1,3,4,1,0,Science,Bachelors,31-35,13,0,0,Flexible,Tier1_City,3,1,0,4,2,1,3,13.37,Other,4,3,4,2,3,0,2,5,2,1,0,0,3,5,46.37
Marketing,Dentist,4.545115924897679,7,2,2,1,9,0,4,4,4,3,0,2,2,1,Commerce,Bachelors,18-24,8,1,37,Remote,Tier1_City,1,5,3,3,0,3,2,32.78,Healthcare,3,5,1,3,3,2,3,2,4,1,1,1,1,3,55.67
Finance,Advertising Manager,3.7625158972493993,8,2,4,1,8,0,0,1,4,0,1,3,0,1,Commerce,PhD,36-40,13,1,59,Flexible,Tier1_City,1,5,2,4,2,3,2,39.47,Other,4,5,4,5,2,3,5,5,3,2,1,0,1,2,59.09
Law,Organic Chemist,3.677558611668289,7,0,3,0,3,1,2,3,2,2,0,4,2,0,Arts,Masters,18-24,10,0,0,Hybrid,Tier2_City,1,4,5,3,5,0,2,48.96,Healthcare,5,2,2,3,4,2,3,3,5,5,0,0,3,2,74.94
Computer Science,Interior Designer,3.23845788476412,6,0,2,1,7,0,2,2,2,0,3,3,0,0,Science,Masters,18-24,2,0,0,Flexible,Tier3_City,3,4,3,5,0,2,5,39.14,Finance,4,4,4,5,3,0,5,5,2,2,0,1,4,3,44.43
Architecture,Industrial-Organizational Psychologist,4.032827937849093,7,1,1,0,1,0,3,1,1,3,4,3,3,1,Interdisciplinary,Bachelors,25-30,7,0,0,Hybrid,Tier2_City,5,4,4,5,1,3,5,10.39,Tech,5,4,5,4,2,0,3,1,1,4,0,0,3,3,57.71
Chemistry,Social Media Manager,3.6474647275653913,8,2,3,0,2,0,1,3,2,2,4,3,1,1,Science,High School,31-35,7,0,0,Remote,Tier2_City,1,1,2,5,1,1,3,13.59,Healthcare,5,3,2,3,5,3,4,2,2,5,0,0,3,5,54.23
Finance,Architectural Technologist,4.72490911574293,3,1,3,1,7,1,3,0,3,2,0,3,3,0,Commerce,High School,18-24,0,0,0,Flexible,Tier3_City,1,2,2,2,3,1,4,38.79,Education,4,3,3,2,4,5,2,2,2,1,0,1,2,3,31.38
Education,Human Resources Specialist,3.8384688957916495,4,2,4,0,6,1,2,1,3,2,3,3,0,0,Arts,Masters,36-40,4,0,0,Remote,Any,4,4,2,3,1,0,2,27.77,Education,5,3,2,4,2,2,5,3,1,3,0,0,5,4,48.59
Business,Nuclear Physicist,3.696290880076763,7,0,3,1,0,0,1,1,0,1,3,2,1,0,Commerce,Masters,40+,12,0,0,Flexible,Tier2_City,2,3,2,2,2,2,5,16.88,Other,5,5,2,2,2,0,4,4,4,2,0,0,3,1,56.78
Physics,Financial Advisor,4.930772730628599,8,2,4,1,2,0,3,1,0,3,2,2,1,0,Science,Bachelors,31-35,9,0,0,Remote,Any,4,2,2,4,5,4,4,25.17,Healthcare,3,2,3,2,2,4,2,5,3,2,0,0,1,5,53.98
Medicine,Biochemist,4.915449192881063,6,1,4,0,6,0,0,1,0,1,3,1,1,1,Science,Masters,25-30,4,0,0,Office,Tier2_City,5,4,1,2,1,3,2,46.0,Finance,1,1,2,4,3,1,4,5,4,2,1,0,1,1,45.11
Engineering,Counselor,2.636450959346369,8,1,0,0,2,0,4,2,2,0,4,1,0,0,Science,High School,31-35,11,0,0,Hybrid,Tier3_City,4,5,1,4,0,3,4,38.51,Other,3,2,2,4,0,0,5,5,5,5,1,1,4,2,64.3
Art,Urban Planner,4.755910829991422,1,2,1,0,0,1,4,4,1,3,4,2,0,0,Arts,Bachelors,25-30,7,0,0,Flexible,Tier2_City,3,1,3,4,1,0,1,24.18,Healthcare,1,4,3,5,5,5,3,5,3,4,1,0,1,3,64.17
Computer Science,Chemical Engineer,3.587594421856987,1,2,1,1,7,0,4,0,2,3,2,4,0,1,Science,Bachelors,25-30,7,0,0,Remote,Any,4,5,5,4,5,5,2,49.09,Education,1,3,3,3,3,2,2,3,3,3,0,0,2,3,61.23
Finance,Legal Secretary,2.584706078913289,9,1,1,1,6,0,1,2,1,1,4,3,0,0,Commerce,Bachelors,36-40,11,1,24,Hybrid,Tier2_City,3,5,1,2,2,5,4,40.36,Tech,3,1,5,5,5,0,4,5,4,3,0,1,3,1,58.66
Psychology,School Counselor,3.4069788999367927,0,0,0,1,1,1,2,0,4,1,2,1,4,0,Arts,Bachelors,40+,1,0,0,Hybrid,Tier2_City,4,1,2,3,0,2,2,3.28,Finance,5,4,2,1,5,4,3,1,4,2,0,0,4,5,35.18
Marketing,Dentist,3.926654113728002,2,1,4,1,9,0,2,1,1,2,3,4,2,0,Commerce,PhD,36-40,2,0,0,Flexible,Tier2_City,4,2,2,2,3,1,2,8.28,Healthcare,3,3,2,1,3,1,1,5,5,3,0,0,2,4,55.88
Physics,Architect,4.28298996134067,3,2,1,1,3,1,4,3,3,3,4,3,4,0,Science,Bachelors,25-30,1,0,0,Hybrid,Any,2,5,2,3,3,1,1,29.04,Education,5,1,2,5,3,1,5,1,5,3,0,0,5,2,60.73
Law,Architectural Technologist,4.70512585701208,3,0,3,0,9,1,3,4,4,2,2,1,3,1,Arts,PhD,18-24,0,0,0,Hybrid,Any,3,2,1,3,3,4,4,19.45,Tech,3,2,5,5,3,4,5,5,2,2,1,0,3,1,57.06
Finance,Graphic Designer,2.959796756007675,7,0,4,1,5,0,3,2,3,4,1,3,1,1,Commerce,Bachelors,25-30,1,1,20,Hybrid,Tier1_City,5,1,1,4,0,1,3,41.19,Education,3,4,2,3,4,2,3,4,1,2,1,1,4,4,39.72
Law,Analytical Chemist,4.6336518927723125,9,2,3,1,7,1,3,3,1,4,0,4,4,1,Arts,PhD,25-30,9,0,0,Remote,Tier2_City,1,4,5,2,3,5,5,45.1,Other,2,5,3,4,4,4,3,5,4,4,1,1,4,1,72.89
Law,Social Media Manager,3.958607384359531,0,1,2,0,8,1,0,1,1,2,0,0,3,1,Arts,Masters,25-30,5,0,0,Office,Tier1_City,5,5,0,3,1,5,2,14.31,Finance,4,1,3,1,2,5,2,2,1,2,0,0,3,3,34.63
Biology,Chemical Engineer,2.8806408553241747,7,2,2,1,8,1,0,3,1,2,0,3,1,1,Science,PhD,25-30,11,0,0,Remote,Tier1_City,4,5,2,5,0,3,2,38.87,Other,3,1,3,4,1,4,4,5,4,2,0,0,1,5,55.04
Music,Curriculum Developer,2.7548413938062715,7,2,4,1,5,0,1,3,2,4,3,3,0,1,Arts,High School,31-35,0,0,0,Office,Any,5,1,5,3,0,4,2,28.16,Manufacturing,4,2,3,2,5,3,1,4,3,4,1,1,3,2,43.5
Finance,Biotechnologist,3.1729497645420857,4,1,4,0,9,0,1,1,1,2,3,2,2,0,Commerce,Masters,31-35,5,0,0,Hybrid,Tier2_City,4,1,5,5,0,2,2,21.42,Healthcare,5,2,4,2,1,5,2,5,5,4,0,1,4,4,50.4
Biology,Education Administrator,3.128606852121409,6,2,4,0,7,1,4,1,4,2,4,2,4,0,Science,PhD,31-35,0,0,0,Remote,Tier1_City,4,4,0,2,4,4,5,39.98,Other,2,4,3,4,0,3,2,4,3,3,1,1,4,5,63.4
Business,Zoologist,4.333329546566829,7,1,3,1,5,1,1,1,2,0,3,0,3,1,Commerce,Bachelors,36-40,1,0,0,Hybrid,Tier2_City,1,1,5,2,2,2,3,29.55,Tech,2,5,5,2,2,3,1,1,4,2,0,1,4,3,39.16
Computer Science,Physical Chemist,2.9266777847601126,3,2,4,0,0,0,2,3,4,3,1,3,1,1,Science,Bachelors,18-24,7,1,24,Office,Tier2_City,2,3,0,2,4,5,1,32.86,Finance,1,3,4,1,5,1,5,3,5,5,1,1,4,3,64.3
Psychology,Architect,4.871252528038024,6,2,3,1,2,0,3,0,1,1,4,1,2,1,Arts,Bachelors,18-24,13,0,0,Hybrid,Tier1_City,2,3,5,3,4,1,3,5.93,Finance,4,1,2,1,0,1,2,3,2,2,1,0,3,5,49.3
Biology,Cybersecurity Analyst,4.318893276148906,5,2,2,0,3,0,4,1,3,3,4,3,1,0,Science,PhD,31-35,5,0,0,Remote,Tier1_City,1,1,5,1,4,0,5,30.54,Manufacturing,2,1,3,2,4,0,5,1,5,3,0,1,4,5,71.58
Engineering,Biotechnologist,4.335630954989556,9,2,1,0,3,0,1,4,2,0,4,1,4,1,Science,Bachelors,25-30,8,0,0,Remote,Tier2_City,5,4,0,3,2,4,4,17.13,Manufacturing,5,4,2,1,3,3,4,5,5,1,1,0,1,1,55.13
Art,Credit Analyst,4.126894969314714,7,0,4,0,1,1,4,1,1,4,3,2,2,1,Arts,Bachelors,25-30,0,1,50,Office,Tier1_City,3,3,5,3,4,4,1,26.18,Healthcare,1,3,3,2,0,2,3,2,4,4,0,1,4,5,50.38
Computer Science,Composer,3.571457336509829,8,2,0,0,0,1,4,3,3,2,4,3,1,0,Science,Bachelors,18-24,4,0,0,Hybrid,Tier1_City,1,5,2,4,3,3,1,13.43,Other,2,3,3,3,0,2,4,2,1,2,1,1,5,4,52.74
Marketing,Musician,3.2054753384655026,6,0,4,0,0,1,3,2,2,1,0,1,1,0,Commerce,High School,25-30,6,0,0,Flexible,Tier1_City,4,4,1,4,0,3,4,31.88,Healthcare,5,3,4,3,4,3,3,4,5,5,0,0,4,2,49.8
Physics,Lawyer,3.1410878616705338,6,2,0,1,4,0,3,4,0,1,3,0,4,1,Science,Masters,31-35,8,0,0,Hybrid,Any,2,1,2,3,0,5,2,9.93,Other,4,4,3,4,2,1,2,5,4,5,0,0,2,1,62.79
Biology,Chemical Engineer,4.059512919223369,0,0,0,0,5,1,4,4,4,2,2,4,4,1,Science,Bachelors,36-40,13,0,0,Hybrid,Tier1_City,2,3,1,5,1,2,5,8.78,Other,5,1,3,2,3,4,3,4,5,2,0,1,1,4,68.92
Physics,Surgeon,2.719824137708555,1,1,2,1,6,1,3,4,0,3,0,4,1,0,Science,Masters,36-40,10,0,0,Hybrid,Tier3_City,5,4,5,4,5,0,4,11.86,Finance,5,2,1,3,3,5,1,5,4,1,0,0,5,5,61.34
Chemistry,Interior Designer,4.128649775607613,3,2,3,1,4,0,3,1,0,3,3,2,4,0,Science,PhD,25-30,8,1,11,Hybrid,Tier2_City,3,5,2,3,3,3,3,41.42,Other,5,1,5,3,2,1,1,5,3,4,0,1,2,3,66.92
Biology,Analytical Chemist,3.2364171262673818,6,2,2,0,3,1,2,3,1,2,3,4,0,1,Science,Bachelors,25-30,3,0,0,Flexible,Tier1_City,1,1,4,1,2,3,3,4.58,Healthcare,3,2,5,1,5,0,4,5,4,2,1,0,1,5,48.39
Biology,Construction Manager,3.605191409554616,3,2,3,1,0,1,3,1,3,1,4,4,1,0,Science,Masters,36-40,12,1,58,Hybrid,Tier2_City,4,2,4,5,5,1,4,37.29,Healthcare,2,2,2,4,4,3,1,2,3,3,1,1,4,4,74.09
Music,Illustrator,4.256702106378012,8,2,0,1,9,0,3,3,3,3,3,1,4,0,Arts,Bachelors,25-30,3,0,0,Remote,Tier2_City,4,3,2,2,0,1,5,5.66,Manufacturing,5,4,2,4,5,1,4,4,3,4,1,0,4,2,53.61
Biology,Analytical Chemist,4.202227362932742,1,0,3,1,8,1,0,4,4,1,1,0,4,1,Science,Masters,25-30,14,1,38,Hybrid,Tier3_City,3,5,2,3,4,5,1,30.82,Finance,1,3,4,3,4,4,5,1,1,5,0,0,4,2,57.65
Medicine,Chemist,2.8345720105402976,8,0,0,0,0,1,1,2,0,2,2,0,2,0,Science,Bachelors,36-40,3,0,0,Hybrid,Any,5,4,2,3,1,5,1,39.36,Education,3,4,2,3,0,0,5,1,3,1,1,1,4,5,33.2
Education,Marketing Specialist,4.402911708750668,5,2,4,0,0,0,2,2,4,0,3,1,4,1,Arts,Masters,31-35,2,0,0,Office,Tier1_City,3,3,4,5,1,3,2,13.86,Education,5,2,1,4,1,1,4,3,4,3,0,1,1,5,52.26
Biology,Principal,4.41527744876812,5,1,2,0,5,1,0,0,1,2,2,2,1,1,Science,Bachelors,36-40,7,1,9,Flexible,Tier3_City,5,3,2,4,0,2,5,12.21,Tech,5,1,2,1,1,3,4,2,1,2,1,0,3,2,33.16
Physics,Software Developer,4.317132316408736,7,0,1,1,6,1,1,4,4,3,2,1,3,1,Science,Bachelors,18-24,4,0,0,Hybrid,Tier1_City,5,1,3,4,3,0,3,16.59,Manufacturing,2,2,3,5,4,4,4,1,1,4,1,1,2,3,52.6
Education,Financial Analyst,4.523366779817559,0,1,0,1,0,1,1,0,1,1,3,3,0,1,Arts,Masters,25-30,6,1,39,Hybrid,Tier1_City,1,5,3,4,5,3,3,35.88,Tech,3,4,2,1,2,1,3,1,1,2,0,1,4,4,43.22
Chemistry,Social Media Manager,4.888804049630361,8,0,2,0,2,1,1,1,2,1,1,0,0,0,Science,Bachelors,36-40,9,0,0,Hybrid,Tier1_City,1,3,3,2,1,2,2,14.98,Finance,5,1,2,5,5,5,1,4,3,5,1,0,4,3,54.52
Law,Lawyer,4.389718120138162,1,2,3,0,7,0,4,2,0,4,3,3,2,0,Arts,Masters,18-24,5,1,45,Flexible,Tier2_City,4,3,2,5,0,2,3,26.58,Education,5,3,3,4,2,3,3,3,4,1,1,1,3,2,58.41
Music,Lawyer,3.36290659861165,7,1,4,1,7,1,0,3,1,2,3,0,4,0,Arts,Bachelors,31-35,13,0,0,Flexible,Tier1_City,2,5,5,5,3,3,2,9.32,Education,4,4,1,4,1,3,3,4,5,3,0,1,1,4,58.15
Marketing,Surgeon,3.682873028131617,5,0,2,0,6,0,2,3,1,1,4,3,3,1,Commerce,Masters,18-24,8,1,48,Flexible,Tier2_City,5,4,0,4,0,2,2,24.68,Education,1,5,5,4,5,1,3,2,5,5,0,0,3,1,70.04
Marketing,Urban Planner,3.63340225039585,9,0,2,0,3,0,2,1,2,0,3,0,0,1,Commerce,Bachelors,36-40,13,0,0,Remote,Tier3_City,4,1,0,4,0,4,4,32.36,Tech,1,2,1,2,2,1,5,4,1,2,0,0,4,4,41.48
Computer Science,Market Research Analyst,3.4207604796224187,3,0,3,0,9,0,1,1,3,1,1,2,1,1,Science,Masters,31-35,2,0,0,Hybrid,Tier3_City,2,3,1,1,3,2,1,6.38,Healthcare,2,3,1,2,2,1,5,5,2,3,0,1,4,3,40.0
Business,Cybersecurity Analyst,3.3699398938370857,5,1,2,0,0,0,2,0,4,4,1,2,2,1,Commerce,Bachelors,18-24,5,1,48,Remote,Any,4,5,5,1,3,3,5,41.32,Tech,3,3,4,2,5,4,3,4,5,2,0,1,3,3,52.13
Education,Electrical Engineer,4.9547989536489085,2,1,4,0,5,1,4,0,4,0,4,4,3,0,Arts,Bachelors,25-30,2,1,54,Hybrid,Tier1_City,5,2,3,3,3,2,5,47.06,Education,5,1,4,4,3,1,2,2,4,2,1,0,2,4,52.93
Business,Interior Designer,2.940313353513332,8,2,3,0,2,1,1,2,0,2,3,1,0,0,Commerce,Bachelors,31-35,1,0,0,Remote,Tier2_City,2,4,4,3,0,3,1,12.1,Manufacturing,3,4,3,3,5,5,3,3,1,1,0,1,1,5,27.33
Law,Music Teacher,2.734551836928343,4,2,0,0,5,1,0,2,1,3,4,0,3,1,Arts,Masters,31-35,2,0,0,Remote,Any,3,1,3,5,1,1,5,38.69,Manufacturing,2,2,4,4,2,5,2,4,2,1,0,1,5,4,41.5
Biology,Acoustics Specialist,4.944567652342556,0,1,2,1,6,0,1,3,1,2,0,4,4,0,Science,Bachelors,25-30,1,0,0,Hybrid,Tier1_City,1,2,3,5,2,3,3,17.73,Other,4,5,5,5,3,2,2,1,4,1,1,1,3,2,42.47
Biology,Architectural Technologist,3.632142966577288,6,1,0,0,8,0,2,2,1,3,1,0,4,1,Science,Masters,36-40,1,0,0,Hybrid,Tier3_City,1,4,1,2,2,2,3,34.81,Tech,2,2,3,1,5,5,1,2,2,1,0,0,1,4,35.05
Biology,Inorganic Chemist,2.5433858466676784,2,1,2,1,1,1,4,1,0,2,2,4,1,0,Science,Masters,25-30,9,0,0,Remote,Tier1_City,2,3,5,2,0,3,5,17.41,Other,1,4,4,5,3,1,4,1,5,1,0,1,3,3,61.83
Biology,Lawyer,2.9198983111287187,3,1,2,0,1,1,0,3,4,1,1,0,4,1,Science,Bachelors,25-30,10,1,46,Remote,Tier2_City,2,1,3,1,0,0,4,43.53,Other,4,3,2,1,5,0,3,4,2,4,1,1,1,5,47.53
Psychology,Marketing Specialist,2.746894940733005,9,2,2,0,3,1,1,2,3,4,0,0,4,0,Arts,Masters,18-24,6,0,0,Office,Tier3_City,5,4,0,3,1,3,5,19.31,Tech,5,5,4,5,1,2,3,3,3,1,1,0,2,5,49.6
Physics,Sound Engineer,3.848635106098444,6,1,1,0,7,0,3,2,0,1,2,1,2,1,Science,Bachelors,36-40,9,0,0,Remote,Any,2,4,4,1,3,3,2,42.9,Other,2,1,5,1,3,0,3,3,3,1,1,1,2,5,47.86
Medicine,Teacher,4.728139438346007,6,1,1,1,9,0,4,4,0,3,2,3,2,1,Science,Bachelors,18-24,14,1,25,Office,Tier2_City,1,4,0,1,0,0,2,39.01,Finance,3,4,4,3,4,5,4,4,1,3,1,0,1,1,58.66
Computer Science,Urban Planner,2.9190812924155467,0,1,0,1,5,1,2,2,1,2,2,1,4,1,Science,Masters,25-30,2,0,0,Hybrid,Tier3_City,5,4,3,3,4,0,1,12.23,Tech,3,2,3,1,0,0,2,2,3,3,0,0,1,3,43.36
Law,Zoologist,3.372683060767099,9,1,1,0,1,0,0,1,4,1,1,0,3,0,Arts,Masters,36-40,7,0,0,Office,Tier1_City,4,2,2,2,3,0,3,10.38,Other,1,4,2,4,3,3,3,5,2,3,0,0,1,5,51.67
Psychology,Advertising Manager,4.265166891411994,4,2,0,0,0,1,1,0,2,1,2,0,0,1,Arts,Masters,18-24,12,1,40,Remote,Tier2_City,1,1,4,3,0,5,4,39.64,Other,1,1,3,5,4,4,3,4,3,4,1,1,3,5,52.8
Physics,Cybersecurity Analyst,2.8515642051876284,8,1,4,1,2,0,2,2,1,1,4,0,4,0,Science,Bachelors,25-30,1,1,57,Remote,Tier2_City,3,3,4,4,4,4,5,21.34,Tech,1,2,2,2,4,2,4,4,1,1,0,0,4,3,33.99
Chemistry,Organic Chemist,3.889572966385913,6,0,1,1,9,1,3,1,3,3,2,1,1,1,Science,Bachelors,18-24,10,1,58,Office,Tier2_City,5,1,1,4,5,5,2,47.62,Education,1,5,2,3,2,2,5,3,5,4,1,1,5,1,65.12
Engineering,Industrial-Organizational Psychologist,4.802828160036775,3,1,1,0,6,1,0,3,4,3,3,0,1,1,Science,Bachelors,31-35,10,1,44,Flexible,Tier2_City,3,2,1,4,1,3,3,47.32,Other,5,2,5,5,4,3,4,4,1,4,1,1,3,5,60.39
Chemistry,Digital Marketing Specialist,3.905133948430296,4,2,0,1,7,0,4,0,1,4,3,0,2,0,Science,Masters,25-30,6,0,0,Remote,Any,2,1,4,5,4,5,3,35.59,Healthcare,4,2,1,3,2,0,4,4,1,2,1,0,2,5,54.36
Computer Science,Fluid Mechanics Engineer,3.545067497069127,9,0,4,0,7,0,1,4,0,1,3,3,4,0,Science,Bachelors,36-40,2,0,0,Remote,Tier1_City,4,2,4,2,0,5,4,26.53,Education,1,1,5,2,4,4,5,3,2,4,0,0,2,3,43.91
Chemistry,Legal Secretary,2.758817246100112,7,1,3,1,2,1,4,2,0,1,4,3,1,1,Science,Masters,36-40,8,1,40,Flexible,Tier1_City,2,2,5,2,2,0,4,12.16,Healthcare,2,2,1,2,1,4,1,3,2,2,0,0,1,3,53.62
Medicine,Chemist,4.010744534250351,3,0,4,0,8,0,0,0,2,3,0,0,1,0,Science,Bachelors,31-35,6,0,0,Remote,Any,1,2,0,5,0,0,4,44.47,Education,5,4,1,2,1,3,4,2,4,5,1,0,2,4,42.44
Marketing,Chemical Engineer,3.4874586052441514,4,2,3,1,7,0,2,1,1,2,4,1,4,0,Commerce,Bachelors,31-35,14,0,0,Remote,Tier2_City,4,2,3,1,2,1,4,6.85,Education,4,3,5,2,1,1,4,1,3,3,1,1,1,1,54.56
Physics,Inorganic Chemist,3.6606315426585407,0,1,1,1,2,0,1,0,3,0,3,1,2,0,Science,Bachelors,25-30,8,1,52,Flexible,Tier2_City,1,4,4,4,1,5,2,20.41,Finance,5,1,4,2,1,4,3,4,5,2,1,1,2,2,52.29
Chemistry,Mechanical Engineer,4.0567658358171785,2,1,4,1,8,1,2,1,4,0,1,2,1,1,Science,High School,25-30,1,1,33,Office,Tier1_City,4,1,5,4,1,4,4,18.0,Other,3,1,5,4,5,1,2,5,4,5,1,0,3,2,45.38
Biology,Advertising Manager,3.87553470938016,8,0,3,1,9,1,2,4,0,1,4,0,3,0,Science,Bachelors,31-35,5,0,0,Hybrid,Tier1_City,3,5,2,1,3,3,3,48.05,Healthcare,5,1,3,1,1,3,2,5,2,4,0,0,1,2,48.13
Music,Ecologist,4.446700542948105,2,2,3,0,4,1,3,0,4,1,1,0,2,0,Arts,Masters,36-40,4,1,21,Flexible,Tier1_City,1,2,3,3,3,2,3,8.55,Education,5,4,3,2,4,0,4,4,5,2,1,0,4,2,50.14
Finance,Curriculum Developer,2.78710459275384,4,0,4,0,1,1,0,2,1,1,1,3,3,1,Commerce,Masters,25-30,13,1,54,Hybrid,Tier1_City,1,2,4,3,2,4,5,44.84,Education,3,4,3,5,3,1,2,4,2,4,0,0,4,2,58.93
Physics,Accountant,4.626585795215443,3,2,4,1,9,1,3,0,2,2,1,4,1,1,Science,Bachelors,25-30,1,1,28,Remote,Tier2_City,2,1,5,2,2,4,3,24.45,Healthcare,3,4,3,5,3,2,3,3,3,2,0,1,5,1,44.77
Education,Forensic Psychologist,4.174893795770424,1,1,1,1,6,1,3,1,4,1,0,4,0,1,Arts,Bachelors,25-30,3,1,24,Office,Tier3_City,5,4,1,5,1,1,3,5.23,Finance,3,4,1,2,3,1,4,2,1,3,1,0,3,3,42.29
Music,Geneticist,4.519837650404384,2,0,4,0,9,1,1,3,3,2,1,2,3,0,Arts,High School,25-30,3,0,0,Hybrid,Any,1,3,1,2,4,3,2,37.26,Healthcare,5,2,1,3,1,0,4,2,5,4,1,1,3,3,50.43
Chemistry,Pharmacist,3.913307817384979,7,2,3,0,8,1,1,4,0,4,2,0,4,1,Science,Masters,18-24,7,1,6,Hybrid,Tier1_City,4,2,1,3,2,3,3,7.74,Finance,3,1,5,2,1,1,4,3,5,1,1,0,4,2,50.21
Engineering,Inorganic Chemist,3.291396778238208,1,2,4,1,4,0,0,0,1,1,2,4,1,0,Science,High School,25-30,12,0,0,Flexible,Tier1_City,2,4,2,1,2,0,1,14.14,Finance,1,1,2,4,4,3,3,5,4,1,0,0,1,1,45.27
Law,Architectural Technologist,4.358487098999646,3,1,2,0,9,1,2,2,3,4,0,2,4,1,Arts,PhD,25-30,6,1,51,Remote,Tier2_City,5,4,0,2,4,0,3,40.59,Manufacturing,2,5,2,1,5,1,2,1,5,2,0,0,4,4,59.16
Engineering,Clinical Psychologist,3.734021248413346,4,2,2,1,2,0,4,4,2,4,2,4,2,1,Science,Bachelors,25-30,12,1,31,Office,Tier1_City,1,5,3,4,3,4,5,10.27,Finance,2,3,1,5,3,5,4,5,5,3,1,0,2,4,76.26
Physics,Judge,3.231443186596658,4,1,3,1,2,1,1,4,3,4,1,3,0,0,Science,Bachelors,25-30,4,0,0,Hybrid,Tier3_City,3,2,0,4,3,1,5,18.3,Manufacturing,3,2,4,2,5,2,5,5,2,4,0,1,3,4,54.84
Physics,Principal,3.1762560706040213,7,1,3,1,8,0,3,1,4,4,4,0,3,0,Science,PhD,31-35,8,0,0,Remote,Tier2_City,2,4,0,1,2,3,4,19.97,Other,4,3,1,1,2,1,4,1,3,4,1,0,5,1,71.17
Art,Ecologist,3.5762951926495314,5,0,1,1,1,1,1,4,2,1,0,2,3,1,Arts,High School,36-40,0,0,0,Office,Any,3,5,0,3,3,1,2,30.67,Tech,5,2,4,1,1,3,2,1,4,2,0,1,5,5,36.36
Music,Landscape Architect,2.67671658636503,7,1,0,1,1,0,1,4,0,3,0,2,0,1,Arts,Masters,40+,3,1,25,Office,Tier1_City,4,4,1,4,3,2,5,40.13,Finance,2,2,2,2,0,1,1,2,2,3,0,1,3,4,41.96
Computer Science,Civil Engineer,2.6823176626051923,2,2,0,0,3,1,1,0,3,2,3,1,4,0,Science,Bachelors,25-30,4,1,47,Flexible,Tier1_City,2,5,3,4,5,3,1,13.85,Healthcare,1,2,1,1,0,4,1,1,4,5,1,0,5,3,53.0
Architecture,Nurse,4.392126817590766,5,0,2,0,0,0,1,3,4,4,2,3,3,0,Interdisciplinary,Bachelors,18-24,7,0,0,Flexible,Tier1_City,2,5,1,5,3,0,1,12.67,Manufacturing,4,1,5,5,0,0,1,3,4,4,0,0,4,2,67.58
Physics,Clinical Psychologist,3.532634023605539,7,1,2,1,4,0,4,4,0,3,4,1,1,1,Science,Bachelors,40+,2,0,0,Hybrid,Tier1_City,2,5,0,2,1,4,4,13.43,Tech,4,3,3,2,4,2,5,1,3,5,0,1,5,5,53.7
Art,Credit Analyst,3.510960603673197,9,2,3,0,7,0,1,0,3,2,3,4,3,1,Arts,Masters,31-35,13,1,33,Hybrid,Tier2_City,5,4,5,3,0,1,2,20.94,Other,1,3,2,3,2,0,1,5,3,4,1,1,2,2,65.41
Art,AI Researcher,4.376215860246983,9,0,0,1,4,1,2,3,0,2,0,4,3,1,Arts,Masters,25-30,11,0,0,Hybrid,Any,5,3,5,2,2,0,2,28.15,Tech,5,4,1,2,1,2,3,3,1,2,0,0,1,3,49.36
Marketing,Judge,2.5302009585285514,4,0,0,0,8,1,1,2,0,4,2,0,3,0,Commerce,High School,18-24,4,0,0,Hybrid,Tier1_City,1,1,4,3,2,4,3,3.63,Finance,5,3,1,5,4,0,3,1,2,3,1,0,5,2,39.77
Biology,Credit Analyst,2.791923102195865,3,0,4,0,2,1,1,2,0,2,4,4,1,0,Science,PhD,18-24,2,0,0,Remote,Tier1_City,3,5,2,4,1,0,1,39.67,Healthcare,3,4,3,2,3,5,1,2,3,1,1,0,5,1,45.96
Finance,Risk Analyst,4.431004945546922,5,1,4,1,2,0,2,1,1,3,1,2,3,0,Commerce,Bachelors,18-24,12,1,13,Hybrid,Tier1_City,1,2,5,5,0,3,1,46.56,Finance,1,5,2,2,3,2,1,2,4,2,1,1,2,1,51.69
Education,Art Therapist,4.489862208787856,6,0,0,1,4,0,4,4,1,4,4,1,1,0,Arts,Bachelors,18-24,6,1,37,Office,Tier2_City,3,1,5,2,0,1,1,42.65,Education,1,4,5,2,1,1,2,5,4,1,1,1,2,3,53.49
Psychology,Special Education Teacher,4.523446495968162,6,2,2,1,6,0,3,4,4,3,0,1,4,1,Arts,Bachelors,36-40,9,0,0,Hybrid,Tier2_City,1,3,5,4,1,2,1,4.75,Tech,1,2,5,4,5,0,3,4,4,5,0,1,2,4,67.01
Biology,Inorganic Chemist,3.298718750873213,9,2,2,1,0,0,0,0,1,4,4,3,2,0,Science,High School,25-30,2,0,0,Flexible,Tier3_City,2,1,2,3,4,5,5,27.65,Education,3,1,5,4,1,2,2,5,2,5,1,1,3,4,46.66
Physics,Web Developer,2.6089781625315003,2,1,0,1,0,0,2,2,2,1,1,4,3,0,Science,Bachelors,31-35,6,0,0,Remote,Tier3_City,2,1,5,2,4,0,2,41.26,Education,2,2,2,5,0,1,2,1,5,2,1,1,3,2,54.63
Finance,Industrial-Organizational Psychologist,4.676032349363313,7,2,0,0,9,0,4,0,4,3,3,1,4,0,Commerce,PhD,36-40,13,1,30,Hybrid,Tier2_City,3,3,0,2,0,5,3,19.17,Manufacturing,5,5,5,1,2,2,1,5,1,5,1,0,4,3,64.68
Marketing,Curriculum Developer,3.676034024941474,3,0,2,1,2,0,4,4,0,2,2,3,1,1,Commerce,Bachelors,31-35,1,0,0,Office,Tier2_City,2,2,1,4,4,1,5,45.16,Education,3,1,4,2,0,2,2,3,4,4,0,1,2,3,52.14
Engineering,Industrial-Organizational Psychologist,3.500043005409128,6,0,1,0,2,1,2,3,0,2,2,1,0,1,Science,Bachelors,36-40,6,0,0,Hybrid,Tier3_City,1,5,3,2,4,3,2,44.68,Tech,3,5,1,2,2,3,1,5,1,3,0,0,4,1,45.88
Art,Acoustics Specialist,2.812974831825013,2,0,3,0,9,0,1,3,4,3,1,3,0,0,Arts,Bachelors,40+,8,0,0,Remote,Tier1_City,5,4,1,5,4,0,4,9.66,Tech,3,2,4,4,4,3,1,2,5,2,1,1,4,4,60.69
Education,Counselor,2.5861558224536805,6,2,2,1,0,0,0,0,2,3,2,1,4,1,Arts,Masters,25-30,11,1,56,Hybrid,Tier1_City,4,2,3,5,0,3,1,26.2,Healthcare,1,1,2,3,4,0,4,3,1,5,0,0,2,4,51.63
Business,Brand Manager,3.5368749500358456,1,2,1,1,1,1,0,2,3,1,0,4,3,0,Commerce,Masters,40+,4,0,0,Remote,Tier1_City,1,2,4,4,4,2,3,4.21,Finance,3,5,5,4,5,1,3,2,2,5,0,1,5,5,50.74
Chemistry,Zoologist,2.67667379362445,3,0,4,0,9,1,4,1,2,4,3,4,2,1,Science,Bachelors,31-35,11,0,0,Office,Tier1_City,3,5,3,3,2,2,2,16.25,Healthcare,2,4,5,1,2,4,5,5,2,5,0,1,5,1,63.29
Engineering,Architectural Technologist,4.095523710115096,2,0,0,1,0,1,3,1,1,2,4,4,1,0,Science,High School,18-24,5,1,23,Flexible,Tier1_City,2,2,3,4,5,4,4,41.16,Healthcare,4,3,5,2,4,5,3,1,4,5,0,1,5,4,57.91
Engineering,Credit Analyst,4.919747935730706,6,1,2,1,0,1,1,0,4,0,2,3,2,0,Science,Bachelors,31-35,12,1,13,Remote,Tier1_City,4,2,4,5,0,4,1,48.83,Finance,3,2,3,2,2,2,5,5,1,1,1,0,1,4,42.26
Computer Science,Social Media Manager,3.3725752830172606,6,1,2,0,8,1,4,4,2,2,0,0,0,0,Science,Bachelors,31-35,9,0,0,Remote,Tier1_City,4,1,2,1,1,4,4,45.93,Tech,2,4,3,5,5,0,4,3,3,4,1,0,3,2,57.25
Law,Physical Chemist,4.49738323096861,5,1,0,1,3,1,4,0,2,0,3,1,4,0,Arts,Bachelors,36-40,10,0,0,Remote,Tier3_City,2,1,3,1,4,3,4,5.0,Manufacturing,1,5,5,3,5,3,4,2,5,4,0,0,4,4,64.52
Medicine,Illustrator,4.254698377653533,1,0,4,0,0,0,2,0,1,2,1,1,3,1,Science,Bachelors,25-30,2,0,0,Remote,Tier2_City,1,3,4,2,3,4,5,46.56,Education,4,5,1,5,5,1,3,5,2,5,1,0,4,2,43.98
Medicine,Physical Chemist,3.790595253107208,1,0,1,1,9,0,2,2,4,1,4,1,3,0,Science,Bachelors,25-30,12,0,0,Remote,Tier1_City,2,3,3,2,0,1,4,41.66,Manufacturing,5,1,3,3,4,3,4,1,2,1,1,1,1,4,50.37
Education,Chemist,4.563652037383863,5,0,2,1,1,1,0,4,4,1,4,1,2,1,Arts,Bachelors,18-24,9,0,0,Remote,Tier3_City,5,3,1,1,1,5,5,43.78,Education,5,4,2,3,5,2,4,1,5,5,1,1,2,2,64.88
Marketing,Entrepreneur,4.909280908017695,6,0,4,1,8,1,2,2,3,0,4,4,1,1,Commerce,Bachelors,25-30,4,0,0,Hybrid,Tier2_City,3,4,4,5,5,5,5,46.0,Finance,1,5,5,3,3,3,1,4,3,3,1,0,1,1,55.15
Business,Musician,4.268830511306071,8,1,0,0,5,0,1,3,1,3,2,2,3,1,Commerce,PhD,18-24,12,0,0,Hybrid,Tier1_City,2,5,0,2,2,3,4,25.94,Finance,1,1,1,3,1,5,4,1,3,4,1,0,2,2,67.93
Finance,Special Education Teacher,3.927440488773216,9,0,2,0,4,1,4,4,1,0,4,4,1,1,Commerce,PhD,25-30,14,1,40,Hybrid,Any,1,4,5,4,1,3,2,12.93,Healthcare,5,3,3,5,4,3,2,5,4,2,0,1,5,4,72.7
Architecture,Financial Controller,3.0063735093288075,9,1,0,0,7,0,3,0,0,1,2,4,1,1,Interdisciplinary,Masters,36-40,4,0,0,Hybrid,Tier1_City,5,4,3,4,4,4,4,3.99,Other,1,3,2,2,4,5,4,1,5,3,0,1,4,1,52.89
Medicine,Analytical Chemist,3.243758477246897,2,1,0,0,9,1,0,0,0,2,4,0,0,0,Science,Bachelors,18-24,2,0,0,Office,Tier3_City,5,3,3,5,3,5,4,4.11,Other,5,1,3,2,3,1,5,1,3,1,0,0,2,3,30.72
Law,Human Resources Specialist,4.608225400374822,4,1,2,0,1,0,1,4,1,1,4,3,0,0,Arts,Bachelors,25-30,7,0,0,Flexible,Any,1,5,1,2,4,5,2,33.2,Finance,1,4,2,5,0,5,3,3,3,2,1,0,1,4,59.06
Medicine,Architectural Technologist,3.2670044055305603,6,1,2,0,8,1,0,1,2,0,2,0,1,1,Science,Bachelors,18-24,5,0,0,Hybrid,Tier3_City,3,4,1,4,1,4,1,18.85,Education,5,1,5,4,3,0,5,1,2,3,0,0,3,4,40.18
Chemistry,Data Scientist,4.248239801147873,5,1,3,0,3,0,3,3,3,2,0,0,3,0,Science,Masters,18-24,12,0,0,Remote,Tier2_City,4,1,0,2,0,3,3,26.31,Other,2,1,1,1,4,2,1,5,1,5,1,0,2,5,58.35
Chemistry,Ecologist,4.502554398892764,7,0,4,0,0,1,2,3,4,2,1,0,1,0,Science,Bachelors,25-30,2,1,27,Remote,Any,5,4,4,2,3,2,1,9.17,Manufacturing,1,4,4,3,3,2,4,1,5,5,0,0,4,5,56.73
Biology,Psychologist,4.352046015890168,4,2,0,0,5,1,3,3,1,2,1,3,2,1,Science,Masters,18-24,0,0,0,Remote,Tier1_City,1,1,5,4,3,2,4,48.85,Manufacturing,5,3,3,5,3,5,2,2,5,4,0,0,4,1,57.2
Finance,Interior Designer,2.690834759663783,9,1,1,0,9,0,3,0,4,2,2,0,3,1,Commerce,PhD,25-30,9,1,51,Hybrid,Tier1_City,5,4,0,1,1,4,1,9.11,Manufacturing,1,5,1,3,5,1,1,4,2,2,0,1,4,3,57.97
Chemistry,Data Scientist,3.966405884955965,9,2,3,1,1,1,3,4,3,3,4,2,4,0,Science,Bachelors,18-24,0,0,0,Hybrid,Tier2_City,4,5,0,4,5,2,3,23.91,Other,5,3,4,3,3,5,3,4,4,2,0,0,3,2,56.76
Marketing,Music Therapist,3.104885490895133,8,2,1,1,1,1,3,4,2,1,1,0,3,1,Commerce,Masters,18-24,12,0,0,Hybrid,Any,1,1,2,5,5,1,1,23.84,Manufacturing,5,4,5,3,2,5,4,3,2,1,0,0,3,5,57.11
Law,Industrial-Organizational Psychologist,4.639951583141737,1,2,3,0,4,0,4,2,3,3,1,4,1,0,Arts,Bachelors,25-30,10,0,0,Remote,Tier2_City,5,1,5,3,4,1,3,3.41,Healthcare,4,2,2,5,3,0,3,5,4,4,1,1,5,3,73.59
Music,Software Developer,4.247837830067987,4,1,4,1,0,1,2,1,2,0,3,1,1,1,Arts,Bachelors,25-30,9,0,0,Office,Any,1,3,0,4,1,1,1,34.39,Other,1,4,5,2,3,1,1,5,1,5,1,1,5,3,51.4
Medicine,Conductor,3.254528214018209,9,0,2,0,2,0,4,4,2,0,3,2,1,1,Science,Bachelors,18-24,11,1,44,Remote,Tier1_City,1,1,3,2,3,3,5,28.3,Manufacturing,2,3,1,4,4,5,2,3,2,2,0,0,3,1,59.74
Architecture,Counselor,3.326941830147404,4,0,0,0,4,1,2,4,0,2,1,2,1,0,Interdisciplinary,Bachelors,25-30,1,1,52,Remote,Tier3_City,4,4,0,2,1,3,4,26.38,Education,3,3,1,4,2,1,3,4,5,2,0,0,5,2,42.84
Business,Web Developer,3.583308608126872,0,2,4,0,7,1,3,3,2,4,4,3,2,0,Commerce,Masters,36-40,9,0,0,Office,Any,1,4,5,4,3,3,3,41.45,Healthcare,3,4,3,5,0,5,4,2,3,4,0,1,4,1,75.17
Architecture,Curriculum Developer,4.127902504132747,8,1,4,0,3,1,4,1,1,3,2,1,4,1,Interdisciplinary,Bachelors,31-35,4,0,0,Remote,Tier2_City,3,3,1,3,4,3,4,14.33,Healthcare,1,4,4,1,2,3,5,4,1,2,0,0,1,3,44.61
Marketing,Architect,3.735115128228303,8,2,4,1,0,0,3,1,1,4,1,4,2,1,Commerce,Bachelors,18-24,6,0,0,Office,Any,5,2,1,4,0,3,5,43.47,Other,5,4,4,4,2,0,5,4,2,2,1,0,3,2,47.8
Computer Science,Psychologist,4.303133455528579,4,1,1,0,9,1,3,2,3,1,3,4,2,1,Science,Masters,25-30,0,1,23,Flexible,Tier1_City,2,1,5,3,0,4,1,43.64,Healthcare,5,3,3,4,2,5,3,2,5,3,1,0,5,4,54.25
Marketing,Marketing Specialist,4.917684376237891,0,0,3,1,6,0,0,1,1,3,2,0,1,1,Commerce,Masters,31-35,0,0,0,Office,Any,3,1,3,3,1,2,4,41.86,Finance,2,1,5,3,4,2,2,4,5,2,0,0,2,5,41.36
Psychology,Brand Manager,2.890535772852373,5,1,1,1,1,1,3,3,4,0,4,3,0,0,Arts,Bachelors,18-24,3,0,0,Remote,Any,3,1,2,5,3,4,1,19.05,Healthcare,1,2,4,5,5,5,1,1,5,1,0,0,3,2,56.57
Engineering,Surgeon,3.8422201369674993,0,1,3,1,4,1,1,1,1,0,3,1,2,0,Science,Masters,36-40,12,0,0,Hybrid,Tier1_City,1,4,0,2,0,2,1,10.64,Education,3,1,5,2,1,4,4,5,3,4,0,1,1,5,55.58
Biology,Counselor,4.804723358333931,5,0,4,1,2,0,1,0,3,1,3,1,2,0,Science,Masters,36-40,9,0,0,Hybrid,Tier2_City,3,5,4,2,3,4,4,25.33,Other,2,3,2,5,4,5,3,4,5,4,0,0,3,4,65.16
Architecture,Legal Secretary,3.395878909640608,8,0,2,1,0,0,0,1,3,0,1,2,1,1,Interdisciplinary,Bachelors,36-40,14,0,0,Flexible,Tier2_City,3,5,1,3,4,1,3,15.21,Other,1,1,1,5,4,2,4,2,3,1,1,1,5,1,49.09
Engineering,Quantum Physicist,3.169742803371336,4,1,1,0,9,1,0,1,1,4,1,1,2,0,Science,Bachelors,36-40,5,0,0,Flexible,Tier1_City,3,5,3,2,1,0,3,5.45,Manufacturing,1,4,2,4,0,1,2,5,2,3,0,1,3,1,40.24
Law,Brand Manager,2.773506302626096,2,1,1,0,0,1,0,2,0,3,4,2,2,1,Arts,Bachelors,31-35,8,0,0,Remote,Tier1_City,1,3,4,1,3,3,4,16.14,Finance,1,5,3,3,5,4,5,5,4,3,0,0,2,3,55.19
Biology,Digital Marketing Specialist,2.8769869778993726,1,0,3,1,3,1,4,1,0,4,4,3,1,0,Science,Masters,31-35,0,0,0,Flexible,Tier1_City,3,3,5,3,1,0,3,25.05,Manufacturing,4,4,4,5,0,1,1,4,1,5,0,0,2,1,51.51
Chemistry,Mechanical Engineer,3.795691911744447,8,2,2,0,2,1,4,4,2,0,0,3,1,0,Science,Masters,31-35,10,0,0,Remote,Tier2_City,2,4,0,2,3,0,2,8.3,Tech,2,2,2,2,0,4,5,4,1,2,1,1,2,2,57.65
Physics,Marketing Specialist,3.338316382330709,7,1,3,0,2,0,3,0,4,4,2,0,2,1,Science,Masters,36-40,9,0,0,Hybrid,Tier2_City,3,5,0,1,5,1,1,47.38,Finance,1,4,1,3,1,5,1,4,2,1,0,1,4,5,61.64
Law,Ecologist,4.330156428188029,7,1,2,0,6,0,3,2,1,3,2,3,4,0,Arts,Bachelors,31-35,4,0,0,Hybrid,Any,1,2,0,5,5,0,4,33.84,Education,2,5,4,3,2,5,5,3,2,4,0,0,4,2,55.43
Music,Principal,3.211967101323544,3,2,2,1,0,0,4,0,0,4,4,0,1,0,Arts,Bachelors,25-30,8,0,0,Remote,Tier1_City,1,1,4,2,3,0,5,9.41,Finance,3,3,5,2,1,3,3,5,5,3,1,1,1,5,56.57
Engineering,Microbiologist,2.583149468877368,7,0,3,1,4,1,4,1,2,1,1,4,2,1,Science,High School,25-30,7,0,0,Flexible,Tier2_City,4,5,0,1,4,1,4,41.17,Healthcare,1,1,4,2,2,1,2,3,5,1,1,1,2,4,50.39
Education,Nuclear Physicist,3.513434882673776,0,0,3,0,9,1,0,0,0,1,1,3,0,1,Arts,Bachelors,36-40,6,0,0,Hybrid,Tier1_City,4,2,2,4,1,2,4,46.62,Finance,5,4,1,2,1,4,5,4,2,5,0,1,5,5,40.25
Engineering,Chemist,2.5861201736647126,1,2,0,1,1,0,2,4,4,2,2,2,3,1,Science,Masters,18-24,12,0,0,Office,Tier2_City,2,1,4,4,2,4,1,15.35,Healthcare,1,1,4,5,5,2,2,2,1,5,1,0,4,3,70.88
Business,Music Therapist,4.748094943329452,2,2,4,0,2,1,4,3,0,1,3,3,2,1,Commerce,Masters,31-35,9,0,0,Flexible,Any,5,1,1,1,3,5,5,9.73,Manufacturing,1,2,2,3,4,3,5,4,2,2,1,0,5,1,58.95
Physics,Market Research Analyst,2.935439889924397,4,0,3,1,7,0,1,3,2,3,1,1,3,0,Science,Bachelors,40+,1,0,0,Office,Tier1_City,4,3,5,3,3,0,1,18.16,Finance,2,1,3,3,4,1,4,4,5,3,0,1,4,2,45.34
Psychology,Risk Analyst,2.8992311692708217,9,2,0,1,5,0,4,2,4,1,1,4,0,1,Arts,Bachelors,31-35,8,0,0,Hybrid,Tier1_City,3,2,2,3,5,3,3,42.12,Finance,2,2,2,1,2,0,5,1,2,5,1,0,5,2,64.9
Law,Software Developer,2.53800007563245,5,1,1,1,7,0,0,1,3,4,1,2,0,0,Arts,Bachelors,40+,11,0,0,Office,Tier2_City,1,5,3,2,0,1,4,11.23,Education,4,2,4,1,2,5,1,1,5,2,1,1,4,1,54.35
Education,Special Education Teacher,4.827778399429247,9,2,0,0,6,0,3,0,3,4,4,3,3,0,Arts,Bachelors,31-35,12,1,40,Hybrid,Tier1_City,4,5,0,4,5,0,1,39.63,Tech,1,4,5,1,2,5,4,5,1,3,0,0,3,4,59.76
Education,AI Researcher,4.372002425147654,6,2,0,0,3,0,4,0,2,1,2,2,2,0,Arts,Bachelors,18-24,7,0,0,Office,Tier2_City,1,4,3,3,1,5,2,36.66,Finance,3,5,4,5,3,3,3,5,4,5,0,1,4,5,57.07
Chemistry,Human Resources Specialist,3.239213375934713,3,1,0,0,0,0,0,1,2,1,2,4,1,1,Science,Bachelors,36-40,12,1,31,Remote,Tier1_City,3,2,1,3,5,2,4,33.61,Manufacturing,2,1,1,5,0,4,3,5,1,4,1,1,5,2,56.71
Psychology,Conductor,3.184871047487883,0,0,2,1,2,0,3,2,0,0,4,0,4,1,Arts,Bachelors,25-30,10,1,53,Hybrid,Tier1_City,1,1,3,4,2,2,3,23.37,Healthcare,4,2,2,2,3,5,3,3,3,4,0,1,4,3,56.81
Chemistry,Architectural Technologist,3.4219436042731366,0,2,1,1,2,1,1,3,2,1,3,3,2,0,Science,Bachelors,25-30,14,0,0,Office,Tier2_City,1,3,1,5,4,5,1,20.24,Manufacturing,5,2,2,5,3,0,2,5,5,1,1,0,5,2,60.93
Chemistry,Acoustics Specialist,3.0496074222661176,4,2,1,0,0,0,1,0,0,2,2,2,0,1,Science,Bachelors,25-30,9,1,33,Office,Any,4,4,3,3,2,3,1,7.01,Other,5,2,4,3,4,0,3,1,2,4,0,0,1,1,48.8
Medicine,Psychologist,4.436859322966953,1,1,0,0,3,0,3,1,0,1,1,0,2,0,Science,High School,25-30,9,0,0,Flexible,Tier2_City,1,3,1,1,4,0,2,19.8,Other,4,3,3,3,5,5,5,5,2,4,1,1,4,3,44.99
Biology,Social Media Manager,3.732442802546022,0,0,4,1,0,1,1,2,4,3,4,0,3,0,Science,Masters,25-30,8,0,0,Remote,Tier1_City,3,1,4,2,2,3,3,31.29,Education,5,1,4,4,4,5,4,4,5,3,0,1,4,4,63.64
Engineering,Human Resources Specialist,4.026483071559845,5,0,4,1,1,1,3,1,3,2,3,4,2,0,Science,Bachelors,25-30,8,0,0,Hybrid,Tier1_City,2,1,4,3,5,2,2,45.22,Other,1,1,3,4,2,0,1,1,3,2,1,0,2,2,62.07
Medicine,Dentist,3.3414639347400903,9,1,0,1,7,1,4,1,4,4,4,1,3,1,Science,PhD,31-35,8,0,0,Hybrid,Any,1,3,5,3,2,2,4,42.16,Finance,2,2,4,5,4,4,3,3,5,4,1,0,4,5,80.31
Physics,Architectural Technologist,3.755540713456489,2,1,3,0,2,0,0,1,4,1,3,2,4,0,Science,Bachelors,36-40,2,0,0,Hybrid,Any,1,4,5,5,5,4,5,4.51,Tech,3,1,2,4,2,3,1,3,2,3,0,0,2,3,48.36
Architecture,Biologist,4.0416597353067125,2,1,4,0,1,0,1,4,4,4,2,4,1,0,Interdisciplinary,Bachelors,25-30,6,0,0,Hybrid,Tier1_City,3,1,3,1,5,2,1,9.53,Tech,5,1,3,5,5,0,2,5,4,4,1,0,1,2,67.89
Education,Analytical Chemist,3.0951608454090587,9,0,2,1,0,0,2,2,2,2,4,4,1,0,Arts,Bachelors,18-24,11,0,0,Remote,Any,5,5,2,2,1,1,2,42.88,Finance,1,3,1,2,5,5,2,3,3,5,1,1,1,5,65.38
Art,Urban Planner,3.2762900051845425,3,1,0,0,9,0,4,2,1,0,4,0,1,0,Arts,High School,31-35,0,0,0,Office,Any,3,5,2,3,5,4,1,47.15,Tech,2,2,3,2,3,0,1,3,2,3,1,1,2,3,40.81
Finance,Financial Advisor,2.7272590981799945,0,1,1,0,3,0,2,0,1,2,2,4,1,1,Commerce,Masters,31-35,8,0,0,Flexible,Tier1_City,4,5,4,2,0,3,1,5.62,Manufacturing,1,1,5,4,0,5,5,1,1,2,0,1,2,5,49.69
Art,Legal Analyst,4.9892249930498895,3,1,0,0,6,0,2,1,1,4,1,0,2,1,Arts,High School,36-40,13,0,0,Remote,Tier3_City,4,4,0,4,2,2,2,35.96,Healthcare,1,5,1,5,4,4,1,5,3,1,0,0,1,3,49.11
Law,Financial Advisor,3.2188148884977146,1,2,4,1,4,0,4,0,0,2,4,0,3,0,Arts,PhD,18-24,14,1,36,Remote,Tier2_City,2,4,0,3,3,5,1,20.19,Finance,2,2,4,4,3,1,4,5,5,2,0,1,4,5,67.39
Education,Clinical Psychologist,4.629070608125069,4,2,2,0,7,0,2,4,3,0,2,2,4,0,Arts,Masters,36-40,8,0,0,Remote,Tier1_City,1,2,2,3,3,1,3,20.12,Other,5,1,5,3,5,1,3,4,1,1,0,0,4,5,53.08
Education,Zoologist,3.2108345417031923,7,2,2,0,0,0,3,3,0,2,0,4,1,1,Arts,Bachelors,25-30,2,0,0,Hybrid,Tier1_City,2,2,3,4,3,4,3,33.21,Healthcare,5,3,1,5,2,5,5,5,4,4,1,1,5,2,52.06
Finance,AI Researcher,4.160508894332207,4,0,1,0,8,0,0,3,0,3,3,2,4,0,Commerce,Bachelors,31-35,4,0,0,Office,Tier1_City,2,5,2,5,0,1,5,41.08,Tech,1,5,4,1,4,3,1,5,4,3,0,0,4,3,45.0
Marketing,Doctor,2.78263452909875,7,0,4,0,3,0,0,1,0,3,2,1,4,1,Commerce,Masters,18-24,11,1,22,Remote,Any,1,3,5,3,5,4,3,15.92,Education,4,4,3,3,5,5,4,1,5,2,1,1,5,4,57.88
Music,Credit Analyst,3.361321176183155,4,0,2,0,7,0,4,2,0,0,3,3,3,0,Arts,Bachelors,25-30,12,0,0,Hybrid,Tier3_City,1,3,4,2,2,4,2,36.15,Healthcare,5,4,4,5,0,5,1,4,5,5,0,1,2,5,68.3
Psychology,Cybersecurity Analyst,4.612539904979766,5,1,1,1,6,0,4,3,0,2,2,1,2,0,Arts,Masters,18-24,7,1,17,Remote,Tier1_City,3,5,3,1,4,4,3,32.89,Education,1,5,2,4,4,0,3,4,1,2,0,1,2,2,54.43
Marketing,Risk Analyst,2.612885700774882,3,2,0,0,3,0,4,0,1,1,1,0,0,1,Commerce,High School,25-30,5,0,0,Flexible,Tier2_City,2,2,4,2,4,5,5,27.31,Manufacturing,3,4,1,4,2,2,2,5,2,1,0,1,3,2,34.44
Law,Chemist,2.6459573168335067,6,2,4,0,4,0,0,3,1,2,4,3,4,0,Arts,Bachelors,25-30,9,0,0,Flexible,Tier2_City,2,4,2,5,1,3,4,31.31,Education,3,5,3,4,3,1,1,2,3,4,0,0,4,3,57.16
Marketing,Mechanical Engineer,4.678433270273974,1,1,3,1,1,0,3,4,1,4,2,3,2,1,Commerce,Bachelors,36-40,9,1,53,Flexible,Tier2_City,4,3,2,1,0,4,4,3.85,Healthcare,4,1,4,5,5,0,4,4,3,3,1,1,5,2,64.12
Art,Investment Banker,3.030993299379612,8,2,0,1,2,1,0,0,1,2,0,1,0,1,Arts,Bachelors,31-35,8,1,39,Remote,Tier3_City,2,4,4,2,2,4,2,3.19,Healthcare,1,4,3,4,3,3,1,5,1,4,0,1,1,1,39.36
Chemistry,Physical Chemist,2.647121185957112,5,0,1,0,2,0,2,3,3,4,0,1,0,0,Science,Masters,25-30,13,0,0,Hybrid,Tier2_City,3,5,3,2,5,1,5,28.87,Finance,3,4,3,5,0,2,3,5,5,5,0,0,2,5,75.41
Computer Science,Biotechnologist,2.663018639808294,4,0,0,1,3,1,2,3,2,2,3,0,4,0,Science,Bachelors,25-30,12,0,0,Remote,Tier1_City,5,4,3,4,3,4,3,27.63,Other,5,5,1,5,0,1,4,1,5,1,0,1,4,3,57.74
Engineering,Organic Chemist,4.026511982713908,1,0,1,1,6,1,1,3,0,3,0,0,1,1,Science,Masters,25-30,2,1,14,Hybrid,Tier1_City,2,3,1,5,0,3,5,6.35,Education,1,1,3,4,3,1,2,4,2,1,1,0,4,1,35.36
Music,Investment Banker,3.5832725284864573,0,0,0,1,0,0,4,2,3,2,0,4,2,0,Arts,Bachelors,40+,11,0,0,Remote,Tier2_City,3,2,4,4,0,5,1,26.13,Manufacturing,4,1,1,2,1,5,3,4,4,1,1,0,3,5,56.72
Music,Nurse,4.6496267200193095,5,2,3,1,1,1,4,1,2,4,0,0,4,0,Arts,Bachelors,25-30,6,0,0,Office,Tier2_City,3,3,2,1,2,5,5,38.6,Finance,4,2,3,2,3,5,1,2,4,4,1,0,4,3,52.78
Architecture,Interior Designer,4.536929356989271,3,0,4,0,1,1,0,0,4,1,1,3,4,1,Interdisciplinary,Bachelors,25-30,12,0,0,Hybrid,Tier2_City,5,1,4,4,5,1,3,28.44,Finance,5,2,3,3,2,0,5,5,1,5,1,1,2,3,57.28
Music,Aerospace Engineer,4.226714821084505,1,2,2,0,7,1,2,2,1,0,0,4,2,1,Arts,Bachelors,18-24,5,0,0,Hybrid,Tier2_City,3,4,4,5,1,4,2,27.33,Manufacturing,3,1,4,5,4,0,1,4,1,2,0,0,3,4,41.08
Art,Physicist,2.5289707041987866,5,1,0,0,1,1,3,0,3,0,2,3,4,1,Arts,Bachelors,31-35,13,1,24,Office,Tier3_City,4,4,0,3,5,1,1,36.74,Finance,3,5,5,4,1,2,2,3,4,1,1,0,2,2,57.06
Biology,Civil Engineer,3.6638358283633377,9,0,3,0,5,0,0,2,0,1,4,0,1,0,Science,Bachelors,25-30,14,0,0,Hybrid,Tier2_City,5,4,1,3,1,5,5,11.08,Manufacturing,4,3,1,4,3,4,1,4,2,1,1,1,3,3,46.77
Medicine,Physician Assistant,3.7019755721097054,8,0,0,1,7,0,3,4,2,0,4,2,3,1,Science,Masters,18-24,4,1,22,Remote,Any,4,5,3,1,1,3,4,24.5,Tech,2,3,2,4,4,5,5,5,2,1,0,1,4,2,53.22
Marketing,Ecologist,3.9128542415485352,6,2,2,0,7,1,2,1,0,0,0,4,3,0,Commerce,Bachelors,36-40,3,0,0,Hybrid,Tier1_City,2,5,0,3,3,1,3,9.96,Finance,4,2,1,2,5,3,2,3,1,1,0,0,5,1,28.86
Architecture,Pharmacist,3.291653879989427,9,1,0,1,8,0,2,2,3,1,0,0,2,1,Interdisciplinary,Bachelors,31-35,4,0,0,Flexible,Any,2,3,1,4,3,3,2,27.62,Healthcare,4,4,3,1,0,0,2,2,3,5,0,0,1,2,44.55
Biology,Architect,4.098252883807871,9,1,1,0,1,0,2,2,2,2,0,1,0,0,Science,Masters,31-35,12,0,0,Hybrid,Tier1_City,3,2,0,1,2,2,3,30.82,Tech,1,3,5,5,5,0,1,3,3,3,1,0,3,4,57.42
Business,Paralegal,3.850362942313752,9,0,2,0,5,0,0,1,1,2,1,1,1,1,Commerce,Masters,18-24,3,1,20,Hybrid,Tier2_City,3,1,1,5,5,4,5,8.72,Finance,5,4,1,3,3,1,3,1,4,1,0,0,5,1,43.79
Art,Legal Secretary,4.59827167479828,0,2,1,1,6,0,4,2,2,4,0,1,1,1,Arts,Bachelors,25-30,2,1,24,Flexible,Tier2_City,5,2,1,1,1,3,2,6.55,Manufacturing,1,4,3,3,1,2,2,3,5,3,1,1,5,4,48.25
Art,Industrial-Organizational Psychologist,3.4383721427984497,6,2,0,0,2,0,0,4,2,1,0,2,3,0,Arts,Bachelors,36-40,6,1,52,Hybrid,Tier1_City,2,2,5,1,2,4,4,10.84,Tech,4,1,2,3,2,5,4,3,5,4,0,0,4,4,52.6
Business,Brand Manager,4.139970922416582,1,2,0,1,3,1,4,0,0,2,3,0,2,0,Commerce,Masters,36-40,5,0,0,Flexible,Any,1,1,4,2,1,3,1,30.56,Other,1,3,4,5,4,4,2,3,3,4,0,1,2,1,53.86
Law,Judge,3.831357806626199,4,0,4,1,0,1,1,1,0,0,4,3,4,0,Arts,Masters,25-30,3,1,31,Remote,Tier1_City,3,5,1,2,0,0,5,11.91,Tech,3,3,4,5,5,4,4,5,2,2,0,0,3,4,42.48
Chemistry,Animator,4.907336529679254,2,2,2,0,4,1,4,4,1,4,3,0,4,0,Science,Bachelors,18-24,8,1,49,Hybrid,Tier2_City,5,4,2,1,4,0,2,15.94,Healthcare,4,4,1,3,4,3,3,2,4,1,1,0,1,5,60.56
Art,Financial Controller,4.39051616797401,0,0,2,1,6,0,0,1,4,4,1,2,2,0,Arts,Bachelors,25-30,0,0,0,Remote,Tier3_City,3,5,2,3,4,0,1,36.02,Finance,3,4,1,3,3,3,5,3,1,4,1,1,5,2,39.95
Finance,Web Developer,2.659146588332308,0,0,1,0,6,1,0,0,1,4,1,1,0,1,Commerce,Masters,25-30,0,0,0,Hybrid,Tier1_City,5,4,2,2,1,3,2,14.67,Finance,3,1,2,4,2,0,4,1,5,5,1,0,4,1,43.75
Computer Science,Organic Chemist,4.343932907060603,4,1,3,1,5,1,0,3,4,3,1,0,1,1,Science,High School,31-35,8,0,0,Remote,Any,2,4,2,5,2,5,5,21.68,Manufacturing,5,5,4,1,2,2,4,4,3,5,1,0,2,4,49.6
Art,Marketing Manager,4.371014254681816,0,1,3,0,7,0,3,3,2,2,2,0,4,0,Arts,PhD,40+,6,0,0,Remote,Tier2_City,3,5,0,4,3,5,2,46.66,Tech,3,3,3,2,0,1,5,3,5,3,0,0,4,1,62.85
Psychology,School Counselor,3.5443169184489243,7,0,4,1,2,0,0,4,2,4,2,2,4,0,Arts,Bachelors,25-30,1,1,15,Remote,Any,3,2,3,2,5,4,4,41.77,Healthcare,1,3,1,5,3,3,2,4,2,5,0,1,5,4,52.37
Biology,Art Therapist,4.738473860713138,3,0,2,0,9,0,3,1,2,3,4,2,3,1,Science,Masters,18-24,10,0,0,Hybrid,Tier2_City,1,4,3,1,1,0,2,15.01,Manufacturing,1,1,5,1,5,4,4,4,2,1,1,0,4,2,54.79
Architecture,Biomedical Engineer,3.879179880714289,7,0,3,1,1,1,1,0,2,3,3,0,3,1,Interdisciplinary,Bachelors,36-40,9,0,0,Remote,Tier2_City,2,5,5,3,1,4,5,31.09,Other,2,1,4,3,4,0,4,4,5,4,0,1,1,3,57.95
Marketing,Education Administrator,3.2085744763584363,9,0,3,1,3,1,4,4,0,0,0,1,1,1,Commerce,Bachelors,18-24,4,0,0,Office,Tier1_City,5,2,1,4,5,3,2,34.29,Manufacturing,5,5,3,3,0,5,5,3,2,4,0,0,4,2,44.0
Education,Organic Chemist,3.706182456361223,2,0,0,0,1,1,2,3,4,2,4,2,4,1,Arts,Masters,40+,12,0,0,Remote,Tier3_City,1,1,3,2,3,4,1,45.31,Healthcare,2,4,4,3,4,0,2,5,1,4,1,0,5,4,70.59
Engineering,Conductor,2.7615686121867027,1,0,2,1,0,0,0,1,4,2,2,2,0,0,Science,Bachelors,31-35,3,1,6,Hybrid,Tier1_City,5,4,0,3,1,4,1,28.73,Finance,3,3,2,3,5,1,1,3,1,1,0,0,1,4,38.0
Physics,Biomedical Engineer,3.988097375670201,7,2,4,0,8,1,2,0,1,3,0,4,0,1,Science,Bachelors,36-40,0,0,0,Remote,Tier2_City,3,2,2,3,0,0,3,29.38,Healthcare,4,4,5,4,0,5,4,3,3,2,0,0,4,4,37.66
Business,Aerospace Engineer,3.901000154075901,6,0,1,1,7,1,3,3,3,1,1,2,1,0,Commerce,High School,18-24,11,0,0,Remote,Tier1_City,4,4,2,3,3,5,3,44.76,Finance,1,3,3,5,5,2,3,5,4,3,0,1,1,1,59.7
Education,Fluid Mechanics Engineer,3.188047761050929,7,1,0,1,5,1,0,0,2,0,4,2,2,1,Arts,High School,18-24,12,1,58,Flexible,Tier1_City,3,2,2,1,0,1,4,5.56,Education,4,1,3,3,3,4,5,2,2,5,0,1,3,1,50.97
Marketing,Industrial-Organizational Psychologist,3.5067527789209656,6,1,1,1,3,0,2,0,0,3,2,2,0,0,Commerce,Bachelors,25-30,8,1,26,Office,Tier1_City,2,1,3,5,4,2,1,32.52,Tech,2,1,1,3,5,5,4,5,4,3,1,1,1,1,56.32
Education,Architect,3.3150885965399413,6,0,4,1,6,1,2,0,4,1,2,1,0,1,Arts,Masters,25-30,14,0,0,Office,Any,5,4,3,3,5,3,3,22.58,Healthcare,2,1,2,5,0,5,2,3,5,3,1,0,1,3,67.93
Law,Landscape Architect,2.928025055134416,6,1,3,0,6,1,0,2,2,2,1,4,4,1,Arts,Bachelors,25-30,5,0,0,Hybrid,Tier2_City,1,5,4,4,3,3,2,45.76,Other,1,5,2,2,0,5,3,3,3,4,0,0,1,4,51.02
Music,Marketing Manager,3.775758677059466,5,0,4,0,2,0,2,2,2,3,1,2,4,1,Arts,Bachelors,40+,10,0,0,Remote,Tier2_City,3,2,4,2,3,3,4,48.15,Other,2,3,3,4,2,0,1,5,2,5,1,1,4,5,61.61
Education,Nurse,4.0722846133997885,7,2,4,0,4,1,4,3,0,3,3,0,0,1,Arts,Bachelors,36-40,12,1,22,Remote,Any,5,1,3,4,2,2,5,11.0,Manufacturing,4,1,4,4,5,5,3,1,1,3,1,1,4,1,53.88
Finance,Biochemist,2.942906753390888,1,2,3,1,7,0,4,1,4,4,2,0,2,0,Commerce,Masters,31-35,13,1,20,Hybrid,Tier3_City,1,4,5,1,2,1,3,16.23,Finance,2,5,3,1,2,0,4,5,5,4,1,0,2,1,69.59
Physics,Forensic Psychologist,4.395313342442768,0,0,1,1,1,1,0,2,2,2,4,4,0,1,Science,Masters,18-24,11,0,0,Office,Tier1_City,3,1,5,1,5,5,3,15.85,Tech,4,4,3,4,5,3,3,4,1,1,1,0,1,4,60.55
Psychology,Inorganic Chemist,4.206978136546663,3,2,1,1,5,0,2,0,0,3,1,3,4,1,Arts,Bachelors,31-35,5,0,0,Flexible,Tier2_City,4,1,5,4,3,4,1,7.73,Other,3,5,3,1,4,4,1,5,5,4,1,0,1,3,47.44
Finance,School Counselor,2.5965815086643222,1,2,2,1,7,0,2,4,4,4,4,1,0,0,Commerce,Bachelors,31-35,3,0,0,Remote,Any,4,4,2,5,4,5,4,25.7,Tech,5,5,3,2,2,1,2,1,1,4,0,0,3,5,54.85
Music,Architect,3.002749532880573,2,1,4,0,2,1,4,0,1,2,2,3,3,0,Arts,PhD,25-30,12,0,0,Hybrid,Tier1_City,3,4,3,1,1,3,1,27.11,Healthcare,1,2,3,5,3,0,1,4,1,1,0,0,5,1,56.89
Finance,Entrepreneur,3.1606988670984286,6,2,0,0,0,1,4,3,1,0,4,4,0,0,Commerce,Bachelors,36-40,1,0,0,Remote,Tier2_City,2,2,0,1,5,4,1,29.93,Manufacturing,2,4,3,3,3,5,1,3,3,5,1,0,4,2,56.25
Architecture,Construction Manager,2.741586351584756,1,1,1,1,3,1,2,1,3,4,0,1,1,1,Interdisciplinary,Masters,18-24,7,0,0,Office,Tier2_City,4,5,4,4,5,0,4,34.16,Other,1,2,4,1,0,4,5,2,3,5,0,1,2,5,56.59
Music,Special Education Teacher,4.608448529343256,8,1,4,1,0,1,3,1,3,2,0,1,0,0,Arts,Masters,25-30,14,0,0,Remote,Tier1_City,5,1,2,1,2,5,2,5.96,Healthcare,2,3,5,4,4,2,5,5,2,5,0,1,3,5,60.06
Art,Chemical Engineer,4.775797565674039,7,0,3,1,7,1,1,3,0,2,0,4,2,0,Arts,Masters,18-24,14,1,22,Hybrid,Any,2,4,4,5,4,0,3,32.26,Manufacturing,3,5,5,3,3,4,1,5,1,2,0,0,2,5,50.42
Finance,Urban Planner,3.3823460784659645,5,2,1,1,6,1,0,4,3,2,2,2,3,0,Commerce,Bachelors,31-35,7,0,0,Flexible,Tier1_City,2,1,5,5,5,0,1,45.95,Education,4,5,1,2,0,2,3,5,4,3,0,1,3,5,59.97
Business,Lawyer,4.429278099248131,3,2,3,0,6,1,0,4,1,1,3,3,4,1,Commerce,Masters,31-35,2,1,27,Office,Tier1_City,3,2,1,5,4,5,3,24.38,Healthcare,1,5,5,5,4,2,3,5,5,4,0,0,4,5,59.92
Architecture,Financial Controller,3.027092195815888,5,0,4,1,5,1,4,2,1,4,3,3,1,0,Interdisciplinary,Masters,25-30,6,0,0,Remote,Any,5,2,1,2,5,3,4,8.02,Finance,3,5,4,1,3,1,1,1,2,2,1,0,5,4,58.99
Art,Urban Planner,4.51063427033634,2,1,4,0,2,1,4,3,2,3,1,4,2,0,Arts,Masters,18-24,13,1,13,Remote,Tier3_City,5,2,1,5,2,2,2,7.04,Healthcare,3,2,3,4,1,0,3,4,3,3,0,0,1,5,65.96
Medicine,Zoologist,4.724336771076717,5,1,3,1,1,1,3,1,0,2,0,4,0,0,Science,Bachelors,18-24,6,0,0,Office,Tier1_City,1,5,5,5,1,3,5,16.24,Healthcare,5,3,2,3,0,2,2,1,5,4,0,0,4,5,54.93
Art,Urban Planner,3.236822046905392,8,0,0,0,0,1,0,1,0,1,3,3,4,0,Arts,Bachelors,18-24,13,0,0,Hybrid,Tier1_City,4,3,5,2,2,0,2,38.37,Other,3,2,4,3,3,1,3,2,5,5,1,1,3,2,58.1
Music,Data Scientist,4.0549298988073055,4,0,4,0,6,0,0,0,4,4,1,3,3,1,Arts,Bachelors,25-30,4,0,0,Office,Any,4,3,3,3,5,0,4,15.27,Education,5,5,2,3,1,4,3,1,3,1,0,1,4,3,48.2
Biology,Biologist,3.418061261920186,0,2,3,1,7,1,3,0,3,4,2,4,1,0,Science,Bachelors,18-24,14,0,0,Remote,Tier1_City,2,3,4,1,4,3,2,41.27,Other,3,3,1,5,5,0,1,5,2,2,1,0,2,3,61.19
Computer Science,Architectural Technologist,4.421195925059066,3,0,3,0,9,1,1,0,4,2,2,4,1,1,Science,Masters,25-30,4,1,29,Flexible,Tier2_City,2,5,0,5,0,2,5,41.52,Education,4,4,4,1,0,0,3,2,4,1,1,0,4,1,48.19
Law,Credit Analyst,4.58922608242699,1,0,4,0,6,1,0,3,1,2,3,3,1,1,Arts,Bachelors,36-40,14,0,0,Office,Tier1_City,3,5,4,1,2,2,1,24.48,Other,3,2,3,5,3,1,3,2,4,5,0,1,5,1,63.8
Business,Legal Secretary,4.825631453604554,7,2,2,1,8,1,0,2,2,3,4,1,3,1,Commerce,Bachelors,25-30,7,0,0,Flexible,Any,5,1,5,4,4,4,2,17.14,Healthcare,4,1,3,4,0,1,5,2,3,3,1,1,3,4,55.54
Art,Artist,3.505010870818607,7,0,3,1,0,0,4,4,0,1,1,4,3,0,Arts,Bachelors,31-35,3,0,0,Hybrid,Tier3_City,4,1,5,1,2,1,4,31.09,Manufacturing,2,4,4,1,2,3,5,3,5,1,0,1,4,5,44.8
Art,Pharmacist,4.429558771909584,1,2,2,0,4,1,1,3,1,4,2,2,4,0,Arts,Masters,18-24,0,1,32,Remote,Tier2_City,1,2,2,2,5,0,2,41.09,Education,3,4,4,2,5,5,3,1,3,1,0,0,3,3,46.4
Law,Teacher,2.7044107440159144,9,0,4,1,8,0,4,0,1,0,4,1,4,0,Arts,PhD,25-30,0,0,0,Remote,Tier3_City,4,5,3,1,4,2,5,6.03,Education,3,5,3,2,1,4,3,2,5,3,0,1,1,1,54.38
Engineering,Inorganic Chemist,2.639992563311224,9,1,1,0,5,1,3,3,1,0,1,1,0,1,Science,Bachelors,25-30,8,0,0,Flexible,Any,4,3,4,1,1,5,4,47.81,Manufacturing,2,5,2,5,4,3,1,4,1,2,1,0,5,3,44.29
Psychology,Curriculum Developer,4.0003294672906335,2,1,2,0,0,0,4,2,1,1,3,4,4,1,Arts,Bachelors,18-24,3,1,36,Remote,Any,4,3,3,1,4,0,2,33.36,Tech,5,4,4,5,4,3,2,2,5,2,0,1,3,3,56.28
Business,Paralegal,2.508902180959613,9,2,2,0,6,1,2,3,2,0,3,3,4,1,Commerce,Bachelors,18-24,0,0,0,Remote,Tier3_City,2,1,3,3,3,1,4,21.71,Education,4,2,3,5,0,0,5,4,1,4,1,0,1,3,42.01
Psychology,Manager,2.693864512864767,6,2,0,1,8,1,2,4,2,3,1,4,2,1,Arts,Masters,36-40,12,0,0,Remote,Tier3_City,5,2,0,3,0,5,5,26.78,Education,2,3,5,2,0,3,4,1,5,4,0,0,5,1,67.7
Medicine,Accountant,3.714024907234768,0,1,2,1,8,1,4,3,3,1,1,1,0,1,Science,Masters,36-40,1,0,0,Office,Tier1_City,5,2,2,4,5,0,1,21.12,Manufacturing,2,2,4,2,2,4,3,4,1,5,1,0,2,5,49.7
Art,Financial Analyst,2.9436002606745952,7,2,2,1,2,1,0,2,3,3,0,2,4,0,Arts,PhD,18-24,9,0,0,Flexible,Tier1_City,4,4,0,2,4,2,5,22.39,Manufacturing,1,2,1,1,1,1,4,1,2,3,0,1,3,1,59.3
Education,Principal,3.3146439665924614,2,1,1,1,7,1,4,4,2,0,4,1,0,1,Arts,Bachelors,25-30,6,0,0,Office,Tier3_City,5,5,5,1,5,4,1,30.99,Healthcare,2,4,1,1,0,0,1,1,4,3,0,1,3,3,58.2
Law,Chemist,3.659844719115152,3,1,2,0,1,1,3,2,1,4,4,2,0,0,Arts,PhD,40+,1,0,0,Hybrid,Tier3_City,3,3,0,1,2,3,3,5.83,Healthcare,5,2,4,5,4,5,4,5,1,4,0,0,5,5,57.33
Biology,Interior Designer,4.305308057792519,5,1,3,1,7,0,2,2,0,2,0,2,3,0,Science,Bachelors,18-24,0,1,45,Flexible,Any,2,3,3,1,2,5,5,11.24,Tech,5,3,3,3,1,0,2,5,5,2,1,1,1,3,38.22
Biology,Lawyer,4.313685348597207,9,2,0,0,7,1,2,3,2,3,2,2,4,1,Science,Masters,31-35,9,1,10,Remote,Tier1_City,2,1,3,1,4,3,1,13.67,Tech,5,4,2,1,1,3,2,3,1,2,0,1,2,3,56.42
Architecture,Conductor,3.436414801539104,9,0,0,0,4,1,0,2,3,3,3,4,2,1,Interdisciplinary,Bachelors,40+,13,1,12,Flexible,Tier2_City,5,1,0,3,3,2,3,22.15,Tech,4,2,4,2,2,4,1,5,5,4,1,0,3,2,67.47
Music,Legal Secretary,3.609834691944629,1,1,0,0,5,0,1,3,4,4,3,4,0,0,Arts,Masters,40+,8,0,0,Hybrid,Tier2_City,4,5,5,4,4,2,3,20.44,Finance,4,5,1,4,5,1,5,4,4,3,0,0,4,1,74.06
Law,Nurse,2.985700008624972,9,1,2,1,8,1,2,2,0,0,4,4,1,0,Arts,Bachelors,25-30,13,0,0,Hybrid,Tier3_City,4,1,1,5,1,5,3,36.94,Manufacturing,3,2,2,3,0,4,3,2,2,1,0,0,2,5,49.65
Law,Web Developer,2.717337693683864,2,2,0,0,9,0,2,0,4,3,0,4,4,0,Arts,Masters,18-24,4,1,27,Remote,Tier1_City,4,1,1,2,3,1,4,15.18,Education,2,4,5,2,1,2,4,1,1,1,0,0,4,4,42.93
Medicine,Financial Analyst,4.791213181873584,2,1,4,0,8,1,2,0,0,4,4,1,2,1,Science,Masters,18-24,13,0,0,Remote,Tier3_City,5,3,0,1,5,5,5,5.68,Manufacturing,5,4,2,3,2,4,1,5,5,5,1,1,5,3,70.47
Law,Counselor,3.0432876847712422,4,0,3,1,9,0,0,4,1,2,0,1,4,0,Arts,Bachelors,36-40,12,1,43,Hybrid,Tier1_City,4,5,3,4,4,0,5,5.61,Manufacturing,2,5,5,4,4,2,2,1,4,2,0,1,3,5,50.0
Business,Digital Marketing Specialist,2.557636952281628,4,2,2,0,8,1,3,2,3,1,3,2,1,0,Commerce,High School,36-40,3,0,0,Remote,Tier2_City,5,3,3,5,5,1,5,3.53,Tech,3,4,1,5,2,0,2,4,3,3,1,0,1,3,52.86
Chemistry,Investment Banker,2.6113803636476978,4,2,4,0,8,1,2,4,1,3,4,1,2,1,Science,Masters,31-35,3,1,26,Hybrid,Tier2_City,1,3,2,4,0,3,5,4.79,Manufacturing,3,1,5,3,2,4,1,5,3,2,1,1,3,2,47.99
Business,Graphic Designer,3.2538154380380324,6,0,4,1,2,1,3,3,2,0,0,0,4,0,Commerce,Bachelors,31-35,14,1,9,Remote,Tier2_City,5,1,3,3,3,0,4,43.36,Finance,5,4,2,4,5,4,1,5,1,1,1,0,4,2,44.28
Education,Astronomer,3.0322128144046485,8,2,4,1,7,0,1,3,2,2,4,2,1,0,Arts,Bachelors,31-35,13,0,0,Remote,Tier3_City,3,3,5,5,4,1,5,35.77,Other,2,2,1,4,2,4,1,2,4,3,0,0,2,5,64.03
Biology,Artist,4.064440721440304,5,1,4,1,5,0,2,1,1,1,1,4,1,1,Science,Bachelors,31-35,10,0,0,Flexible,Any,4,5,4,4,0,3,1,49.81,Education,3,3,2,3,0,3,4,2,1,4,0,1,5,4,51.79
Architecture,Construction Manager,4.939084811945073,1,1,2,0,9,0,0,4,2,0,3,0,4,1,Interdisciplinary,Masters,36-40,12,0,0,Flexible,Tier1_City,4,1,5,3,4,0,3,3.95,Other,1,2,4,3,2,0,2,5,5,1,0,0,1,1,60.2
Marketing,Social Media Manager,2.779918167717944,0,1,3,1,9,1,0,1,0,0,1,4,0,1,Commerce,High School,31-35,0,0,0,Flexible,Tier3_City,2,5,4,4,1,4,4,42.9,Tech,4,4,2,3,4,4,1,1,5,1,0,1,4,1,29.86
Architecture,Advertising Manager,4.513158354295588,0,0,0,1,0,0,0,2,2,3,2,0,1,1,Interdisciplinary,Bachelors,25-30,2,0,0,Office,Tier1_City,5,2,3,4,2,5,4,35.71,Healthcare,2,1,4,3,1,1,3,4,3,3,1,0,1,1,43.38
Physics,School Counselor,4.393560921857317,9,2,0,1,2,1,0,1,3,3,3,4,1,1,Science,High School,18-24,12,0,0,Office,Tier3_City,1,5,0,5,5,5,5,33.1,Other,5,2,4,5,3,0,1,4,5,2,0,1,2,2,63.16
Education,Zoologist,3.547220461272076,5,2,3,1,2,1,4,4,1,3,0,1,1,0,Arts,Bachelors,31-35,0,0,0,Office,Tier2_City,4,5,5,3,4,5,3,19.76,Education,3,3,5,2,5,4,1,2,5,1,0,0,5,4,41.7
Physics,Special Education Teacher,3.879646495206264,8,0,4,0,5,0,0,3,1,1,3,0,2,1,Science,Masters,25-30,4,0,0,Office,Tier2_City,2,4,5,1,3,4,1,20.71,Other,3,2,4,1,0,5,4,1,1,5,1,0,5,4,44.9
Education,Physical Chemist,4.962935548147182,8,2,4,1,2,0,3,3,0,4,3,1,3,0,Arts,PhD,25-30,4,0,0,Hybrid,Tier3_City,5,5,4,2,4,1,3,42.74,Healthcare,3,5,5,5,3,1,5,1,3,1,1,1,5,2,60.11
Psychology,Game Developer,3.2240391705880747,8,0,2,1,1,1,2,1,0,2,4,3,2,1,Arts,Masters,36-40,8,0,0,Remote,Tier2_City,2,3,3,5,4,2,2,36.53,Healthcare,4,1,4,3,5,5,2,3,2,2,0,0,3,1,54.53
Chemistry,Actuary,4.391186312060068,5,0,3,1,5,1,1,4,1,0,4,2,2,1,Science,Bachelors,31-35,12,0,0,Remote,Tier1_City,1,3,3,3,4,0,3,34.5,Manufacturing,2,4,1,4,5,3,1,3,5,4,0,0,4,4,66.46
Architecture,Clinical Psychologist,4.0455425788470105,2,1,0,1,2,1,2,2,0,4,4,4,3,1,Interdisciplinary,PhD,36-40,7,1,47,Office,Any,5,1,4,4,4,1,1,4.44,Education,3,2,5,5,2,1,4,3,3,1,0,1,1,4,62.94
Psychology,Entrepreneur,4.644960395735918,1,2,0,1,2,1,4,3,2,3,1,0,0,1,Arts,Bachelors,18-24,4,1,11,Office,Tier2_City,4,2,3,3,3,2,1,11.66,Finance,4,2,2,1,0,0,5,4,2,3,1,0,2,2,44.59
Education,Judge,3.390250247725971,9,0,3,0,3,1,0,4,2,2,0,0,2,0,Arts,Bachelors,31-35,4,0,0,Hybrid,Tier2_City,5,1,0,2,3,5,1,48.24,Manufacturing,1,2,5,1,4,0,5,4,2,2,0,0,3,1,36.95
Education,Marketing Manager,2.8879524348557792,8,2,0,0,5,0,4,2,4,2,1,2,4,0,Arts,PhD,18-24,6,0,0,Remote,Tier2_City,4,5,5,2,4,5,4,24.36,Healthcare,2,2,1,5,3,2,5,5,3,1,1,0,4,1,66.17
Law,Nuclear Physicist,4.068649044447014,9,1,0,0,2,1,2,0,3,4,2,1,2,1,Arts,Masters,36-40,11,1,16,Remote,Any,3,5,1,1,2,5,4,39.73,Other,5,3,4,4,1,2,1,5,1,4,0,0,5,2,58.72
Physics,Risk Analyst,3.0503336407746025,9,1,4,1,4,1,4,4,3,4,1,1,1,0,Science,Masters,18-24,1,0,0,Office,Tier1_City,4,3,5,1,4,2,2,21.3,Education,2,5,1,4,5,2,1,4,3,3,0,1,1,4,58.43
Computer Science,Education Administrator,3.966108299695127,6,2,3,0,4,1,4,2,1,2,2,1,4,0,Science,Masters,31-35,12,0,0,Hybrid,Tier1_City,2,5,4,2,5,0,3,38.92,Manufacturing,3,5,3,4,4,3,4,1,2,5,1,0,5,4,68.87
Business,AI Researcher,2.622439576238495,2,2,2,1,2,1,4,1,4,2,3,4,3,1,Commerce,Bachelors,31-35,6,0,0,Hybrid,Tier1_City,1,5,4,5,5,0,5,8.6,Education,5,1,1,2,4,0,2,1,2,1,1,1,3,5,55.13
Psychology,Judge,3.727200147831153,6,0,4,1,8,0,4,1,1,1,3,2,3,1,Arts,Bachelors,25-30,0,0,0,Hybrid,Tier2_City,5,3,3,5,3,2,2,4.98,Other,2,1,1,4,3,3,4,2,2,1,0,1,4,4,37.28
Education,Credit Analyst,3.492401573529701,6,2,0,1,5,0,0,0,1,0,1,4,4,1,Arts,Masters,40+,13,0,0,Hybrid,Tier1_City,3,2,0,4,5,3,5,24.91,Tech,5,3,1,1,1,0,5,3,3,2,1,0,1,2,52.41
Law,Landscape Architect,2.838335611772988,3,2,3,1,8,1,0,4,0,4,2,1,0,1,Arts,Bachelors,36-40,4,1,10,Flexible,Tier2_City,3,5,4,1,5,5,5,30.81,Finance,2,5,2,3,0,5,3,2,5,4,0,1,4,4,51.51
Engineering,Teacher,2.633765147954446,4,1,2,0,8,0,1,0,1,0,2,2,0,0,Science,Bachelors,25-30,14,0,0,Flexible,Tier1_City,3,4,3,4,1,1,2,18.21,Finance,1,1,2,3,4,2,2,4,2,2,0,0,2,1,42.62
Engineering,Acoustics Specialist,3.846773490224292,6,0,2,0,3,1,2,1,1,3,1,0,3,0,Science,Masters,18-24,11,1,6,Remote,Tier3_City,2,2,3,1,4,0,3,36.65,Finance,1,4,1,1,0,2,4,1,3,5,1,1,5,1,59.06
Architecture,Biologist,4.264606475216047,8,2,1,0,7,0,0,4,4,0,4,0,2,1,Interdisciplinary,Masters,25-30,14,0,0,Hybrid,Tier3_City,4,2,5,2,4,2,5,26.3,Healthcare,1,5,3,4,4,1,2,1,1,5,1,1,2,1,63.2
Chemistry,Teacher,4.575492786089532,0,2,2,0,2,1,4,1,1,1,0,3,3,0,Science,Bachelors,25-30,11,1,41,Hybrid,Tier1_City,3,3,5,5,4,3,4,46.63,Healthcare,2,2,3,3,2,5,3,5,5,1,0,1,4,3,53.7
Education,Urban Planner,2.886913430079602,5,2,0,0,7,0,2,0,0,4,1,2,1,0,Arts,Masters,36-40,5,0,0,Hybrid,Tier1_City,1,1,3,5,4,4,4,6.99,Finance,5,5,5,1,5,5,5,1,4,5,1,1,3,3,56.64
Architecture,Composer,3.5021115063139563,1,0,4,1,7,1,2,3,2,4,3,2,4,1,Interdisciplinary,Masters,40+,12,0,0,Hybrid,Tier3_City,1,5,2,2,0,2,2,6.13,Education,1,4,1,4,4,5,4,4,1,3,1,0,1,2,60.88
Law,Judge,2.840392817964602,0,1,0,1,9,0,0,1,0,3,3,3,0,1,Arts,Masters,18-24,10,1,44,Remote,Tier3_City,5,5,2,4,4,3,5,45.54,Tech,4,2,5,2,0,2,2,3,5,1,1,1,1,4,55.98
Medicine,Lawyer,3.5539377088510102,1,1,1,1,6,1,1,1,3,1,3,1,1,0,Science,Bachelors,25-30,13,1,13,Office,Tier3_City,1,1,0,4,3,4,2,34.45,Healthcare,4,5,4,3,1,2,2,2,1,3,0,1,3,1,54.74
Physics,Legal Secretary,4.289637960270548,3,1,4,0,9,0,3,2,3,2,3,1,3,0,Science,Bachelors,25-30,9,0,0,Hybrid,Tier1_City,4,5,1,3,3,3,4,34.54,Other,1,2,3,4,3,4,1,1,4,5,0,1,4,1,69.68
Music,Astronomer,4.862181577759176,9,2,2,0,9,0,2,1,4,4,0,4,0,1,Arts,Bachelors,18-24,0,1,27,Flexible,Any,4,4,2,1,0,0,2,4.3,Manufacturing,1,2,4,4,1,0,5,1,2,2,1,0,4,3,39.4
Marketing,Astronomer,4.527033964425719,7,0,4,0,2,0,3,3,3,2,3,3,1,1,Commerce,Bachelors,25-30,14,0,0,Remote,Tier3_City,3,1,0,4,4,2,5,47.07,Manufacturing,3,3,4,3,4,2,4,4,1,1,1,1,1,5,55.72
Finance,Manager,3.14121219846454,2,2,3,0,0,1,3,3,3,2,3,2,2,0,Commerce,Bachelors,25-30,8,1,39,Remote,Tier1_City,4,3,3,2,2,4,5,39.28,Healthcare,4,4,1,4,0,4,5,4,1,2,0,1,4,3,54.19
Chemistry,Game Developer,4.819083061720852,8,0,1,1,3,1,0,4,2,3,1,0,1,1,Science,Bachelors,25-30,8,1,35,Office,Tier2_City,4,1,3,4,4,3,4,38.92,Finance,4,3,3,5,2,4,1,4,5,1,0,0,1,2,51.87
Psychology,Animator,4.849807125118193,5,1,0,0,2,1,3,1,1,3,4,0,1,0,Arts,Bachelors,31-35,0,0,0,Office,Tier2_City,3,2,1,5,3,4,1,45.86,Education,1,5,5,5,1,4,3,5,3,2,0,1,1,3,43.46
Law,Biotechnologist,2.9911268256669645,0,1,2,0,5,1,4,3,1,1,3,4,2,0,Arts,PhD,31-35,3,0,0,Hybrid,Tier1_City,5,3,4,1,1,1,1,30.17,Tech,3,2,4,2,2,5,5,1,5,4,0,0,2,2,64.22
Finance,Construction Manager,3.941290995050272,6,2,0,0,2,0,1,4,3,1,3,0,2,0,Commerce,Bachelors,18-24,14,0,0,Flexible,Any,4,2,2,3,5,2,3,21.55,Manufacturing,5,5,1,1,3,5,1,2,3,1,0,1,1,1,51.78
Music,Graphic Designer,2.720549768060533,7,2,0,1,4,1,4,0,3,3,0,0,1,0,Arts,Masters,36-40,7,1,56,Hybrid,Tier3_City,4,3,2,1,1,0,4,25.59,Healthcare,3,5,2,5,2,5,3,2,4,1,1,1,1,5,56.03
Physics,Illustrator,3.2337825918060026,7,0,4,1,6,1,3,3,1,0,2,0,1,0,Science,Masters,31-35,1,0,0,Hybrid,Tier1_City,2,1,3,5,2,4,3,39.53,Education,3,3,3,5,3,2,5,2,5,3,0,1,3,2,49.48
Art,Accountant,3.651336220847661,3,2,1,1,0,0,1,1,4,4,0,2,4,1,Arts,Bachelors,36-40,12,0,0,Flexible,Any,5,2,0,5,4,5,4,39.13,Finance,4,5,2,2,2,3,3,5,1,4,0,1,5,3,56.5
Computer Science,Psychologist,3.1890537496009737,9,0,1,0,0,0,0,4,0,1,3,2,0,0,Science,PhD,25-30,12,0,0,Hybrid,Tier2_City,3,3,5,5,0,3,5,31.65,Tech,1,4,5,5,4,3,4,3,4,2,1,1,2,1,59.34
Finance,Industrial-Organizational Psychologist,4.210593432203732,6,0,4,0,7,1,1,0,1,3,3,0,2,0,Commerce,Masters,36-40,10,1,56,Hybrid,Tier2_City,2,5,1,5,4,5,4,13.25,Tech,1,2,5,5,2,5,2,5,5,4,1,0,4,4,65.93
Chemistry,Risk Analyst,3.403874317773943,1,1,4,1,6,0,0,1,2,2,1,3,1,1,Science,Bachelors,36-40,12,0,0,Office,Tier3_City,2,2,1,2,2,4,2,41.49,Manufacturing,1,1,5,3,5,0,3,1,2,2,1,0,4,4,47.87
Music,Psychologist,3.6906842666953694,2,0,0,1,2,0,1,2,1,0,3,2,1,1,Arts,Masters,25-30,7,1,40,Hybrid,Tier2_City,5,4,4,3,2,5,3,33.42,Manufacturing,3,4,3,2,1,3,2,5,4,1,0,0,4,4,51.22
Chemistry,Musician,3.7225243495875135,8,0,1,0,7,1,4,3,0,0,1,4,1,0,Science,Bachelors,25-30,9,1,57,Hybrid,Tier2_City,4,3,4,5,5,3,4,13.4,Other,3,1,4,4,1,2,4,4,2,3,1,1,2,2,55.38
Business,Forensic Psychologist,3.0824541407033115,6,2,3,0,7,0,2,3,0,3,0,3,2,1,Commerce,Masters,36-40,12,0,0,Remote,Tier1_City,3,5,5,5,2,4,3,25.59,Healthcare,2,1,1,4,1,0,3,2,5,2,0,1,2,1,57.85
Chemistry,Graphic Designer,3.712447530124298,5,0,0,1,9,1,2,0,4,3,2,3,0,0,Science,High School,31-35,11,0,0,Hybrid,Tier2_City,5,5,0,4,1,0,4,49.87,Tech,5,3,4,1,3,0,2,1,5,1,1,0,5,5,51.66
Chemistry,Investment Banker,4.102836635835926,3,2,1,0,8,1,0,4,2,1,2,3,1,1,Science,Masters,36-40,13,1,57,Remote,Tier2_City,2,1,0,3,5,0,1,18.43,Finance,2,1,3,1,3,5,3,1,5,5,0,0,3,5,67.27
Finance,Inorganic Chemist,3.3644957545666263,4,2,3,0,3,0,3,1,3,1,2,0,1,0,Commerce,Bachelors,31-35,12,0,0,Flexible,Tier2_City,1,1,1,1,4,2,3,8.48,Finance,5,2,2,5,4,0,1,1,3,5,1,0,5,1,62.97
Chemistry,Accountant,2.543696077107604,8,1,4,1,2,0,3,4,2,1,1,2,4,1,Science,Masters,31-35,8,1,34,Remote,Tier2_City,3,2,3,3,4,0,5,4.02,Healthcare,2,3,1,5,3,1,3,1,4,5,0,1,3,4,68.26
Law,Marketing Manager,2.708285890604285,3,0,1,0,7,1,1,3,0,4,1,1,0,1,Arts,Bachelors,18-24,8,1,34,Remote,Tier2_City,1,2,0,3,0,4,5,11.68,Tech,2,4,5,4,4,2,3,3,4,1,0,0,3,4,45.48
Music,Graphic Designer,4.099349468686926,4,1,3,1,6,1,2,1,3,0,4,2,3,1,Arts,Masters,25-30,13,0,0,Hybrid,Tier2_City,4,4,5,3,2,4,4,11.79,Manufacturing,2,4,2,2,2,5,5,5,2,1,0,1,5,4,53.74
Law,Illustrator,3.0514907373882805,5,0,0,1,6,0,3,4,0,2,0,2,4,1,Arts,Masters,40+,0,0,0,Office,Tier2_City,5,5,0,5,2,0,5,43.33,Other,2,4,4,3,0,2,5,1,2,2,0,1,3,1,37.48
Music,Music Teacher,3.214209561827402,7,2,0,0,3,1,4,1,2,4,2,3,2,1,Arts,Bachelors,25-30,8,0,0,Office,Tier1_City,4,3,4,5,3,1,5,10.34,Finance,3,5,1,1,1,3,4,3,2,3,1,0,3,5,54.29
Business,Manager,3.6499786963850136,2,0,0,1,1,0,1,4,1,4,1,2,3,1,Commerce,Masters,18-24,3,0,0,Hybrid,Tier1_City,5,4,4,2,5,4,3,43.54,Education,5,3,5,5,1,3,4,5,4,2,1,0,3,2,56.9
Finance,Aerospace Engineer,2.9688147934003064,7,1,3,0,6,0,1,3,2,2,2,1,0,1,Commerce,Bachelors,31-35,11,0,0,Flexible,Tier2_City,2,4,5,1,3,2,4,7.08,Healthcare,2,3,1,1,4,2,4,5,2,4,1,1,4,4,51.54
Music,Accountant,3.5640725871934853,1,2,4,0,2,0,2,4,3,4,1,0,3,1,Arts,Masters,31-35,11,0,0,Hybrid,Tier1_City,4,4,4,4,5,1,3,45.61,Finance,2,3,4,4,3,1,2,3,1,1,0,0,2,3,60.01
Engineering,Human Resources Specialist,2.8334473049664606,9,1,1,0,8,0,0,2,2,3,2,4,3,0,Science,Bachelors,25-30,7,0,0,Hybrid,Tier1_City,1,3,3,3,1,0,4,15.05,Education,1,2,3,2,5,4,4,4,5,1,1,0,3,4,53.09
Physics,Music Teacher,3.142201682355686,8,2,3,1,7,0,3,3,1,1,4,0,3,0,Science,Masters,25-30,12,0,0,Office,Tier1_City,2,4,1,1,5,3,5,31.74,Education,3,3,4,4,2,1,4,4,2,3,1,1,3,4,62.83
Medicine,Judge,3.055111197136112,1,0,2,0,4,1,0,3,1,1,2,4,2,0,Science,Masters,25-30,13,0,0,Remote,Tier1_City,5,1,3,1,4,4,4,10.51,Finance,4,2,3,3,4,1,5,1,1,2,1,0,1,5,54.88
Music,Legal Consultant,3.765114182570618,1,2,0,1,5,0,4,1,4,3,4,2,4,0,Arts,Bachelors,18-24,8,1,24,Flexible,Tier1_City,2,1,4,2,0,3,4,21.33,Healthcare,1,4,5,2,1,3,3,3,2,2,1,0,2,4,57.76
Business,Biotechnologist,2.88041292641123,5,1,0,1,8,0,3,3,1,0,0,4,1,1,Commerce,Bachelors,31-35,2,0,0,Hybrid,Tier1_City,1,1,2,4,5,5,2,7.03,Education,4,5,4,3,5,1,4,3,5,1,0,1,2,1,43.64
Business,Art Director,3.332412817179637,0,0,0,0,7,0,2,4,2,1,2,1,2,1,Commerce,Bachelors,25-30,5,0,0,Flexible,Tier1_City,3,4,2,3,5,2,4,30.24,Education,2,1,4,3,4,3,4,4,1,5,1,0,5,3,50.83
Medicine,Legal Consultant,4.562007057378517,8,2,1,0,2,0,4,4,4,4,0,3,2,0,Science,Masters,36-40,2,1,30,Remote,Tier1_City,5,4,1,4,5,1,2,19.26,Tech,5,5,4,2,0,3,3,3,5,2,0,1,3,5,60.59
Biology,Accountant,3.634131201561379,0,2,3,1,5,0,1,2,0,1,1,4,2,1,Science,Bachelors,36-40,0,0,0,Flexible,Tier1_City,3,5,4,2,0,3,3,43.05,Other,4,5,4,3,0,5,5,3,3,4,1,1,2,4,34.25
Biology,Cybersecurity Analyst,3.09783768651984,1,2,2,1,9,1,0,0,4,4,1,0,3,0,Science,Bachelors,31-35,9,1,45,Office,Tier1_City,2,2,5,5,2,2,2,11.55,Other,4,5,3,1,0,0,5,1,5,5,0,1,1,1,58.31
Education,Urban Planner,3.773235088949794,3,2,2,0,3,0,2,1,0,1,3,3,0,1,Arts,Masters,25-30,5,0,0,Hybrid,Tier3_City,4,5,4,1,0,3,3,16.16,Other,4,1,3,5,2,5,3,1,4,5,1,1,2,2,56.1
Engineering,Game Developer,2.5857472609668988,7,1,1,0,7,0,2,0,1,0,2,3,4,0,Science,Bachelors,25-30,4,1,7,Hybrid,Tier1_City,5,1,3,3,2,3,4,11.33,Tech,5,2,2,2,0,1,5,3,5,2,1,0,3,4,42.82
Marketing,Construction Manager,4.449890017384679,0,1,4,1,6,1,2,1,4,2,3,3,4,1,Commerce,Masters,25-30,2,0,0,Flexible,Tier2_City,2,2,1,5,4,2,3,29.5,Other,1,4,5,4,2,1,5,2,3,5,0,1,5,4,62.94
Architecture,Forensic Psychologist,3.683132045944591,7,0,2,0,4,1,2,4,2,4,0,1,0,1,Interdisciplinary,Bachelors,25-30,13,1,46,Hybrid,Tier1_City,5,5,3,2,0,4,5,8.25,Tech,3,1,5,4,5,1,1,2,2,4,1,0,5,1,59.1
Physics,Education Administrator,4.028990799323651,9,0,2,0,0,1,4,0,1,1,3,1,4,0,Science,Bachelors,36-40,13,1,43,Hybrid,Tier1_City,1,3,5,4,2,3,4,11.9,Education,5,4,3,5,4,5,2,3,4,2,1,1,4,5,57.27
Music,Composer,3.444768848845915,8,1,0,1,2,1,0,2,1,1,1,3,0,1,Arts,Masters,25-30,3,0,0,Office,Tier2_City,2,3,4,1,4,2,2,34.89,Education,1,2,2,4,2,2,3,4,3,3,0,0,5,1,48.65
Computer Science,Biomedical Engineer,4.2012704259674845,3,2,2,1,6,1,1,1,4,0,2,0,0,0,Science,Bachelors,36-40,1,0,0,Remote,Tier2_City,4,3,5,3,4,3,1,6.5,Healthcare,2,4,2,5,1,4,2,1,5,2,1,0,1,2,47.4
Physics,Legal Secretary,3.154546660328996,7,0,3,0,6,1,0,3,4,2,3,4,4,0,Science,Bachelors,18-24,11,1,30,Remote,Tier1_City,5,1,0,5,2,4,4,37.93,Manufacturing,1,2,4,1,3,4,3,2,3,1,0,1,5,3,55.28
Business,Curriculum Developer,3.9507458217675726,3,2,4,1,6,0,3,4,3,3,4,4,3,1,Commerce,Masters,18-24,9,0,0,Office,Tier1_City,4,2,2,5,2,2,5,7.9,Tech,4,1,2,4,0,2,1,1,2,3,0,1,4,4,68.3
Marketing,Counselor,3.327057909032373,1,0,4,1,5,0,4,0,4,4,0,1,3,0,Commerce,Bachelors,40+,9,1,36,Remote,Tier1_City,4,1,4,1,1,3,3,30.52,Other,1,1,5,4,3,5,3,3,4,2,0,1,2,2,58.94
Music,Biomedical Engineer,4.682186478548089,1,0,4,1,5,1,3,1,2,3,3,4,1,0,Arts,PhD,25-30,12,0,0,Office,Tier3_City,1,3,0,4,4,0,2,49.9,Manufacturing,1,4,1,1,4,5,3,1,1,5,1,1,4,4,69.13
Law,Actuary,3.535153913521261,7,1,0,1,3,0,3,0,2,4,3,2,3,1,Arts,PhD,25-30,13,1,22,Hybrid,Tier1_City,3,4,2,2,2,4,2,11.17,Tech,2,4,3,4,2,1,3,2,3,1,1,0,2,1,61.97
Chemistry,Marketing Manager,3.2240464196686194,8,0,4,1,3,0,2,1,4,0,3,2,0,1,Science,Bachelors,25-30,3,0,0,Hybrid,Tier1_City,2,1,0,4,4,3,5,15.27,Other,2,5,4,4,2,3,1,3,3,1,1,0,4,1,46.15
Education,School Counselor,3.625151430601168,7,2,4,0,0,0,4,4,3,1,3,1,2,0,Arts,High School,18-24,3,0,0,Remote,Tier3_City,3,2,1,4,0,1,5,45.23,Tech,1,5,2,1,3,2,5,3,5,3,1,0,1,1,49.31
Business,Advertising Manager,3.636676222469341,8,0,4,0,6,0,1,2,1,1,0,1,1,0,Commerce,Masters,31-35,2,0,0,Office,Tier1_City,3,1,0,4,3,2,4,32.44,Other,5,4,3,1,4,3,4,3,4,4,1,1,5,3,41.95
Chemistry,Game Developer,3.9550525057512713,0,1,0,0,0,0,1,3,4,1,3,0,0,0,Science,Bachelors,18-24,5,0,0,Office,Tier1_City,1,2,5,1,3,3,1,26.15,Healthcare,2,5,3,1,3,2,2,1,1,1,1,0,1,3,39.99
Music,Geneticist,4.4807442275666265,8,2,1,0,2,0,0,3,3,4,4,0,4,1,Arts,Bachelors,25-30,0,0,0,Hybrid,Tier1_City,4,4,0,1,5,4,1,29.45,Healthcare,4,4,3,4,1,1,2,4,3,2,1,0,1,2,49.06
Medicine,Music Teacher,2.842450044514235,0,2,1,1,9,0,4,0,3,1,3,1,2,1,Science,Masters,25-30,8,0,0,Hybrid,Tier1_City,4,5,1,2,2,4,3,16.89,Finance,5,3,5,5,0,5,2,2,1,5,1,0,5,5,61.47
Music,Marketing Manager,3.4827641912748404,6,0,1,1,3,0,1,4,4,1,3,0,4,1,Arts,High School,36-40,10,0,0,Remote,Tier1_City,2,2,0,4,2,1,2,43.2,Tech,1,5,4,5,0,5,4,5,1,3,0,1,1,2,55.07
Medicine,Biomedical Engineer,3.3708632032486765,7,0,3,1,2,0,0,3,3,1,1,2,3,1,Science,Masters,25-30,9,1,39,Office,Any,1,2,2,1,4,1,4,38.03,Tech,4,4,1,2,2,1,5,2,2,4,0,0,3,4,55.94
Business,Teacher,3.195368660654218,0,0,1,1,7,0,4,4,1,4,3,0,1,1,Commerce,Bachelors,18-24,2,0,0,Hybrid,Any,5,3,0,2,5,5,2,33.2,Tech,4,3,4,2,5,2,1,2,5,5,0,0,1,2,59.65
Psychology,Surgeon,3.578025641860288,3,2,3,0,5,1,1,0,0,0,2,0,2,0,Arts,Bachelors,25-30,2,1,53,Remote,Tier2_City,4,3,5,2,2,5,4,46.79,Healthcare,5,5,2,4,4,1,3,5,1,4,1,0,4,3,33.31
Engineering,Web Developer,4.80528215495898,7,0,4,1,7,1,0,0,3,4,3,0,0,1,Science,Bachelors,18-24,11,0,0,Office,Tier2_City,2,4,5,4,4,3,5,30.17,Other,1,1,4,4,4,0,3,2,5,3,1,0,1,2,63.95
Chemistry,Composer,2.698172463147933,9,0,4,0,0,1,4,3,1,0,3,2,3,0,Science,PhD,18-24,2,0,0,Flexible,Tier2_City,5,1,0,3,2,0,3,27.06,Tech,4,4,5,5,2,2,5,3,2,3,0,1,5,1,55.95
Architecture,Art Director,3.20531328605966,5,0,4,0,0,1,2,1,1,3,3,0,3,0,Interdisciplinary,Masters,18-24,6,0,0,Remote,Tier2_City,3,5,1,4,4,4,5,48.86,Finance,2,1,1,3,4,1,1,3,1,4,0,1,3,5,51.28
Engineering,Lawyer,4.890541065795954,4,2,2,0,5,1,2,2,2,4,2,1,4,0,Science,Masters,25-30,7,0,0,Office,Tier3_City,1,5,2,3,2,0,2,12.68,Education,2,5,4,2,4,3,3,1,5,1,0,1,5,1,59.14
Marketing,Physicist,3.709647268908875,9,1,0,0,5,1,4,0,4,0,0,3,1,1,Commerce,Bachelors,18-24,1,0,0,Flexible,Tier2_City,5,4,1,2,1,0,3,9.67,Finance,5,3,2,5,0,4,1,5,4,3,0,0,2,4,47.56
Art,Education Administrator,3.967801390300023,7,0,1,1,1,0,0,1,4,1,2,4,0,1,Arts,Bachelors,25-30,0,0,0,Flexible,Tier1_City,4,5,0,1,4,3,4,10.63,Other,2,4,4,4,1,4,5,3,5,4,1,0,5,1,51.67
Computer Science,Web Developer,4.605684632432819,7,1,0,1,5,1,4,4,3,1,3,1,3,1,Science,Bachelors,36-40,4,0,0,Remote,Tier1_City,2,1,1,5,1,2,4,49.5,Education,3,3,5,2,1,1,5,5,4,1,1,0,1,3,50.78
Marketing,Organic Chemist,4.106389070090259,6,1,4,0,9,1,0,0,2,0,3,0,0,1,Commerce,Bachelors,31-35,7,0,0,Hybrid,Any,2,3,5,2,1,2,3,33.66,Healthcare,1,1,3,2,2,3,5,3,2,1,1,0,2,4,36.14
Art,Organic Chemist,4.393142511380939,7,2,0,0,4,1,4,3,3,4,0,3,2,1,Arts,Masters,18-24,13,0,0,Flexible,Tier1_City,1,4,1,1,1,2,5,17.38,Other,4,4,5,2,1,3,3,2,2,3,1,0,5,1,60.67
Education,Microbiologist,4.060499771584867,4,0,0,1,7,1,1,4,2,0,2,3,2,1,Arts,Masters,18-24,2,0,0,Remote,Any,3,5,0,2,1,1,3,14.7,Manufacturing,4,1,5,4,1,4,1,5,4,2,0,0,3,1,49.24
Law,Art Therapist,4.830577143006845,9,1,0,0,1,0,2,3,2,3,3,2,1,1,Arts,Bachelors,31-35,5,0,0,Hybrid,Tier2_City,4,4,0,4,0,4,5,5.66,Other,5,1,5,5,0,5,2,3,3,4,1,1,2,2,54.39
Music,Music Therapist,3.281919528453923,0,2,1,1,4,0,4,4,3,0,0,0,2,1,Arts,PhD,36-40,2,0,0,Hybrid,Tier2_City,3,4,5,3,5,1,3,9.2,Healthcare,5,3,1,3,1,5,2,4,1,5,0,0,4,5,54.11
Marketing,Artist,4.262605034118538,7,1,1,1,6,0,1,3,2,4,3,4,3,1,Commerce,Bachelors,18-24,14,0,0,Hybrid,Tier1_City,1,2,5,2,3,4,5,45.68,Manufacturing,4,5,4,4,1,0,3,5,1,2,1,0,2,1,59.73
Medicine,Legal Consultant,3.434439601674524,5,0,0,1,5,0,3,1,0,4,0,1,4,0,Science,PhD,36-40,5,0,0,Hybrid,Tier1_City,1,2,5,1,0,5,1,38.13,Education,2,1,2,2,1,0,4,5,4,1,0,1,2,5,45.8
Computer Science,Inorganic Chemist,4.597167379851155,2,2,1,0,3,0,1,3,4,2,3,1,0,1,Science,High School,25-30,11,0,0,Flexible,Tier2_City,3,4,4,4,2,4,3,47.25,Manufacturing,5,1,3,1,5,2,4,4,1,5,1,1,1,4,52.77
Education,Analytical Chemist,2.5184750754797207,3,1,2,1,3,1,1,3,4,1,1,1,0,0,Arts,Bachelors,25-30,3,0,0,Remote,Tier2_City,5,2,0,5,2,4,5,22.92,Education,3,2,3,5,5,2,5,5,2,2,0,1,5,5,41.51
Architecture,Principal,4.698058877793484,5,0,0,0,9,1,1,0,3,3,1,0,0,1,Interdisciplinary,Bachelors,40+,13,0,0,Hybrid,Tier2_City,5,5,0,4,5,3,2,31.26,Other,5,3,1,4,3,3,1,1,3,1,0,0,2,1,54.41
Music,Manager,4.993411344666029,7,0,4,1,0,0,2,4,1,3,2,2,1,1,Arts,Bachelors,31-35,10,0,0,Hybrid,Tier2_City,1,4,4,3,3,2,2,25.73,Manufacturing,2,1,2,2,1,4,2,2,4,5,1,0,2,1,63.0
Law,Landscape Architect,3.954810483569686,3,0,0,0,7,1,2,2,0,4,2,3,0,0,Arts,Masters,36-40,14,1,28,Remote,Tier1_City,5,2,2,4,3,1,3,44.43,Education,1,2,3,3,3,5,5,2,2,5,1,0,2,3,65.65
Engineering,Accountant,4.230314178311708,9,1,4,1,4,0,4,1,1,0,2,2,4,1,Science,Bachelors,25-30,6,0,0,Remote,Tier3_City,5,5,4,5,3,5,3,49.59,Other,3,3,2,2,0,1,3,3,2,1,0,0,5,2,45.53
Biology,Data Scientist,4.330965556836687,1,0,3,1,0,0,2,2,4,2,4,2,4,0,Science,Bachelors,25-30,10,0,0,Flexible,Any,2,3,1,1,1,1,4,46.84,Manufacturing,5,4,2,2,1,2,4,1,4,3,0,1,3,5,66.03
Chemistry,Art Director,4.328656419334849,7,2,2,0,8,0,3,2,1,0,2,2,2,1,Science,Masters,31-35,9,0,0,Hybrid,Any,3,3,4,2,0,3,5,31.11,Education,1,5,4,4,4,0,3,4,4,1,0,0,5,5,53.98
Medicine,Urban Planner,4.581467454650042,4,0,4,1,2,1,3,3,2,3,4,1,3,0,Science,Masters,25-30,0,0,0,Hybrid,Tier2_City,2,4,5,3,2,4,3,5.9,Finance,1,3,1,3,3,3,1,4,5,4,0,1,3,2,57.23
Medicine,Curriculum Developer,3.580699128122529,8,0,0,1,6,0,4,3,1,2,1,4,3,0,Science,Masters,25-30,0,1,41,Office,Tier1_City,2,1,4,5,0,5,2,32.02,Tech,4,1,5,1,1,2,1,2,2,1,0,1,2,5,39.36
Music,Biotechnologist,4.653839742899239,8,2,4,1,6,1,3,2,2,1,3,1,1,1,Arts,Bachelors,18-24,14,1,49,Remote,Tier1_City,1,5,2,3,0,2,2,7.56,Finance,2,2,5,4,5,3,1,4,1,4,0,0,5,2,51.96
Finance,Conductor,2.9155145240463405,3,1,3,0,1,0,4,1,0,0,0,2,3,0,Commerce,Masters,18-24,4,0,0,Office,Tier2_City,1,4,3,4,0,0,2,9.52,Healthcare,4,2,3,5,4,5,4,2,3,5,0,1,5,4,49.7
Architecture,Art Therapist,3.4038467267803263,3,2,0,0,2,0,0,3,2,2,0,4,2,0,Interdisciplinary,Masters,25-30,8,1,10,Remote,Tier3_City,1,2,2,3,3,0,5,11.99,Manufacturing,2,4,3,3,2,1,4,1,5,1,0,0,5,4,56.48
Finance,Web Developer,3.83098266860709,7,0,3,1,1,0,0,4,1,3,2,1,0,0,Commerce,Bachelors,31-35,4,0,0,Office,Tier2_City,2,3,4,5,5,3,1,20.08,Other,1,2,1,1,3,2,5,1,2,2,1,0,2,5,42.07
Art,Social Media Manager,3.811413686449088,9,1,3,1,8,1,4,2,0,4,2,2,1,0,Arts,Bachelors,36-40,3,0,0,Remote,Tier2_City,4,2,1,2,5,2,3,30.81,Education,5,1,4,1,0,4,3,1,4,1,1,1,2,3,50.85
Art,Legal Analyst,4.286477246648239,5,1,4,0,7,1,2,0,2,2,2,4,0,1,Arts,Bachelors,25-30,7,0,0,Office,Tier3_City,2,5,1,2,3,0,1,18.68,Finance,2,3,3,3,2,1,2,3,3,3,0,1,3,1,51.54
Engineering,AI Researcher,2.611343855420204,6,0,2,0,2,0,3,1,1,2,0,1,0,0,Science,Bachelors,31-35,12,0,0,Office,Tier1_City,2,4,3,3,2,0,5,24.26,Finance,2,4,3,5,4,0,2,4,3,1,1,1,3,5,49.66
Marketing,Chemical Engineer,3.389603151434617,8,0,4,0,0,1,2,2,1,1,4,3,0,1,Commerce,Bachelors,18-24,4,1,9,Hybrid,Any,2,3,0,1,2,5,3,5.22,Other,1,5,2,2,3,3,2,3,2,1,1,0,5,4,43.02
Marketing,Quantum Physicist,4.475301781765426,7,1,2,1,8,1,4,1,1,3,0,2,2,1,Commerce,Bachelors,36-40,0,1,11,Hybrid,Tier1_City,5,5,5,3,2,5,4,32.13,Education,3,5,1,4,3,1,4,5,1,5,1,1,4,5,38.98
Education,Physical Chemist,4.9902794127033285,5,1,3,0,7,1,4,1,0,2,3,4,1,0,Arts,Masters,25-30,6,0,0,Remote,Tier1_City,5,3,5,4,5,1,3,33.88,Manufacturing,1,1,5,5,1,1,5,4,3,3,0,1,1,2,62.51
Medicine,Social Media Manager,2.903834567693922,6,1,1,1,4,1,1,2,3,1,1,1,1,0,Science,Masters,31-35,10,0,0,Flexible,Tier3_City,1,3,5,2,5,2,3,7.67,Other,1,4,1,1,2,1,1,5,2,1,0,1,2,2,48.87
Biology,Chemical Engineer,4.056834780136004,1,0,4,0,1,1,3,2,3,3,1,2,3,1,Science,PhD,31-35,14,0,0,Remote,Any,2,4,4,2,0,0,3,39.9,Healthcare,2,4,5,5,1,3,1,1,3,2,1,0,1,4,64.97
Computer Science,Marketing Specialist,2.816845628742408,9,0,2,1,3,1,4,3,1,0,3,3,4,0,Science,Masters,25-30,3,1,16,Hybrid,Tier3_City,2,4,0,2,3,5,3,33.43,Healthcare,1,1,2,2,0,5,5,3,1,5,1,0,1,1,50.69
Physics,Civil Engineer,4.620368375477652,4,0,4,0,9,0,0,1,2,0,1,4,0,0,Science,Bachelors,25-30,9,0,0,Remote,Tier3_City,1,1,1,1,1,5,3,26.02,Other,4,4,4,5,2,5,4,3,5,4,0,1,1,2,54.15
Physics,Pharmacist,3.670710489352176,9,2,4,1,6,0,4,0,1,2,0,2,3,0,Science,Masters,40+,4,0,0,Flexible,Any,3,1,0,1,0,5,5,28.98,Healthcare,1,2,5,5,3,4,2,2,2,3,0,0,3,4,45.35
Architecture,Physicist,4.221646321975978,7,1,2,0,4,0,3,0,2,4,1,4,3,1,Interdisciplinary,Masters,18-24,12,0,0,Hybrid,Tier2_City,4,1,2,5,4,1,3,26.64,Education,5,2,2,1,4,3,3,1,2,3,0,0,2,3,62.73
Physics,Judge,4.237273881904268,6,2,1,1,9,0,1,0,2,1,4,0,2,1,Science,Bachelors,31-35,5,1,40,Remote,Tier2_City,4,1,5,3,5,2,5,5.53,Finance,1,1,4,5,0,3,4,2,5,5,1,1,4,4,57.95
Engineering,Forensic Psychologist,4.181124850513903,6,2,0,1,9,0,3,0,2,1,1,4,1,0,Science,Masters,40+,12,1,45,Office,Tier1_City,3,2,2,3,0,4,3,37.55,Other,1,1,2,4,1,0,2,1,4,4,0,0,4,4,62.68
Engineering,Aerospace Engineer,3.646131799422344,6,0,2,0,6,1,2,2,2,0,2,2,1,0,Science,PhD,25-30,6,0,0,Flexible,Tier1_City,1,1,3,4,3,5,3,27.06,Healthcare,5,2,4,3,1,3,1,2,2,5,1,0,4,1,58.28
Marketing,Graphic Designer,3.231249814975572,7,0,1,0,6,0,3,4,0,3,1,3,0,0,Commerce,Bachelors,36-40,10,0,0,Hybrid,Tier2_City,3,2,0,2,4,2,5,11.12,Finance,3,3,3,1,5,3,5,3,4,3,1,0,5,1,61.29
Music,Physical Chemist,3.852265506641101,8,2,3,1,1,0,0,1,4,3,4,2,4,1,Arts,PhD,36-40,1,1,21,Hybrid,Tier3_City,4,3,3,1,0,3,3,34.99,Other,3,1,4,3,0,4,5,3,2,5,1,1,2,1,56.26
Art,Conductor,4.536384320445176,0,2,3,0,1,0,3,4,4,0,4,4,2,0,Arts,Bachelors,31-35,14,1,23,Remote,Tier1_City,3,2,2,4,3,1,2,35.67,Healthcare,3,2,5,5,2,5,2,2,3,5,0,0,3,3,77.28
Computer Science,Chemical Engineer,4.816697263284291,4,0,3,0,9,0,3,1,2,0,1,3,3,0,Science,Bachelors,18-24,13,0,0,Remote,Tier2_City,2,3,5,4,3,4,3,13.03,Healthcare,4,3,4,2,0,3,4,2,1,5,1,0,3,2,57.46
Chemistry,Brand Manager,4.106041495320536,1,1,1,1,7,1,0,3,2,0,3,3,3,1,Science,Bachelors,25-30,14,0,0,Remote,Any,5,1,2,1,5,5,4,40.44,Other,5,3,1,1,2,3,2,4,3,3,1,0,5,4,57.85
Engineering,Industrial-Organizational Psychologist,4.93455705134388,6,2,0,0,2,0,3,1,2,1,2,0,1,1,Science,Masters,18-24,0,1,13,Hybrid,Tier2_City,2,2,3,3,1,5,5,24.46,Manufacturing,4,2,4,5,0,3,4,3,2,1,0,0,3,1,35.1
Marketing,Civil Engineer,4.221998384650673,1,2,2,1,3,1,4,2,3,3,3,1,3,0,Commerce,Masters,36-40,11,1,57,Office,Any,4,3,2,2,0,1,3,11.49,Education,4,2,2,5,5,5,1,5,4,4,1,0,2,2,69.3
Education,Fluid Mechanics Engineer,4.907306068627854,6,2,3,1,3,0,2,0,1,1,2,3,4,1,Arts,PhD,36-40,2,1,11,Flexible,Any,5,1,0,3,3,1,3,33.91,Manufacturing,4,4,5,2,5,3,5,5,4,3,0,1,5,2,50.32
Architecture,Art Therapist,3.053509081676835,5,2,2,1,7,1,2,2,4,3,1,1,1,0,Interdisciplinary,Bachelors,31-35,9,0,0,Office,Tier2_City,5,3,4,4,2,0,5,31.05,Finance,5,3,3,5,0,5,4,1,5,1,0,0,4,3,60.22
Music,Nurse,4.188128827118285,7,1,3,1,7,0,4,4,0,3,0,3,0,1,Arts,High School,25-30,11,1,10,Remote,Tier1_City,3,4,4,2,3,5,1,11.01,Finance,2,5,3,4,3,0,1,4,5,4,1,1,1,5,60.69
Music,Quantum Physicist,3.0750960636426794,2,0,0,1,0,0,1,3,3,4,4,4,4,0,Arts,Masters,18-24,0,0,0,Office,Tier1_City,2,3,2,5,1,2,2,44.0,Other,2,4,2,2,2,0,3,2,5,5,0,0,4,3,60.72
Architecture,Doctor,3.698303823306269,7,2,2,0,5,1,2,4,3,3,3,0,1,1,Interdisciplinary,Masters,31-35,3,1,43,Hybrid,Tier2_City,3,1,4,4,3,1,2,43.16,Education,3,4,3,1,0,5,2,5,1,1,1,0,1,2,46.33
Medicine,Chemist,3.450224050675816,3,0,3,1,5,0,4,3,2,4,3,4,0,1,Science,Bachelors,31-35,5,0,0,Hybrid,Tier2_City,4,5,4,3,5,1,3,42.3,Healthcare,4,3,5,1,1,3,4,1,5,2,0,1,2,3,61.95
Physics,Physical Chemist,2.5957501940474845,7,2,3,0,0,1,2,3,3,3,3,2,3,0,Science,Bachelors,36-40,4,0,0,Hybrid,Tier1_City,5,4,4,3,0,3,5,21.76,Education,3,3,2,3,1,5,2,3,4,4,0,1,2,1,57.03
Biology,Architect,4.555970843252998,4,1,4,1,5,0,2,1,1,3,2,0,3,0,Science,Masters,31-35,12,0,0,Remote,Tier3_City,3,2,5,3,5,3,4,41.76,Healthcare,4,3,5,4,5,3,2,3,3,1,1,0,2,1,55.62
Chemistry,Legal Secretary,3.071059257141456,8,0,0,1,0,0,3,0,0,2,1,0,4,0,Science,Masters,36-40,10,1,37,Remote,Tier2_City,5,4,5,1,0,3,3,42.71,Tech,3,1,3,4,2,0,5,5,2,4,1,0,3,3,50.04
Art,Software Developer,3.6314973148945136,9,2,0,1,3,1,1,0,3,1,1,1,2,1,Arts,Bachelors,31-35,3,0,0,Hybrid,Tier1_City,2,1,2,4,4,1,2,49.84,Tech,1,2,3,1,0,0,2,1,5,5,1,1,2,2,45.27
Law,Dentist,4.670683667496967,1,2,4,0,6,0,3,0,2,2,2,4,2,1,Arts,Bachelors,31-35,6,0,0,Remote,Tier3_City,4,3,4,2,0,4,3,48.01,Education,5,2,1,5,2,5,3,3,1,2,0,1,5,1,47.76
Art,Musician,2.507358777511952,6,1,1,0,1,1,0,4,0,3,4,1,0,1,Arts,PhD,25-30,12,1,26,Hybrid,Tier1_City,2,5,3,3,4,2,5,20.99,Tech,4,2,2,4,0,3,5,1,3,1,0,0,3,4,60.97
Marketing,Forensic Psychologist,4.245899798438625,5,1,0,1,8,1,4,2,2,0,1,3,1,1,Commerce,Masters,36-40,10,0,0,Hybrid,Tier1_City,3,1,5,3,5,1,4,12.32,Tech,4,3,4,4,3,3,2,3,4,3,0,1,3,4,64.88
Chemistry,Musician,2.7832636318973787,5,1,2,0,1,1,0,1,2,3,1,1,0,0,Science,Bachelors,31-35,10,0,0,Flexible,Tier1_City,3,3,3,1,2,0,1,16.75,Finance,4,4,2,5,4,4,3,3,1,4,1,0,3,3,49.57
Computer Science,Microbiologist,4.810953159326702,3,0,1,0,3,1,1,3,4,1,4,4,3,0,Science,Bachelors,25-30,5,1,33,Flexible,Tier1_City,1,1,4,2,1,5,4,26.25,Healthcare,5,3,5,2,1,0,4,3,2,1,0,1,3,1,50.38
Finance,Mechanical Engineer,4.068991456019191,7,0,1,1,2,0,4,2,2,4,0,3,1,1,Commerce,Masters,18-24,2,0,0,Flexible,Tier3_City,2,5,1,4,2,4,3,40.86,Other,1,3,3,5,5,0,1,2,5,5,1,1,4,2,61.2
Law,Biomedical Engineer,4.300242355280684,0,0,0,1,3,0,4,2,4,0,0,1,4,1,Arts,Bachelors,25-30,8,1,32,Flexible,Tier2_City,4,3,1,5,4,4,2,36.98,Tech,2,4,1,3,2,5,3,2,2,4,0,1,2,2,52.76
Music,Architect,3.606116078096836,8,2,1,0,0,0,3,1,4,3,4,0,0,0,Arts,Bachelors,25-30,14,0,0,Flexible,Tier2_City,5,5,3,1,3,2,5,40.02,Manufacturing,5,5,2,3,1,0,4,1,2,1,1,1,4,2,58.48
Art,Legal Secretary,3.431512298607577,9,1,1,1,6,1,4,2,4,2,4,3,0,1,Arts,Bachelors,25-30,4,1,22,Office,Tier2_City,1,3,3,4,3,4,3,20.86,Finance,1,1,5,1,0,2,4,3,4,5,0,0,5,1,64.73
Education,Legal Consultant,3.7822723590450695,4,0,2,0,2,1,3,4,0,3,1,1,2,1,Arts,Bachelors,18-24,12,1,42,Flexible,Tier2_City,4,4,4,5,2,2,1,14.6,Healthcare,3,5,1,2,1,1,4,1,3,4,1,0,5,4,59.38
Engineering,Actuary,3.5995234948937256,7,0,3,1,5,0,3,3,1,1,3,4,1,1,Science,Masters,25-30,9,0,0,Hybrid,Tier2_City,2,1,2,3,3,4,5,4.13,Finance,4,3,1,4,0,0,1,5,5,5,0,1,4,5,71.41
Chemistry,Analytical Chemist,3.628901257537531,3,0,0,0,4,0,3,0,2,3,3,3,3,0,Science,Bachelors,18-24,0,1,36,Office,Tier3_City,5,2,3,3,4,5,5,32.43,Manufacturing,4,2,1,1,2,2,2,3,4,1,0,1,5,2,46.02
Psychology,Biochemist,3.90115631919012,1,0,2,1,5,1,1,0,2,2,3,2,0,1,Arts,Masters,36-40,12,0,0,Remote,Tier2_City,4,2,4,2,5,2,5,40.37,Other,2,2,3,1,5,5,2,3,3,1,1,1,4,4,52.55
Chemistry,Financial Advisor,3.555823311900583,2,2,3,0,9,1,3,4,1,0,2,3,0,1,Science,Bachelors,25-30,5,1,46,Office,Tier3_City,1,1,3,5,1,3,3,44.79,Healthcare,3,4,5,4,5,5,2,1,3,3,0,1,3,2,51.16
Psychology,Manager,2.841289321019965,8,2,1,1,9,0,3,3,4,2,1,0,0,1,Arts,High School,25-30,4,1,46,Flexible,Tier3_City,5,2,5,3,0,3,1,25.38,Education,1,3,1,4,4,1,3,1,1,5,0,1,3,5,47.02
Education,Digital Marketing Specialist,3.9662999579258766,5,1,2,0,6,1,4,0,0,1,1,1,2,1,Arts,Bachelors,18-24,9,0,0,Hybrid,Tier1_City,2,5,3,3,4,4,3,46.6,Education,3,4,3,5,3,1,1,5,4,4,0,0,1,3,58.41
Medicine,Artist,3.1923461795311203,7,2,1,0,4,1,0,1,4,3,0,4,3,0,Science,PhD,25-30,7,0,0,Remote,Tier2_City,5,2,4,2,4,4,5,12.51,Finance,3,4,3,3,3,0,5,5,4,4,1,1,3,3,66.11
Music,Financial Advisor,2.546480112043517,8,2,0,0,2,1,3,0,2,2,0,0,1,1,Arts,Masters,25-30,3,1,25,Hybrid,Tier3_City,2,1,4,4,0,2,5,27.18,Other,2,1,3,4,1,1,1,1,3,3,1,0,4,3,45.36
Psychology,Social Media Manager,4.030077832537677,7,0,1,1,7,1,1,3,3,2,3,1,1,0,Arts,Bachelors,36-40,11,0,0,Office,Tier3_City,3,4,0,3,0,2,2,13.05,Education,1,4,2,5,2,2,5,2,5,2,1,1,5,1,60.24
Psychology,Architect,3.241634146750521,7,1,1,0,8,0,3,0,3,0,4,4,4,1,Arts,Masters,31-35,0,0,0,Office,Tier1_City,3,1,2,1,1,5,4,11.84,Healthcare,2,3,3,3,2,0,4,4,1,3,1,0,4,3,45.86
Art,Cybersecurity Analyst,4.744084755395605,3,1,0,1,2,1,3,0,3,4,0,3,4,0,Arts,Masters,18-24,10,0,0,Hybrid,Tier1_City,2,1,5,1,1,1,3,47.81,Manufacturing,1,1,5,2,5,3,2,5,5,4,0,1,3,2,63.73
Finance,Pharmacist,3.8716229999494063,5,1,4,0,4,1,0,1,2,1,0,2,4,0,Commerce,PhD,31-35,1,0,0,Remote,Tier2_City,4,3,0,4,1,3,1,41.43,Manufacturing,5,2,4,2,3,3,5,4,2,5,1,0,1,5,40.97
Business,Zoologist,4.195789185285063,4,0,4,1,3,1,1,0,2,2,3,2,3,0,Commerce,Bachelors,18-24,7,1,42,Flexible,Tier1_City,1,2,0,5,3,1,5,3.55,Education,5,1,2,2,0,5,2,5,3,3,0,0,4,5,47.71
Finance,Animator,2.5389501009363795,7,1,2,0,4,0,4,1,4,1,3,3,2,0,Commerce,Masters,40+,9,0,0,Office,Tier1_City,3,2,0,2,4,1,3,15.62,Tech,4,3,1,4,3,3,1,5,2,5,1,0,4,1,71.74
Physics,Musician,4.450898166899219,6,0,2,1,7,1,1,0,0,0,4,2,1,0,Science,Bachelors,40+,7,0,0,Remote,Tier1_City,4,3,0,1,5,0,4,12.64,Tech,2,5,3,3,5,2,2,5,5,2,0,0,3,5,53.13
Engineering,Actuary,4.217977759367508,1,0,2,1,0,1,3,0,1,3,0,2,2,1,Science,Bachelors,25-30,12,1,54,Office,Tier1_City,5,5,5,1,0,2,3,9.92,Other,5,1,2,3,1,2,2,5,1,4,1,0,2,3,47.56
Architecture,Architectural Technologist,4.144553970157308,8,0,3,1,9,1,4,4,0,0,4,4,4,1,Interdisciplinary,PhD,31-35,13,0,0,Hybrid,Tier1_City,3,5,0,4,4,0,4,35.78,Tech,3,5,2,2,3,5,3,2,3,2,0,0,3,1,70.51
Music,Doctor,3.568054560254408,2,1,2,0,6,1,1,1,3,2,1,4,0,0,Arts,Bachelors,36-40,4,0,0,Hybrid,Tier3_City,4,3,5,5,4,0,3,29.64,Education,3,1,5,1,0,1,5,2,3,5,1,0,3,3,50.09
Biology,School Psychologist,4.7996351817968685,0,2,0,0,0,0,2,1,0,2,3,1,2,1,Science,Bachelors,31-35,5,1,15,Flexible,Tier1_City,1,2,3,5,1,1,2,24.33,Education,5,1,1,3,5,5,3,4,1,2,1,1,1,1,38.67
Engineering,Nuclear Physicist,4.471728148764962,7,0,1,1,6,0,1,2,4,1,4,1,4,0,Science,Bachelors,31-35,1,1,49,Flexible,Tier2_City,5,5,0,4,1,0,3,11.91,Education,2,4,4,3,1,2,1,1,4,1,0,0,5,3,40.87
Education,Chemist,3.492545363263288,7,0,1,1,7,0,1,1,0,4,1,2,3,1,Arts,Masters,40+,10,1,23,Hybrid,Tier2_City,3,5,4,1,4,5,2,16.05,Healthcare,4,5,4,5,0,5,4,4,5,5,0,1,2,2,64.39
Psychology,Game Developer,4.736126451971089,0,0,4,0,1,0,1,4,4,0,4,2,4,0,Arts,Masters,25-30,11,0,0,Remote,Tier3_City,3,4,5,2,1,2,4,19.74,Tech,3,5,2,2,4,0,4,2,3,3,1,0,2,3,66.69
Law,Biologist,2.6271927770075805,1,2,1,0,8,0,2,4,1,0,0,1,1,1,Arts,Bachelors,31-35,8,0,0,Remote,Tier1_City,1,5,2,1,3,1,5,39.92,Finance,4,1,2,1,1,4,2,2,3,5,1,1,5,5,52.79
Architecture,Physicist,4.832251209478814,9,1,0,1,8,1,2,2,4,4,1,3,1,1,Interdisciplinary,PhD,36-40,14,0,0,Flexible,Tier1_City,2,2,1,5,0,2,5,49.49,Other,3,3,1,5,0,3,4,3,2,3,0,0,5,4,68.7
Chemistry,Biologist,4.122295513036972,4,2,0,0,3,1,0,0,0,4,1,2,0,0,Science,High School,31-35,5,0,0,Flexible,Any,3,4,1,1,4,5,3,11.65,Healthcare,1,3,2,1,3,5,3,3,2,2,0,1,3,1,32.01
Business,Quantum Physicist,2.65422731622503,0,0,2,0,1,1,0,0,4,1,3,1,3,0,Commerce,Bachelors,31-35,11,0,0,Hybrid,Tier3_City,2,4,3,2,0,4,1,19.05,Other,5,5,3,1,4,1,2,5,1,4,1,1,5,1,49.14
Psychology,Physical Chemist,3.425241074602093,5,0,4,1,2,0,3,0,4,4,4,0,3,1,Arts,PhD,18-24,8,0,0,Hybrid,Tier2_City,1,2,5,3,3,0,3,16.17,Other,2,4,4,1,0,1,2,3,1,1,0,1,2,1,55.95
Medicine,Marketing Specialist,3.214901765533052,6,0,4,1,5,0,4,3,2,2,4,1,0,1,Science,Bachelors,25-30,10,0,0,Hybrid,Tier1_City,1,3,0,1,1,1,2,5.07,Healthcare,3,4,3,4,5,3,5,1,4,2,1,1,1,4,64.46
Marketing,Legal Secretary,4.47732014273592,3,0,0,1,7,0,0,0,4,4,0,0,1,0,Commerce,Bachelors,18-24,9,0,0,Flexible,Tier1_City,4,1,4,4,2,3,2,13.3,Education,5,3,5,3,3,3,2,4,3,5,1,1,4,3,55.49
Biology,Cybersecurity Analyst,3.702972852443656,4,2,1,1,3,0,0,3,1,3,2,1,1,1,Science,Bachelors,25-30,2,0,0,Hybrid,Tier1_City,3,5,1,3,3,2,4,45.38,Education,4,4,2,3,4,0,4,4,5,4,0,1,5,1,49.29
Chemistry,Industrial-Organizational Psychologist,3.954183212004261,3,0,3,0,7,1,4,2,1,0,3,1,2,1,Science,Masters,25-30,5,0,0,Hybrid,Tier1_City,5,3,0,4,2,5,3,42.61,Healthcare,2,1,1,5,2,1,5,2,4,3,0,0,5,1,58.4
Chemistry,Entrepreneur,2.722873576096996,9,0,1,1,9,0,4,1,2,1,4,4,3,0,Science,Bachelors,40+,9,0,0,Office,Tier1_City,5,1,1,4,0,0,4,10.88,Education,2,1,5,1,2,5,3,4,5,5,1,1,2,3,63.61
Engineering,Biotechnologist,3.8929621089942392,0,1,1,1,4,0,0,3,3,1,4,0,3,1,Science,PhD,31-35,4,0,0,Remote,Tier1_City,1,2,1,4,4,2,1,20.21,Tech,5,5,5,1,4,3,4,1,5,2,1,1,3,4,53.91
Computer Science,Chemical Engineer,2.788265640478313,8,2,3,1,3,0,4,1,1,0,2,3,0,1,Science,Masters,31-35,8,0,0,Remote,Tier1_City,5,5,0,1,1,5,5,17.61,Healthcare,5,2,1,3,0,5,4,3,3,2,0,1,1,5,53.51
Physics,Organic Chemist,3.717235998677584,1,1,4,0,5,0,2,4,4,0,3,1,2,0,Science,Bachelors,25-30,12,1,53,Hybrid,Tier3_City,5,3,2,5,3,2,5,9.94,Other,5,3,5,1,0,2,4,3,1,4,0,0,2,5,59.5
Education,Nuclear Physicist,3.542534393773007,1,2,0,0,7,1,1,0,2,2,0,4,1,1,Arts,Masters,36-40,9,1,43,Office,Tier3_City,5,1,2,3,1,4,3,32.24,Healthcare,1,3,3,1,1,1,3,1,1,5,1,1,1,2,50.05
Finance,Graphic Designer,4.767253462230793,5,2,1,1,8,0,1,1,2,3,2,3,2,1,Commerce,Bachelors,31-35,14,1,8,Office,Tier1_City,4,2,3,2,2,5,4,29.19,Healthcare,1,2,5,1,0,2,5,3,1,5,0,1,5,1,56.02
Education,Microbiologist,4.7229070673516,9,1,4,1,5,0,3,0,3,2,3,2,1,1,Arts,Bachelors,31-35,0,0,0,Hybrid,Any,4,4,4,5,2,2,4,23.07,Education,2,4,1,2,0,3,5,5,5,3,1,1,4,1,44.93
Chemistry,Animator,3.7307296733579056,3,1,1,1,9,1,0,2,2,2,1,4,3,0,Science,Masters,25-30,8,0,0,Remote,Tier3_City,1,4,0,1,5,4,1,43.21,Healthcare,5,1,4,2,2,0,4,4,4,2,0,0,1,4,58.18
Finance,Art Director,4.376165405422903,0,1,3,1,3,1,0,3,3,0,4,1,4,0,Commerce,PhD,25-30,4,0,0,Hybrid,Tier1_City,5,4,1,4,4,4,4,32.13,Finance,1,1,2,2,2,1,2,3,1,1,0,1,4,2,50.21
Business,Ecologist,4.838530999404956,6,0,3,1,1,1,0,0,3,0,3,0,3,1,Commerce,Bachelors,31-35,0,1,19,Remote,Tier1_City,1,2,2,2,2,4,2,15.19,Finance,2,3,1,5,0,1,2,4,3,2,1,0,2,1,34.26
Biology,Financial Analyst,4.278232715935988,4,1,1,1,7,1,4,0,4,2,0,3,1,1,Science,Bachelors,25-30,9,0,0,Remote,Tier1_City,1,1,4,3,4,0,2,20.56,Tech,3,3,3,1,3,5,4,1,2,1,0,1,1,4,48.93
Chemistry,Biochemist,3.2882286650957537,2,0,0,0,3,1,4,0,2,0,1,3,0,0,Science,Bachelors,36-40,7,0,0,Hybrid,Tier3_City,1,2,5,5,5,5,2,10.06,Healthcare,5,4,3,2,2,3,2,3,2,4,1,1,2,4,53.74
Business,Paralegal,3.8999938312994953,0,1,0,0,2,0,4,4,2,2,4,0,1,0,Commerce,Bachelors,36-40,6,0,0,Flexible,Tier1_City,4,4,4,5,3,2,3,30.79,Healthcare,1,4,4,2,5,2,3,5,4,4,1,1,5,3,63.97
Biology,Dentist,4.457036404931892,3,1,1,1,6,1,3,1,2,4,1,3,0,0,Science,Bachelors,40+,13,0,0,Office,Tier1_City,4,2,0,2,5,2,2,30.57,Other,2,3,3,4,5,5,5,5,2,2,1,0,5,5,58.68
Finance,Fluid Mechanics Engineer,3.8165891644138967,4,2,0,1,1,1,4,1,4,0,0,4,4,0,Commerce,Bachelors,31-35,5,1,52,Office,Tier2_City,3,5,0,1,4,5,2,43.9,Education,5,4,1,5,5,4,3,1,2,2,1,1,1,2,50.82
Education,Analytical Chemist,3.6944081086644274,7,2,2,1,8,0,2,1,3,1,3,0,2,0,Arts,Masters,40+,1,0,0,Office,Tier3_City,5,1,0,3,2,4,5,43.22,Other,2,2,3,2,0,5,4,5,2,1,1,0,4,5,37.56
Music,Special Education Teacher,4.420587854007296,4,0,2,0,6,0,4,0,2,3,2,1,2,0,Arts,Bachelors,36-40,4,0,0,Flexible,Tier1_City,2,5,2,2,0,2,3,42.34,Manufacturing,3,1,4,2,2,3,2,1,2,2,1,0,2,1,39.47
Psychology,Financial Controller,3.137108710874257,4,1,0,0,1,1,0,3,3,2,1,0,2,1,Arts,Bachelors,25-30,2,0,0,Office,Tier2_City,4,4,3,4,4,2,2,28.8,Other,2,3,4,2,0,5,4,5,2,4,0,1,2,1,40.25
Finance,Cybersecurity Analyst,2.714315003723299,8,1,4,1,0,0,4,3,3,1,0,1,2,1,Commerce,Masters,25-30,1,0,0,Hybrid,Tier1_City,2,1,3,3,1,4,1,33.64,Manufacturing,2,2,5,4,4,2,3,3,1,4,0,1,3,5,45.21
Finance,Actuary,4.482010085930534,2,2,1,0,2,0,2,0,1,0,2,4,1,0,Commerce,Masters,18-24,13,1,13,Hybrid,Tier2_City,5,5,3,5,0,3,2,39.45,Healthcare,3,2,5,4,2,5,5,4,5,3,1,0,2,2,59.09
Chemistry,Electrical Engineer,4.071136752133779,7,0,4,1,7,1,2,0,1,1,1,1,4,1,Science,Bachelors,18-24,9,0,0,Remote,Tier1_City,5,2,4,2,4,3,3,7.31,Tech,4,5,3,5,0,2,1,4,3,1,1,1,1,5,45.4
Music,Biomedical Engineer,3.3650205137410527,3,0,3,0,9,1,2,2,3,0,2,4,1,0,Arts,Bachelors,18-24,0,1,37,Hybrid,Tier2_City,4,3,4,5,1,4,4,17.13,Finance,5,3,3,1,2,5,4,2,3,5,1,0,3,1,45.0
Biology,Financial Analyst,4.539158383513009,9,2,1,1,7,1,2,1,1,0,1,0,2,1,Science,Masters,18-24,8,0,0,Flexible,Tier2_City,2,2,2,5,5,0,5,10.95,Healthcare,3,5,3,1,3,4,4,4,3,2,0,0,2,5,47.41
Business,Special Education Teacher,3.7314220141599153,2,0,4,1,0,0,4,0,2,3,3,4,1,1,Commerce,Bachelors,31-35,1,0,0,Hybrid,Tier1_City,1,4,0,5,0,2,5,27.04,Healthcare,3,2,3,5,4,1,4,5,2,4,0,1,2,4,49.04
Physics,Ecologist,2.9216804046246074,2,2,3,0,8,0,3,3,3,0,3,1,0,0,Science,Bachelors,25-30,12,1,48,Remote,Tier1_City,1,3,0,1,4,2,3,42.37,Tech,5,3,5,1,0,0,4,2,4,1,0,1,1,3,60.11
Law,Legal Analyst,4.422572082820892,0,1,1,0,3,1,3,4,2,3,3,1,0,0,Arts,Masters,25-30,10,1,46,Hybrid,Tier1_City,4,1,1,5,3,3,2,13.84,Tech,2,5,1,3,4,4,5,2,5,3,1,0,2,4,74.38
Computer Science,Chemist,2.864955501316356,4,0,0,0,1,0,1,0,3,3,3,4,2,0,Science,High School,31-35,0,0,0,Hybrid,Tier1_City,2,3,1,4,5,4,1,37.35,Manufacturing,1,1,1,1,0,3,5,3,3,1,1,1,1,2,39.24
Marketing,Doctor,3.781846777881706,5,2,3,1,0,1,0,3,1,3,3,3,4,1,Commerce,Bachelors,36-40,13,0,0,Flexible,Tier1_City,4,1,1,4,1,5,2,22.07,Healthcare,5,3,1,4,4,2,3,3,3,2,0,1,3,3,54.13
Law,Animator,2.672925024416914,6,2,2,1,4,0,2,0,4,3,3,3,4,1,Arts,High School,40+,6,0,0,Remote,Tier1_City,1,5,4,3,3,5,2,45.44,Healthcare,3,5,5,4,4,5,1,3,1,5,1,1,2,1,56.88
Physics,Dentist,4.028213564779171,2,2,3,1,3,0,1,4,1,2,3,2,0,1,Science,Bachelors,31-35,8,0,0,Office,Tier1_City,5,5,3,5,2,0,1,32.46,Education,2,4,1,2,1,4,4,5,3,1,0,1,3,5,51.16
Computer Science,Software Developer,2.543840971635978,6,1,4,1,9,1,4,4,4,2,3,0,1,0,Science,Bachelors,25-30,5,0,0,Office,Tier1_City,4,5,2,5,5,4,5,48.9,Finance,4,3,1,4,0,2,3,5,5,2,0,1,5,5,63.48
Law,Cybersecurity Analyst,3.179589717938664,1,2,0,1,1,1,3,2,2,0,1,1,4,0,Arts,PhD,25-30,7,0,0,Flexible,Any,1,5,3,2,5,3,2,14.55,Education,2,4,5,3,2,1,5,5,4,3,0,1,2,5,63.52
Engineering,Manager,3.175355834206805,0,2,3,0,4,1,0,0,1,4,1,3,3,1,Science,Bachelors,18-24,14,0,0,Hybrid,Any,5,5,0,1,4,3,4,46.43,Education,1,3,2,3,2,5,2,4,1,1,1,1,3,5,43.51
Chemistry,Urban Planner,3.824978173725141,0,1,2,1,0,0,3,0,2,1,3,0,0,1,Science,Bachelors,18-24,10,1,35,Flexible,Tier1_City,4,3,1,3,4,2,4,19.78,Finance,2,5,3,3,2,2,5,1,5,2,0,0,4,1,59.07
Music,Aerospace Engineer,3.887735591517229,7,0,3,0,3,1,1,4,4,3,3,3,1,0,Arts,Bachelors,25-30,6,0,0,Remote,Tier2_City,4,1,3,5,1,1,3,32.23,Healthcare,1,5,3,2,4,0,5,3,3,1,1,0,4,5,52.0
Medicine,Zoologist,3.187258670231467,4,0,1,0,9,0,1,3,0,2,3,1,0,0,Science,PhD,40+,8,1,57,Remote,Any,1,5,0,2,5,0,3,11.2,Manufacturing,4,3,2,1,3,5,2,2,1,1,1,0,1,2,51.47
Law,Financial Advisor,3.535839451504562,3,0,4,0,9,1,4,3,2,0,4,4,3,0,Arts,Bachelors,18-24,6,1,37,Hybrid,Tier2_City,1,5,1,1,4,0,1,38.71,Finance,4,2,4,2,2,3,2,2,4,3,1,0,4,4,60.66
Finance,Animator,4.794729965164304,9,2,0,0,9,0,3,3,2,2,2,0,4,1,Commerce,Bachelors,18-24,12,1,58,Hybrid,Tier3_City,5,1,3,3,2,1,1,48.98,Tech,2,5,1,4,5,1,3,2,5,1,1,0,3,5,58.89
Engineering,Social Media Manager,2.9269102529136384,6,1,3,1,8,1,1,2,1,4,1,4,2,0,Science,Masters,18-24,5,1,32,Hybrid,Tier3_City,3,3,3,3,4,5,3,40.01,Healthcare,5,3,2,3,4,2,1,1,4,3,0,1,2,2,56.83
Marketing,Legal Analyst,3.74278559860224,8,2,3,0,5,0,0,0,3,1,0,2,1,0,Commerce,Bachelors,31-35,0,1,26,Remote,Any,5,5,3,5,5,5,2,31.94,Finance,5,3,1,2,5,0,1,5,4,1,0,1,1,3,33.75
Physics,Biochemist,4.6401290076535,0,1,1,0,6,1,3,0,3,0,0,0,1,0,Science,Bachelors,25-30,8,1,29,Hybrid,Tier1_City,4,3,5,3,0,5,5,24.07,Finance,5,1,2,2,5,0,5,5,2,4,1,1,1,2,40.96
Marketing,Nurse,4.931053998185909,5,0,1,1,3,1,4,3,1,2,3,3,0,0,Commerce,Bachelors,25-30,9,0,0,Hybrid,Tier1_City,4,5,5,2,3,3,4,19.23,Other,4,4,3,3,2,3,2,5,5,5,0,1,5,3,67.35
Finance,Biochemist,4.552273986793223,6,2,3,1,2,0,2,1,0,4,1,4,1,0,Commerce,Bachelors,18-24,4,0,0,Hybrid,Tier1_City,4,3,1,3,5,4,1,22.69,Finance,1,1,1,5,1,1,5,2,3,5,0,1,1,3,57.45
Law,Principal,4.835688834675329,9,2,4,1,9,0,1,4,1,0,2,1,1,1,Arts,Bachelors,25-30,12,1,21,Remote,Tier2_City,1,4,4,4,2,0,3,18.43,Manufacturing,3,4,5,3,4,3,1,1,1,4,0,0,5,5,49.07
Psychology,Financial Controller,2.933353177623032,1,1,4,1,6,1,3,0,2,2,3,4,4,1,Arts,Masters,18-24,1,0,0,Flexible,Tier2_City,4,5,1,2,5,1,4,42.14,Education,2,4,3,5,0,3,1,4,5,5,0,0,4,4,64.75
Music,Physicist,4.7985739284121305,1,1,0,1,8,1,0,3,0,4,4,1,0,1,Arts,Bachelors,25-30,14,0,0,Hybrid,Tier1_City,4,5,2,1,2,2,1,44.98,Education,1,1,3,3,4,0,4,1,5,3,0,0,4,4,57.4
Business,Physical Chemist,3.4258143778901005,4,0,0,1,5,1,3,4,1,0,0,2,1,1,Commerce,Masters,18-24,13,1,13,Remote,Tier1_City,5,2,5,1,5,2,1,47.63,Other,3,2,3,1,5,4,1,1,1,2,1,0,4,4,53.39
Art,Surgeon,3.3776024187118,6,2,2,1,4,0,2,3,0,3,0,1,4,1,Arts,Bachelors,31-35,11,0,0,Office,Tier3_City,1,2,1,5,3,3,2,22.66,Finance,4,3,1,5,1,2,4,3,5,3,1,1,1,1,59.88
Business,Investment Banker,2.8299793007675427,5,1,3,1,8,1,3,1,1,2,3,4,0,0,Commerce,Bachelors,25-30,10,1,9,Hybrid,Tier1_City,5,3,3,5,3,0,1,28.67,Finance,3,5,4,5,0,1,5,4,5,2,0,1,3,3,66.17
Computer Science,Pharmacist,4.352878036803177,3,2,4,0,6,1,2,1,1,1,3,2,0,1,Science,Bachelors,31-35,7,0,0,Hybrid,Tier2_City,3,2,0,4,2,4,5,30.11,Education,4,3,2,2,2,4,3,1,1,3,1,1,5,2,47.1
Law,Data Scientist,3.5457882865646573,8,2,1,1,3,1,1,4,4,4,0,2,3,1,Arts,PhD,25-30,12,0,0,Hybrid,Tier3_City,5,3,0,1,5,0,1,33.6,Manufacturing,4,1,2,5,4,3,1,4,5,3,1,1,5,5,79.01
Medicine,Quantum Physicist,3.879054764083504,9,2,2,0,1,1,1,4,1,2,2,2,3,1,Science,Bachelors,25-30,3,0,0,Flexible,Tier2_City,5,5,3,1,3,5,5,3.12,Healthcare,1,2,5,4,1,1,4,1,1,2,1,0,1,3,39.87
Education,School Counselor,4.315565572229399,2,1,3,1,0,1,2,1,3,0,4,2,0,1,Arts,Masters,18-24,13,1,58,Flexible,Tier1_City,3,5,4,1,1,2,2,42.61,Education,5,5,4,2,0,3,3,4,1,4,0,1,3,4,58.47
Business,Principal,2.957397379219757,7,2,0,0,2,0,1,1,1,4,2,2,1,0,Commerce,Bachelors,25-30,2,0,0,Remote,Any,5,4,4,1,5,0,5,15.6,Finance,5,5,3,2,5,5,3,4,3,4,0,1,1,1,44.04
Computer Science,Marketing Specialist,4.167484702306281,4,1,1,0,1,1,4,1,4,2,3,3,0,1,Science,Bachelors,25-30,12,1,44,Remote,Tier1_City,4,4,1,3,3,2,4,25.19,Manufacturing,1,2,2,1,3,1,5,4,5,4,1,1,5,3,67.87
Computer Science,Art Therapist,3.7509467701622494,2,2,3,0,3,0,4,1,4,4,4,0,4,1,Science,Bachelors,25-30,0,0,0,Remote,Tier3_City,4,2,1,2,0,1,1,42.55,Manufacturing,2,5,1,2,4,1,2,3,3,4,1,1,3,4,49.26
Computer Science,Curriculum Developer,2.847604831507856,3,2,1,1,9,1,4,2,3,4,2,1,4,1,Science,Bachelors,31-35,4,0,0,Hybrid,Tier3_City,2,5,0,2,0,1,3,49.85,Other,4,5,3,2,5,2,3,5,3,3,0,1,4,1,48.48
Biology,Financial Advisor,2.758919374505844,8,0,1,1,2,0,1,0,3,3,1,2,4,1,Science,Bachelors,36-40,2,0,0,Remote,Tier2_City,1,3,3,4,1,2,3,40.36,Finance,2,2,3,4,4,0,5,1,3,3,1,0,4,1,41.16
Computer Science,Legal Secretary,2.902724209501733,5,1,3,1,3,0,3,1,1,3,1,1,1,0,Science,Bachelors,31-35,14,0,0,Office,Tier2_City,4,2,3,3,3,4,5,4.17,Tech,4,1,4,2,5,2,2,3,2,1,1,0,4,2,48.92
Biology,Curriculum Developer,3.39789359190636,5,0,2,0,3,1,1,3,2,1,4,3,3,1,Science,Masters,18-24,3,0,0,Hybrid,Tier1_City,1,4,1,1,0,4,2,20.33,Manufacturing,4,1,4,5,2,2,3,1,4,5,0,0,2,5,61.06
Chemistry,Game Developer,4.241660207421199,0,2,3,1,3,0,3,3,2,3,0,0,0,1,Science,High School,31-35,14,0,0,Hybrid,Tier3_City,5,1,2,1,5,0,5,14.62,Education,5,5,2,1,3,4,5,1,5,1,0,0,2,1,52.2
Music,Social Media Manager,4.64984416982696,5,0,2,0,3,0,2,3,3,1,2,2,2,1,Arts,Masters,18-24,8,0,0,Hybrid,Tier1_City,2,3,5,5,4,2,5,48.31,Tech,5,1,2,4,2,2,5,2,3,5,1,1,4,2,66.33
Computer Science,Risk Analyst,2.9220234345660896,8,2,1,0,1,0,4,4,4,1,2,3,4,0,Science,Bachelors,31-35,10,0,0,Flexible,Tier2_City,4,1,1,5,3,3,5,15.42,Other,4,1,3,3,3,1,4,2,2,5,1,0,5,5,66.2
Music,Animator,4.5344234289560585,7,2,1,1,7,1,4,4,3,4,3,1,1,1,Arts,Bachelors,25-30,13,1,7,Remote,Tier1_City,5,2,5,4,1,4,4,47.34,Healthcare,5,5,5,3,0,3,5,3,2,3,0,1,3,4,66.62
Law,Principal,4.149032127754477,0,0,1,1,6,1,2,2,0,1,3,1,2,0,Arts,Masters,18-24,6,0,0,Office,Any,2,2,1,1,3,4,4,47.06,Education,5,5,3,3,0,4,3,1,5,4,0,1,5,3,60.49
Physics,Market Research Analyst,4.674977143783332,5,1,1,0,9,1,0,2,0,2,1,1,3,1,Science,Bachelors,36-40,10,0,0,Office,Any,5,1,4,4,2,5,5,42.45,Other,3,1,1,4,5,1,3,3,5,2,0,0,2,4,50.12
Engineering,Microbiologist,4.143087409541101,2,2,2,0,4,1,2,1,1,0,0,2,4,1,Science,Bachelors,31-35,4,0,0,Hybrid,Tier3_City,1,2,5,3,2,1,2,7.61,Other,3,4,5,3,4,5,1,5,4,3,0,1,3,3,40.07
Finance,Artist,3.456801499865638,2,2,2,0,7,0,3,3,0,2,4,2,0,0,Commerce,Masters,25-30,7,1,35,Hybrid,Tier2_City,5,2,1,2,0,4,1,3.09,Other,4,2,2,5,4,3,3,5,4,2,1,0,3,4,57.22
Law,Acoustics Specialist,3.269962698141598,6,0,0,0,4,0,0,4,2,2,1,0,3,1,Arts,Masters,18-24,5,1,59,Remote,Tier1_City,5,5,1,1,2,4,3,40.31,Finance,5,1,5,3,5,3,2,2,2,1,0,1,1,1,43.6
Computer Science,Art Therapist,2.946429132204281,4,2,1,1,3,0,4,2,3,4,3,3,2,0,Science,Bachelors,25-30,9,1,48,Office,Tier2_City,5,3,2,3,1,5,4,42.64,Tech,3,1,5,3,0,4,1,2,1,4,1,0,4,1,62.38
Computer Science,Software Developer,2.976752677842628,3,2,2,1,2,1,1,4,4,4,4,3,3,0,Science,Bachelors,36-40,1,0,0,Office,Tier3_City,2,4,0,1,0,4,1,48.22,Other,2,4,2,1,3,2,5,3,3,1,1,1,5,5,45.78
Chemistry,Manager,2.856547721902284,2,0,0,0,3,1,2,2,2,0,1,4,0,1,Science,Masters,25-30,6,1,43,Remote,Tier2_City,5,5,0,5,1,5,4,13.26,Other,4,3,1,3,2,4,1,5,5,4,1,1,3,4,58.63
Computer Science,Artist,4.878866579436938,9,1,4,1,1,0,1,1,4,4,1,0,1,0,Science,Bachelors,40+,0,1,16,Hybrid,Tier2_City,2,2,1,4,5,2,4,37.46,Other,4,3,1,3,0,4,2,5,5,3,0,0,3,2,49.62
Physics,Interior Designer,2.5307534379272023,1,2,2,0,5,1,1,2,1,2,0,1,1,0,Science,Masters,18-24,2,1,38,Remote,Tier3_City,2,4,3,5,1,2,4,27.4,Education,2,2,4,2,0,5,1,3,4,2,1,1,1,4,40.09
Architecture,Geneticist,4.235209922161729,1,2,0,0,0,0,1,1,3,0,2,0,4,1,Interdisciplinary,Bachelors,25-30,11,0,0,Hybrid,Tier1_City,3,2,1,2,2,1,5,18.44,Other,4,5,4,5,1,4,2,5,3,4,1,0,4,4,56.62
Law,Artist,3.4223234394982454,7,2,0,1,9,1,4,4,0,4,2,4,3,0,Arts,Bachelors,31-35,0,1,8,Office,Any,5,3,4,5,5,0,5,31.5,Manufacturing,5,1,1,4,4,5,5,2,5,5,0,0,4,3,61.69
Engineering,Marketing Manager,4.197721204364146,8,0,1,0,8,0,0,3,3,3,0,1,0,1,Science,Masters,25-30,13,0,0,Office,Tier2_City,4,2,2,1,2,5,4,28.77,Finance,3,4,1,1,3,3,1,3,4,3,1,0,2,1,57.45
Music,Psychologist,2.964900937178605,8,2,0,0,2,0,1,3,2,1,1,0,3,0,Arts,Bachelors,18-24,14,0,0,Hybrid,Tier1_City,2,1,1,5,1,4,4,16.74,Tech,1,5,4,4,2,2,3,4,1,3,1,1,5,2,44.25
Finance,Market Research Analyst,4.375519103434431,9,1,4,1,2,0,0,3,2,1,0,3,1,0,Commerce,Bachelors,25-30,0,0,0,Remote,Tier3_City,5,1,0,1,2,0,3,15.62,Manufacturing,3,5,4,3,1,5,3,4,3,4,0,0,5,5,38.17
Chemistry,Teacher,4.041916774747632,2,1,3,0,8,1,1,3,2,2,3,1,4,1,Science,Bachelors,31-35,14,0,0,Office,Any,4,1,1,2,2,2,1,25.87,Other,2,3,1,2,1,5,2,4,3,4,1,0,1,1,59.82
Architecture,Biomedical Engineer,3.866180190090168,7,1,2,0,4,0,4,0,0,0,4,1,2,0,Interdisciplinary,Masters,31-35,4,0,0,Hybrid,Tier2_City,1,1,5,5,2,4,1,25.28,Finance,1,1,2,3,5,0,2,5,4,1,0,0,1,1,47.56
Chemistry,Electrical Engineer,4.7771045085945865,6,2,4,1,8,0,1,2,1,0,0,3,1,0,Science,Masters,31-35,5,0,0,Remote,Tier2_City,4,4,2,4,3,0,2,17.2,Finance,5,2,1,3,0,3,2,2,4,3,0,0,1,3,49.48
Marketing,Physicist,2.583238346281869,2,2,2,1,9,0,1,1,4,1,1,2,1,0,Commerce,Bachelors,31-35,11,1,25,Hybrid,Tier3_City,2,1,2,4,5,5,2,15.4,Tech,5,4,2,1,4,4,5,2,2,5,1,1,4,2,55.39
Architecture,Credit Analyst,4.031719366748382,3,1,2,1,8,1,1,1,2,3,4,2,4,0,Interdisciplinary,Bachelors,31-35,2,0,0,Remote,Any,2,2,3,4,5,5,2,47.85,Tech,3,1,2,1,0,5,2,5,5,2,1,1,3,3,52.15
Medicine,Microbiologist,3.04369476579781,3,2,1,0,0,1,0,1,1,2,3,0,0,0,Science,Masters,18-24,13,0,0,Office,Any,2,5,3,5,5,0,5,43.53,Tech,4,5,2,4,1,3,3,2,1,5,1,0,3,4,59.16
Psychology,Lawyer,3.739427606720173,7,0,2,0,2,1,0,0,0,3,1,0,4,1,Arts,Masters,25-30,2,0,0,Remote,Tier1_City,3,2,3,5,1,5,5,41.39,Education,4,5,4,3,1,1,3,3,4,2,0,0,3,2,38.05
Architecture,Dentist,3.721454967158324,9,0,2,1,3,0,4,2,1,0,2,2,3,1,Interdisciplinary,Masters,31-35,2,1,16,Hybrid,Tier2_City,4,2,1,5,4,3,3,13.07,Finance,2,2,3,4,2,2,2,3,2,1,1,1,5,1,43.65
Physics,Game Developer,3.385295881044611,6,0,2,0,9,0,0,2,1,1,0,4,4,1,Science,Bachelors,40+,0,0,0,Remote,Tier3_City,5,2,0,1,1,2,5,11.9,Other,4,3,1,3,0,0,4,5,5,4,0,1,3,1,40.42
Education,Paralegal,4.590401851067344,4,1,3,1,3,0,1,2,3,1,1,4,0,0,Arts,Masters,18-24,4,0,0,Office,Tier2_City,5,2,4,2,5,1,2,41.04,Healthcare,5,2,5,1,0,2,2,2,3,2,1,1,5,2,52.16
Biology,Market Research Analyst,2.5186019733457288,5,1,3,1,8,1,4,3,4,0,3,0,3,0,Science,Masters,25-30,0,1,13,Hybrid,Tier2_City,2,5,0,4,0,1,4,11.68,Manufacturing,1,2,5,2,3,1,4,5,3,5,0,1,2,2,50.83
Architecture,Zoologist,3.868224064290632,5,0,0,0,0,1,2,2,3,3,0,4,0,1,Interdisciplinary,High School,25-30,9,0,0,Office,Tier2_City,4,1,2,1,2,3,2,26.67,Tech,3,1,1,4,2,0,1,2,2,4,0,1,2,5,53.87
Computer Science,Civil Engineer,4.998260105182285,9,1,1,0,5,1,0,4,4,3,1,4,2,1,Science,Bachelors,18-24,9,0,0,Hybrid,Tier1_City,1,3,0,4,2,0,3,13.41,Finance,3,3,2,4,4,3,1,2,1,5,0,0,3,3,60.51
Biology,Ecologist,2.700140973624852,2,1,3,1,5,0,2,0,0,1,2,1,4,0,Science,Bachelors,25-30,2,0,0,Remote,Tier1_City,4,4,1,1,4,5,4,20.77,Other,3,5,4,5,0,0,3,3,5,1,1,1,2,2,41.49
Psychology,Illustrator,4.177740161720341,1,1,2,0,5,1,1,0,3,3,4,3,1,1,Arts,Masters,31-35,12,0,0,Remote,Tier1_City,5,5,3,5,0,3,5,43.11,Manufacturing,4,3,4,5,0,4,1,3,2,1,0,1,1,4,57.3
Law,Paralegal,4.380704980980868,6,1,2,0,9,0,3,0,4,3,0,3,3,1,Arts,Bachelors,18-24,5,0,0,Flexible,Tier2_City,2,5,0,4,3,3,4,44.9,Healthcare,1,1,2,2,4,1,1,3,3,5,0,0,2,4,53.49
Business,Human Resources Specialist,4.454548366245682,0,1,1,1,5,0,0,3,1,2,2,0,0,0,Commerce,Masters,31-35,10,0,0,Hybrid,Tier1_City,4,5,2,5,1,5,3,49.84,Manufacturing,4,1,1,5,2,5,1,1,4,5,0,1,1,1,61.54
Business,Entrepreneur,3.842387210960452,8,1,4,1,3,0,2,0,0,0,2,0,4,0,Commerce,PhD,36-40,5,1,49,Hybrid,Any,3,4,2,4,3,2,5,47.36,Healthcare,4,2,5,2,0,4,5,5,3,5,1,1,2,3,47.58
Education,Psychologist,2.8855105400218486,5,0,4,1,8,0,3,4,0,0,1,2,4,0,Arts,Masters,40+,2,0,0,Flexible,Tier1_City,2,2,4,3,0,5,1,34.55,Other,5,1,4,3,4,1,5,4,1,2,0,0,3,3,39.85
Music,Mechanical Engineer,3.769018760221224,5,2,4,0,1,1,3,0,0,4,3,3,0,1,Arts,PhD,18-24,8,0,0,Remote,Tier1_City,3,4,0,1,4,5,2,23.29,Tech,5,3,2,5,3,3,2,2,3,3,0,1,3,3,69.35
Business,Interior Designer,4.199790240423444,7,0,4,0,3,0,0,2,3,3,1,1,0,0,Commerce,PhD,25-30,7,1,19,Office,Any,2,5,1,3,0,4,2,5.71,Education,4,2,4,5,0,3,4,1,1,3,1,1,1,1,55.57
Law,Analytical Chemist,4.632710028838487,5,1,0,0,3,1,3,0,3,0,0,2,2,1,Arts,High School,25-30,10,0,0,Remote,Tier2_City,5,2,2,1,4,0,3,31.58,Healthcare,2,2,2,4,4,4,3,3,3,3,0,0,2,5,52.79
Physics,Financial Advisor,4.241595419237538,0,1,3,1,1,1,3,4,1,0,4,0,2,1,Science,Masters,25-30,2,0,0,Remote,Tier1_City,1,5,4,2,3,1,3,12.9,Tech,2,2,4,2,1,1,5,5,3,2,0,0,1,4,49.4
Marketing,Electrical Engineer,2.960429725790937,5,0,0,0,3,1,0,1,0,1,0,1,0,1,Commerce,Bachelors,25-30,4,0,0,Remote,Any,4,3,5,4,3,1,2,42.96,Manufacturing,2,3,5,4,0,1,5,2,1,3,1,0,1,3,34.28
Finance,Mechanical Engineer,4.964793190453772,7,0,3,0,0,1,2,0,2,1,3,0,3,0,Commerce,Masters,31-35,4,0,0,Office,Tier3_City,4,1,2,2,0,3,4,28.8,Other,4,2,4,5,3,3,3,2,1,3,1,0,4,2,41.21
Medicine,Urban Planner,4.073854195521709,8,0,1,0,1,0,3,0,2,2,1,2,2,0,Science,Bachelors,18-24,14,0,0,Hybrid,Tier2_City,2,1,4,2,0,3,1,37.47,Manufacturing,1,4,1,3,4,2,5,1,1,3,0,1,4,3,46.73
Computer Science,Music Therapist,2.949231541877701,4,2,3,1,5,0,3,2,4,1,2,0,2,1,Science,PhD,40+,13,1,56,Remote,Any,1,5,2,1,2,3,1,34.65,Manufacturing,2,4,3,1,4,4,3,3,3,5,0,0,1,1,69.67
Education,Digital Marketing Specialist,3.7979183006666553,4,2,1,0,3,0,3,4,0,0,1,2,3,1,Arts,Masters,36-40,4,0,0,Remote,Tier1_City,1,2,1,3,4,0,3,19.32,Other,5,3,2,2,0,4,2,4,1,2,0,1,5,3,42.92
Business,Chemical Engineer,3.454596152550593,0,0,3,1,5,0,1,4,0,1,4,4,0,1,Commerce,Masters,31-35,2,0,0,Remote,Tier1_City,5,3,1,5,2,3,3,38.68,Other,3,5,3,2,1,1,2,2,5,5,1,0,3,4,59.58
Engineering,Manager,4.493637080116927,7,2,3,0,2,1,3,4,0,3,3,4,1,0,Science,Bachelors,31-35,4,1,41,Flexible,Tier3_City,3,3,2,1,1,3,4,42.64,Education,3,5,5,3,4,5,1,3,4,5,1,1,3,4,57.12
Physics,Legal Secretary,4.5341960268949535,9,1,4,0,3,0,2,4,2,0,0,2,3,1,Science,Bachelors,25-30,4,1,49,Hybrid,Tier1_City,4,2,5,5,1,4,3,37.97,Finance,4,2,5,3,4,0,3,1,2,4,1,0,3,5,40.96
Psychology,Civil Engineer,3.621770494687966,6,1,3,1,0,0,1,1,4,3,1,0,4,1,Arts,Masters,31-35,3,0,0,Flexible,Any,2,2,5,2,0,0,1,39.51,Healthcare,3,3,3,2,1,5,3,5,3,2,1,1,3,1,42.13
Medicine,Electrical Engineer,3.825237464195855,5,0,0,0,5,0,0,1,2,4,0,4,1,0,Science,High School,25-30,3,1,22,Office,Tier1_City,1,3,3,5,3,2,2,19.92,Other,4,2,5,2,3,3,2,5,1,1,1,1,4,1,30.46
Art,Biomedical Engineer,4.917084751273949,7,1,0,0,1,1,1,3,2,0,2,0,3,0,Arts,Masters,36-40,1,0,0,Office,Tier1_City,4,1,1,3,1,2,1,47.35,Finance,3,2,5,3,0,5,5,1,1,2,1,1,4,4,36.7
Computer Science,Biomedical Engineer,4.753886079693446,9,0,1,1,8,1,1,3,2,4,4,1,3,1,Science,High School,18-24,8,0,0,Remote,Tier2_City,4,1,1,1,1,5,4,22.95,Manufacturing,1,4,2,3,5,3,3,4,5,3,1,1,1,5,59.92
Psychology,Interior Designer,4.910908183015516,1,1,3,0,1,0,4,1,1,4,3,4,3,1,Arts,Masters,25-30,14,0,0,Remote,Tier2_City,4,3,4,3,2,4,2,45.16,Education,1,1,2,3,0,5,3,5,3,1,1,1,5,3,64.76
Medicine,Zoologist,4.519150508887067,1,2,0,1,6,0,1,3,3,4,2,2,0,0,Science,Bachelors,25-30,6,0,0,Hybrid,Tier1_City,1,4,4,3,2,1,2,43.32,Tech,1,3,2,5,0,2,5,1,2,5,0,1,1,3,56.38
Chemistry,Web Developer,3.006285705461891,2,1,0,1,3,1,3,3,0,1,0,4,2,1,Science,Masters,25-30,0,0,0,Hybrid,Tier1_City,5,3,0,1,1,5,1,8.84,Education,1,1,1,2,2,0,2,5,3,2,1,0,5,4,36.34
Engineering,Legal Analyst,3.4990851642931804,2,1,4,1,3,1,1,0,2,0,0,0,2,0,Science,Masters,25-30,4,0,0,Hybrid,Any,4,5,0,3,0,2,2,48.41,Other,2,4,1,2,0,0,3,1,4,3,1,1,2,1,39.92
Marketing,Dentist,3.222987043311892,9,1,4,0,0,1,4,1,1,3,4,3,0,0,Commerce,Bachelors,25-30,1,0,0,Remote,Any,1,4,1,4,2,0,2,49.83,Finance,5,1,1,3,5,0,3,5,3,1,1,1,5,5,47.98
Art,Landscape Architect,4.238431647389625,4,0,3,1,6,0,2,4,0,2,4,2,0,0,Arts,Bachelors,36-40,9,0,0,Flexible,Tier1_City,1,2,5,4,1,1,3,31.49,Manufacturing,1,4,1,4,1,2,5,4,2,4,0,1,5,5,60.69
Art,Electrical Engineer,2.798564599380988,4,2,4,0,5,0,4,2,3,4,2,2,3,1,Arts,Bachelors,25-30,5,0,0,Remote,Tier2_City,2,3,1,4,3,3,2,39.81,Healthcare,2,5,3,1,0,3,1,1,4,4,1,0,3,5,61.31
Music,Marketing Specialist,4.807046707646997,2,0,0,1,5,0,4,1,1,1,0,2,0,1,Arts,Masters,25-30,6,1,28,Remote,Tier2_City,5,3,2,5,2,0,4,46.88,Education,4,4,2,2,5,0,5,4,4,2,0,1,5,3,46.77
Engineering,Education Administrator,4.719748023831608,6,1,4,0,0,0,1,2,0,2,3,2,0,1,Science,Bachelors,18-24,11,1,27,Office,Any,5,4,3,3,1,1,2,3.94,Finance,3,3,5,5,3,3,5,4,2,4,0,1,5,5,54.54
Architecture,Artist,4.82811738844231,2,1,4,0,4,0,0,3,1,1,1,1,2,1,Interdisciplinary,Masters,25-30,1,0,0,Remote,Tier2_City,5,3,2,1,4,2,3,46.71,Finance,3,5,4,1,2,3,1,2,5,3,0,0,5,2,43.27
Education,Illustrator,2.679930097061244,9,2,2,1,6,1,1,4,2,4,3,3,1,0,Arts,Bachelors,25-30,10,1,17,Remote,Tier3_City,1,5,5,1,2,5,5,32.49,Tech,2,2,1,4,1,2,3,1,1,1,1,0,3,1,53.51
Finance,Credit Analyst,2.604515259708044,3,2,2,0,2,1,4,1,2,1,2,3,2,0,Commerce,Bachelors,31-35,5,0,0,Remote,Any,1,1,5,5,4,3,5,41.94,Healthcare,3,3,5,5,1,3,1,4,5,2,1,1,3,3,60.05
Computer Science,Financial Advisor,3.5882268196025,0,2,2,1,8,1,1,2,4,4,4,3,0,0,Science,Bachelors,18-24,14,0,0,Remote,Tier2_City,5,3,1,1,2,3,4,28.41,Finance,1,3,2,3,3,1,4,2,4,3,1,1,1,4,69.33
Medicine,Financial Controller,4.392534210949414,2,1,3,1,8,1,0,3,1,4,3,2,4,1,Science,High School,18-24,12,0,0,Remote,Tier1_City,1,1,4,4,2,0,4,27.94,Healthcare,3,3,3,4,0,3,1,2,2,2,1,1,4,4,48.9
Education,Human Resources Specialist,3.184486834155317,0,0,1,1,0,0,2,3,4,2,4,1,3,0,Arts,Bachelors,25-30,2,0,0,Remote,Tier2_City,5,2,0,3,5,5,2,45.18,Manufacturing,1,1,5,3,5,1,2,4,5,4,0,1,3,5,61.58
Marketing,Brand Manager,4.745499741061838,3,2,0,1,1,1,4,2,3,1,1,1,1,1,Commerce,PhD,25-30,8,1,27,Hybrid,Any,2,2,5,1,5,3,2,26.85,Other,1,1,4,5,2,0,3,3,5,3,1,0,4,5,73.21
Architecture,Psychologist,4.3095502220198725,8,2,4,0,2,1,3,4,2,0,1,1,0,1,Interdisciplinary,Masters,25-30,14,1,23,Hybrid,Tier2_City,3,3,3,1,4,1,5,25.17,Education,3,2,5,5,5,5,4,1,1,4,0,0,3,1,63.62
Physics,Marketing Manager,2.8076608863082626,0,0,1,1,5,0,1,1,3,1,2,0,3,0,Science,Bachelors,31-35,3,0,0,Hybrid,Any,3,2,4,2,0,4,5,31.58,Finance,2,1,2,3,2,1,4,1,5,4,0,1,1,2,47.71
Art,Teacher,4.784648778862684,3,0,1,1,2,1,3,1,2,2,3,0,2,1,Arts,Masters,25-30,2,0,0,Hybrid,Any,3,3,1,2,1,2,1,27.37,Manufacturing,4,3,5,1,2,0,1,3,3,3,1,0,5,4,47.04
Art,Social Media Manager,3.0728639890808296,9,0,0,1,7,0,1,4,0,1,0,3,0,1,Arts,Masters,25-30,12,0,0,Remote,Tier1_City,3,1,3,2,0,0,5,23.98,Tech,2,4,3,2,1,5,4,1,2,1,0,0,2,3,46.63
Marketing,Chemical Engineer,4.340830766173937,9,0,4,0,8,0,2,2,2,3,4,3,3,0,Commerce,Bachelors,31-35,10,0,0,Remote,Tier2_City,2,4,5,3,0,5,5,11.48,Healthcare,5,2,2,2,3,1,3,4,5,5,0,0,3,3,65.35
Psychology,Psychologist,4.6535473121528055,3,0,3,1,7,1,1,2,4,2,0,4,0,1,Arts,High School,18-24,2,1,44,Flexible,Tier2_City,1,3,3,4,5,4,4,21.68,Other,5,2,1,5,1,1,3,2,1,1,0,1,1,3,37.65
Engineering,Financial Analyst,2.815282402534085,6,1,2,1,5,1,1,2,1,3,0,2,2,1,Science,Bachelors,31-35,1,0,0,Hybrid,Tier1_City,2,4,0,4,1,4,1,16.26,Manufacturing,1,3,2,4,0,0,5,2,4,1,0,0,2,1,36.28
Computer Science,Zoologist,2.640251913261841,5,2,0,0,1,0,0,4,3,2,4,3,1,0,Science,Bachelors,25-30,11,0,0,Remote,Tier2_City,4,1,3,4,5,0,1,21.82,Healthcare,1,5,5,3,4,2,5,3,3,1,0,1,2,5,60.62
Psychology,Judge,4.410364846944557,4,1,4,0,3,0,2,4,0,4,4,4,1,1,Arts,PhD,25-30,8,1,10,Flexible,Tier1_City,1,1,1,3,5,1,2,30.88,Other,2,1,4,4,2,3,2,4,3,2,0,0,5,2,72.27
Music,Aerospace Engineer,3.7831044300678256,7,0,4,1,5,0,2,1,4,4,4,3,3,1,Arts,Masters,36-40,7,0,0,Office,Tier3_City,5,4,0,3,5,5,2,31.62,Healthcare,2,5,2,3,2,1,1,4,1,5,1,1,5,4,66.13
Finance,Animator,4.010894454622294,4,0,2,1,7,1,2,0,3,3,4,3,3,1,Commerce,Bachelors,18-24,4,1,53,Remote,Any,4,3,1,2,3,2,1,14.22,Finance,1,3,2,4,2,4,4,2,4,2,1,0,5,4,57.66
Education,Pharmacist,3.962608612503984,5,2,2,1,8,1,1,1,3,4,2,3,1,0,Arts,Bachelors,36-40,13,0,0,Flexible,Tier1_City,4,4,3,1,0,0,1,6.97,Healthcare,4,5,2,3,1,2,5,5,5,2,1,1,3,5,58.53
Psychology,Interior Designer,3.389752064040792,2,1,1,0,0,0,0,4,2,1,4,4,1,1,Arts,Masters,25-30,13,0,0,Hybrid,Tier2_City,2,3,5,5,0,5,2,37.99,Manufacturing,4,3,2,5,2,5,3,5,3,4,0,0,5,2,66.61
Psychology,Organic Chemist,3.7798455871002834,5,0,1,1,7,0,3,4,2,1,0,2,0,1,Arts,Masters,31-35,12,0,0,Flexible,Tier2_City,4,3,1,5,0,4,4,27.84,Tech,5,1,5,1,2,3,4,1,2,2,1,0,1,2,51.34
Architecture,Urban Planner,2.5198016315301057,4,1,2,1,4,0,0,1,2,0,4,3,1,0,Interdisciplinary,Masters,36-40,8,0,0,Remote,Tier3_City,2,4,4,1,3,4,4,23.78,Finance,4,1,1,2,4,2,1,1,3,1,0,1,5,1,53.04
Law,Legal Secretary,3.638636860493639,0,1,2,1,2,1,4,1,4,0,1,3,2,0,Arts,Masters,36-40,12,1,57,Remote,Tier2_City,4,1,3,2,2,0,4,9.09,Education,3,2,4,4,3,2,4,1,3,1,0,1,3,4,58.17
Law,Urban Planner,3.1547918240945623,2,0,3,1,1,0,0,3,0,3,3,2,0,0,Arts,High School,31-35,1,0,0,Office,Tier1_City,2,5,5,1,4,5,4,22.49,Tech,1,5,2,2,0,0,4,4,3,4,0,0,3,3,39.38
Business,Marketing Specialist,3.018785834867608,4,2,1,0,8,1,4,1,3,1,2,3,1,0,Commerce,Masters,31-35,5,1,13,Remote,Tier1_City,1,2,2,1,4,4,2,41.45,Manufacturing,2,5,4,4,5,4,2,2,3,5,1,1,4,5,64.69
Law,Market Research Analyst,3.9849180057102185,0,1,4,1,5,0,0,0,0,4,3,4,0,1,Arts,Masters,25-30,6,0,0,Remote,Tier1_City,4,5,2,5,3,0,3,30.33,Finance,1,5,5,5,1,3,1,4,4,3,1,0,2,5,54.53
Medicine,Animator,3.388567650744968,7,2,2,0,8,0,4,1,0,1,0,2,0,0,Science,Bachelors,25-30,5,1,43,Office,Any,2,1,4,2,0,0,5,7.28,Other,3,5,1,5,0,2,4,3,1,3,1,1,5,5,40.33
Medicine,Legal Consultant,3.3049611658617453,4,2,3,1,3,1,3,0,1,2,2,2,0,0,Science,Masters,18-24,14,1,25,Remote,Tier2_City,3,2,2,3,4,2,5,18.62,Other,4,4,2,4,3,0,3,2,3,5,0,0,2,1,66.43
Art,Legal Consultant,3.195362908516593,9,1,2,1,3,0,1,4,2,2,3,0,2,1,Arts,Bachelors,18-24,2,0,0,Flexible,Any,3,4,2,5,3,0,5,49.05,Healthcare,1,2,1,4,0,3,3,2,5,5,0,0,3,2,57.7
Psychology,Quantum Physicist,3.780934579946056,4,0,2,1,1,1,4,3,0,4,2,3,1,0,Arts,High School,36-40,9,0,0,Hybrid,Tier2_City,4,5,0,3,5,5,5,28.59,Tech,3,2,2,4,1,0,2,2,1,2,0,0,1,3,57.6
Biology,Animator,3.3338551455660106,5,1,3,1,8,1,3,1,4,4,3,4,1,0,Science,Bachelors,18-24,13,1,39,Flexible,Tier2_City,2,3,5,2,1,5,2,16.46,Finance,4,4,2,5,4,3,5,2,3,2,1,0,5,1,64.98
Engineering,Physician Assistant,3.571078065798421,5,2,4,0,1,0,2,4,1,0,4,4,3,1,Science,Bachelors,18-24,9,0,0,Hybrid,Tier3_City,1,1,5,1,4,4,3,45.93,Education,5,5,3,1,0,2,1,1,3,2,1,1,2,5,58.68
Education,Art Therapist,3.4750654757953607,1,0,3,1,4,1,0,0,4,0,2,4,4,1,Arts,Bachelors,31-35,9,1,6,Hybrid,Tier3_City,4,1,1,4,1,3,2,18.79,Education,5,4,4,1,3,1,4,2,2,1,0,1,4,1,41.5
Business,Paralegal,4.541982834067879,6,1,2,0,9,0,0,0,0,4,2,4,0,1,Commerce,Bachelors,18-24,8,0,0,Hybrid,Tier1_City,1,1,5,4,0,2,3,37.31,Education,5,5,1,4,1,5,2,4,4,5,0,1,3,3,56.16
Education,Forensic Psychologist,3.22889131449201,1,1,1,0,3,0,0,4,2,4,3,1,0,0,Arts,Bachelors,25-30,13,1,52,Office,Tier1_City,2,5,3,2,4,5,2,9.92,Other,3,4,4,3,3,5,3,2,1,5,1,0,1,4,60.08
Art,Teacher,4.302552944198839,4,0,4,1,5,0,4,2,1,4,1,4,4,1,Arts,Bachelors,25-30,14,0,0,Hybrid,Tier1_City,3,3,5,4,3,4,1,10.36,Finance,3,2,4,1,5,4,4,3,3,2,1,1,2,5,57.28
Law,Animator,2.9276954693202284,8,0,2,1,3,1,2,0,3,2,2,1,0,1,Arts,Bachelors,25-30,11,1,40,Remote,Tier3_City,2,5,2,3,2,4,3,29.38,Tech,2,4,4,5,0,5,3,5,1,5,0,1,1,2,54.02
Medicine,Judge,4.749731735281374,1,0,1,0,3,1,4,0,2,1,3,2,2,0,Science,High School,31-35,7,0,0,Remote,Tier3_City,1,3,3,4,4,2,5,14.27,Healthcare,2,3,1,5,1,1,4,4,4,1,1,1,3,4,52.15
Psychology,Construction Manager,4.894091445820949,1,2,2,0,0,1,0,4,0,2,0,4,4,0,Arts,Masters,25-30,14,1,57,Remote,Tier1_City,3,2,4,2,4,2,3,5.32,Tech,5,5,2,5,0,1,1,4,1,5,1,1,1,2,57.83
Education,Pharmacist,2.889848827206713,5,1,1,1,7,1,1,3,3,3,0,3,1,1,Arts,Bachelors,25-30,7,0,0,Hybrid,Tier1_City,4,4,2,2,4,4,4,46.54,Healthcare,1,4,2,2,5,2,3,4,2,3,1,1,1,2,52.4
Psychology,Education Administrator,4.693080856953094,6,2,0,0,8,0,3,2,0,4,4,4,0,0,Arts,Bachelors,31-35,7,0,0,Office,Tier2_City,3,1,0,3,4,3,3,5.63,Tech,4,5,2,2,2,0,2,1,1,1,0,0,4,4,52.23
Marketing,Architect,2.6412608288198305,9,2,3,1,7,0,0,0,3,1,0,2,3,0,Commerce,Masters,25-30,8,1,47,Remote,Tier2_City,4,3,3,4,3,1,4,36.72,Tech,2,1,2,5,1,4,2,3,1,2,0,0,2,5,46.71
Law,Risk Analyst,3.719395469248752,5,2,2,1,7,0,2,1,0,2,0,1,2,1,Arts,Masters,31-35,0,1,21,Remote,Tier2_City,4,5,4,4,3,4,4,18.65,Finance,4,5,2,1,5,1,2,2,2,4,0,0,2,3,34.05
Finance,Analytical Chemist,4.401469630149948,7,1,4,1,7,1,3,4,0,2,2,4,2,1,Commerce,Masters,36-40,7,1,11,Flexible,Any,3,5,0,1,2,2,1,46.87,Education,1,4,2,2,0,0,2,3,4,3,0,1,2,1,58.29
Business,Electrical Engineer,3.859356607477129,9,0,0,1,0,1,1,4,4,3,3,2,0,0,Commerce,Bachelors,25-30,1,0,0,Hybrid,Tier3_City,3,1,5,5,3,0,3,49.34,Education,5,5,5,3,1,4,5,2,5,1,1,0,2,2,53.28
Computer Science,Software Developer,2.74345706985291,5,2,1,1,2,1,0,1,2,2,1,2,2,1,Science,Bachelors,25-30,3,0,0,Flexible,Tier1_City,1,1,5,2,3,0,1,18.77,Education,4,3,5,4,4,2,4,1,4,4,0,1,2,2,49.2
Finance,Clinical Psychologist,3.639069580051852,0,2,0,1,0,1,3,1,0,1,1,3,3,0,Commerce,Masters,18-24,0,0,0,Flexible,Tier1_City,3,1,1,1,0,2,5,30.78,Education,5,3,2,2,5,5,4,5,3,1,0,1,3,3,33.45
Medicine,Nurse,4.053487994331821,1,0,2,0,6,1,0,1,1,3,2,2,1,1,Science,Bachelors,31-35,11,0,0,Remote,Tier1_City,5,2,4,2,0,2,3,39.33,Tech,4,4,1,2,2,4,4,1,3,3,1,1,3,3,48.32
Finance,Physician Assistant,3.332547492904232,1,2,1,1,7,0,1,2,4,4,4,3,2,1,Commerce,Bachelors,18-24,5,0,0,Flexible,Tier1_City,3,4,0,1,1,1,2,8.8,Education,1,4,4,1,3,5,5,3,2,5,1,0,4,2,59.45
Computer Science,Marketing Manager,2.6440721154813307,4,1,3,0,7,1,0,0,3,2,3,2,1,0,Science,Bachelors,25-30,9,0,0,Remote,Tier3_City,1,3,3,5,2,5,2,36.34,Tech,2,5,4,1,0,3,2,1,1,2,1,0,1,1,43.05
Education,Biomedical Engineer,2.7966407208155792,5,2,2,0,7,0,2,4,3,2,2,0,1,1,Arts,Masters,36-40,0,1,31,Flexible,Tier1_City,5,1,0,1,0,2,2,45.59,Healthcare,3,2,1,3,3,5,1,3,2,1,1,1,3,3,38.49
Marketing,Physical Chemist,3.88726131545412,5,1,2,0,8,1,2,4,1,0,1,4,1,1,Commerce,Bachelors,25-30,11,0,0,Hybrid,Tier2_City,5,3,4,2,2,0,4,11.39,Manufacturing,5,3,5,3,0,2,2,3,1,2,0,1,4,5,48.84
Biology,Geneticist,2.53201601319257,9,1,3,0,9,0,2,0,1,1,3,4,2,0,Science,PhD,25-30,4,1,23,Hybrid,Tier2_City,2,5,1,4,2,3,2,42.42,Manufacturing,2,3,4,3,1,1,5,3,3,1,0,1,3,5,48.01
Marketing,Industrial-Organizational Psychologist,2.992623561981788,8,0,1,0,6,1,0,0,4,4,0,1,2,1,Commerce,Masters,31-35,14,0,0,Office,Tier1_City,5,4,1,2,4,2,5,8.43,Healthcare,4,1,5,3,3,3,1,1,3,1,0,1,4,1,54.43
Biology,Landscape Architect,3.980227106060159,2,2,2,0,4,1,1,3,2,0,0,1,1,0,Science,Bachelors,25-30,8,1,57,Flexible,Tier1_City,4,4,4,3,5,1,3,29.71,Tech,2,1,3,2,2,0,5,5,1,4,1,1,2,1,47.26
Music,Special Education Teacher,3.2831250490392203,0,2,0,1,2,0,2,3,1,4,2,4,3,0,Arts,Masters,31-35,0,0,0,Hybrid,Tier3_City,1,3,5,3,5,3,3,18.95,Education,3,2,4,3,0,1,3,2,5,3,1,1,1,2,59.6
Computer Science,Fluid Mechanics Engineer,4.364895914446201,7,1,0,0,6,1,3,0,3,1,3,2,2,0,Science,Masters,31-35,8,1,43,Hybrid,Any,2,5,3,3,5,1,4,25.17,Finance,5,3,3,3,3,3,4,5,5,1,1,0,5,2,62.89
Marketing,Chemical Engineer,3.8627180286501073,4,0,4,0,3,0,0,2,3,0,3,4,2,1,Commerce,Masters,18-24,3,0,0,Remote,Tier1_City,3,5,1,3,2,3,4,17.13,Tech,5,4,3,5,0,5,4,2,3,4,0,1,3,3,51.55
Biology,Electrical Engineer,3.891554728060952,3,1,1,0,0,1,3,4,4,2,2,2,1,0,Science,Bachelors,36-40,2,1,9,Office,Tier2_City,5,2,2,5,4,2,4,15.25,Tech,2,3,3,2,4,5,5,1,4,3,1,0,1,2,52.79
Art,AI Researcher,3.192189660391992,0,2,0,0,7,1,1,2,2,1,0,0,0,0,Arts,Masters,18-24,7,0,0,Remote,Tier2_City,2,1,5,4,1,0,5,37.93,Healthcare,1,4,3,2,4,2,1,3,2,3,0,1,5,2,40.85
Law,Chemist,2.5657490812534234,6,1,0,0,4,1,0,0,3,0,0,0,1,0,Arts,Bachelors,40+,5,0,0,Office,Tier3_City,4,5,2,4,1,3,3,13.49,Healthcare,4,4,2,2,3,3,3,2,2,1,0,1,4,3,27.52
Finance,Mechanical Engineer,2.711602669550077,9,2,0,1,3,1,1,4,0,0,3,3,4,1,Commerce,PhD,18-24,6,0,0,Hybrid,Tier2_City,2,1,1,2,5,4,1,22.2,Finance,2,2,2,4,4,3,3,2,4,3,1,0,1,2,60.92
Biology,Education Administrator,3.166232490692314,5,1,0,0,4,1,4,2,0,2,0,3,0,0,Science,Bachelors,25-30,8,0,0,Hybrid,Any,4,1,3,1,1,5,4,15.9,Education,1,3,1,3,2,5,2,1,2,3,0,0,3,5,50.57
Business,Credit Analyst,4.032451271334965,7,2,3,0,4,1,2,1,3,1,0,3,4,0,Commerce,Bachelors,18-24,4,1,56,Hybrid,Tier1_City,2,3,3,2,4,1,2,14.22,Manufacturing,5,5,4,3,3,5,2,4,1,5,1,1,3,1,44.38
Chemistry,Ecologist,4.495936804391992,7,1,0,0,8,0,3,3,1,1,3,3,3,0,Science,Masters,18-24,12,0,0,Office,Tier1_City,2,1,3,2,5,3,1,32.47,Other,4,3,1,3,1,1,1,2,1,2,0,1,3,5,61.33
Psychology,Graphic Designer,3.411172467107728,3,1,0,1,0,0,4,3,4,3,4,2,1,1,Arts,Masters,31-35,1,1,9,Flexible,Tier3_City,3,3,3,2,4,1,1,5.14,Education,5,3,3,1,3,5,2,1,5,5,0,1,2,4,68.33
Finance,Pharmacist,4.2303153980039205,5,2,1,0,0,0,1,4,4,3,4,1,1,0,Commerce,Masters,31-35,2,0,0,Remote,Tier3_City,3,4,3,2,1,0,4,40.08,Education,3,1,1,1,1,3,4,5,1,3,1,1,3,5,49.33
Art,Architect,4.24259400453106,3,1,4,0,8,0,1,3,2,2,2,1,1,0,Arts,Bachelors,31-35,2,1,49,Flexible,Tier1_City,3,5,0,4,5,1,2,28.67,Other,1,2,2,1,4,4,5,4,4,5,1,0,3,4,47.47
Business,Doctor,3.0180435129278145,0,1,1,1,6,1,1,0,2,0,4,2,3,0,Commerce,Bachelors,25-30,3,1,39,Flexible,Tier2_City,2,3,1,1,4,1,4,41.94,Other,3,5,5,4,3,5,4,5,2,5,1,1,3,5,50.12
Music,Actuary,3.2871012865421534,4,2,0,0,4,1,2,0,2,4,3,4,3,0,Arts,PhD,25-30,9,0,0,Office,Tier1_City,5,2,4,2,3,4,4,13.01,Tech,3,5,5,3,2,1,3,3,1,4,0,1,3,2,65.43
Law,Doctor,4.582576133514106,0,1,3,1,2,1,2,2,3,0,1,4,3,0,Arts,Masters,31-35,6,0,0,Flexible,Any,2,3,5,4,3,1,2,36.34,Finance,3,5,5,2,4,4,3,3,2,2,0,0,3,4,50.44
Psychology,Ecologist,4.098952835905078,3,2,0,1,9,0,2,3,1,4,3,0,2,1,Arts,Masters,25-30,11,0,0,Office,Tier3_City,3,1,2,2,4,3,1,22.77,Tech,1,4,5,2,5,3,5,2,1,1,0,1,4,3,56.02
Computer Science,Urban Planner,4.024161607857881,7,1,1,0,4,1,4,1,2,0,3,4,4,0,Science,High School,31-35,9,0,0,Remote,Tier1_City,2,2,1,3,4,1,1,6.61,Healthcare,4,2,5,5,4,5,1,5,5,1,0,1,3,3,60.48
Physics,Quantum Physicist,4.589120439604738,6,0,1,1,8,1,0,0,0,2,0,1,0,1,Science,Bachelors,31-35,5,0,0,Hybrid,Tier2_City,5,1,2,2,0,2,2,38.37,Other,5,1,4,1,4,4,3,4,5,4,1,0,2,5,36.41
Physics,Pharmacist,4.971353395349581,4,1,4,0,1,1,4,1,1,0,4,3,4,0,Science,Masters,18-24,2,0,0,Office,Tier2_City,4,2,1,2,0,1,1,38.82,Manufacturing,4,4,3,4,1,2,1,5,1,1,0,1,3,5,39.32
Finance,Fluid Mechanics Engineer,2.701108235919295,7,1,0,0,0,1,4,2,1,2,4,4,0,0,Commerce,Masters,31-35,14,0,0,Flexible,Tier1_City,1,3,1,5,2,2,5,15.73,Finance,4,5,2,5,1,5,4,1,2,5,0,0,4,5,74.08
Finance,Data Scientist,4.336518328408544,6,1,3,0,6,1,0,4,3,2,4,4,0,1,Commerce,High School,31-35,13,0,0,Hybrid,Any,3,1,2,3,5,5,4,46.05,Finance,4,4,5,4,2,2,2,5,3,3,0,0,2,1,65.45
Marketing,Accountant,4.301632221562988,0,1,4,0,6,0,3,3,1,2,2,0,4,1,Commerce,Masters,31-35,6,0,0,Office,Tier1_City,2,3,3,1,2,1,5,38.91,Education,5,4,4,2,1,3,5,2,2,5,0,1,4,1,55.35
Law,Nurse,4.321660940857236,6,0,3,0,6,0,4,2,2,0,4,3,4,1,Arts,Bachelors,18-24,3,0,0,Office,Tier2_City,5,5,2,2,2,5,5,17.42,Tech,5,5,2,3,5,4,2,5,5,5,0,1,5,2,62.53
Chemistry,Marketing Manager,4.78910933660388,1,1,3,0,0,0,0,2,2,2,4,0,3,0,Science,Bachelors,25-30,9,0,0,Remote,Tier2_City,3,2,2,1,1,1,5,14.24,Education,1,5,5,2,0,3,1,1,5,4,1,1,1,5,55.23
Music,AI Researcher,3.880583319270004,9,2,1,0,7,1,3,0,3,4,2,3,0,0,Arts,Bachelors,25-30,10,0,0,Remote,Tier3_City,3,4,2,3,3,3,3,23.68,Education,2,1,3,2,0,2,1,4,5,2,0,0,5,1,61.2
Computer Science,Graphic Designer,3.283141195207396,2,1,3,1,5,0,0,2,0,2,3,2,0,0,Science,Bachelors,25-30,10,0,0,Office,Tier1_City,4,4,3,2,1,2,3,16.76,Finance,5,2,1,1,3,4,4,3,2,5,0,1,5,2,53.99
Finance,Mechanical Engineer,2.690508183356517,3,1,4,1,7,0,4,3,4,2,3,4,3,1,Commerce,Bachelors,18-24,7,0,0,Remote,Tier2_City,1,3,1,5,5,5,5,13.2,Manufacturing,5,3,3,2,5,2,4,1,3,4,1,0,2,3,70.79
Architecture,Psychologist,4.580334589829861,9,2,2,0,1,0,1,0,4,0,4,3,2,1,Interdisciplinary,Bachelors,36-40,14,1,27,Remote,Tier1_City,2,2,4,4,4,5,4,21.76,Healthcare,2,3,3,4,5,4,1,1,5,4,0,1,1,4,64.5
Physics,Forensic Psychologist,2.850216479844189,5,0,2,0,3,1,1,2,4,3,0,1,4,0,Science,Bachelors,31-35,6,0,0,Hybrid,Tier3_City,2,2,4,5,0,2,5,4.21,Education,5,3,5,3,5,5,4,3,3,3,1,1,1,2,46.31
Education,Judge,3.841770652735086,5,0,0,0,0,0,0,2,4,3,0,4,3,0,Arts,Masters,25-30,6,1,34,Office,Tier1_City,3,3,1,5,5,4,5,21.87,Other,4,1,1,1,4,1,5,5,1,4,1,0,5,4,54.27
Chemistry,Fluid Mechanics Engineer,3.2067271322125586,8,1,4,1,8,0,2,1,4,3,4,3,2,1,Science,Bachelors,18-24,8,0,0,Hybrid,Tier3_City,5,4,2,4,4,1,3,13.42,Manufacturing,5,4,1,5,0,3,3,2,2,5,1,1,1,4,68.69
Biology,Teacher,4.900881942822823,9,0,0,0,6,1,2,2,1,4,3,1,2,0,Science,Bachelors,36-40,7,0,0,Flexible,Tier2_City,3,5,1,4,5,1,5,15.42,Other,1,5,2,2,1,5,5,4,5,1,0,1,5,4,55.25
Law,Acoustics Specialist,3.390686265396233,6,1,2,0,3,1,0,2,3,1,0,0,4,1,Arts,Bachelors,18-24,11,0,0,Remote,Tier1_City,4,4,0,4,4,3,4,6.88,Education,5,2,4,1,2,5,1,5,1,1,0,0,1,1,37.78
Finance,Biomedical Engineer,2.7523299719257626,1,0,2,0,0,0,1,0,0,1,4,2,1,1,Commerce,Bachelors,31-35,0,0,0,Remote,Tier1_City,1,1,1,2,0,4,4,30.68,Manufacturing,2,3,2,1,1,4,3,3,4,5,1,0,4,2,38.42
Music,Judge,4.427563914474272,2,1,0,0,4,1,0,3,4,0,2,0,0,0,Arts,Masters,40+,6,1,9,Hybrid,Tier1_City,4,4,0,1,4,4,5,25.18,Tech,4,2,5,1,4,5,1,2,3,1,1,0,4,2,47.28
Psychology,Game Developer,3.8682337877983,6,2,0,1,3,0,4,1,0,2,1,1,1,1,Arts,Bachelors,31-35,14,0,0,Office,Any,5,1,5,1,2,3,4,38.28,Other,2,2,1,4,4,5,5,4,5,3,0,0,5,3,56.72
Chemistry,Lawyer,3.7009525852598304,4,0,2,1,3,1,2,1,3,1,3,0,1,1,Science,Masters,40+,2,1,10,Hybrid,Tier2_City,2,1,5,4,5,5,5,49.39,Healthcare,5,5,3,5,0,4,1,2,3,2,1,1,3,2,48.04
Physics,Advertising Manager,2.7706493481022147,3,1,2,0,2,0,3,2,1,3,3,2,1,1,Science,Masters,31-35,11,0,0,Remote,Any,5,5,4,5,0,2,3,8.62,Finance,5,1,3,1,0,1,4,3,1,4,1,0,5,5,57.77
Medicine,Clinical Psychologist,4.29361119170331,1,1,2,1,0,1,0,3,4,2,3,2,1,0,Science,Bachelors,18-24,3,0,0,Office,Tier1_City,4,5,4,3,4,5,5,15.8,Tech,1,5,4,4,1,0,1,2,5,2,1,1,4,3,53.08
Medicine,Brand Manager,2.541225069526977,1,2,3,1,7,1,1,0,1,2,3,2,4,0,Science,Bachelors,18-24,5,0,0,Office,Tier1_City,2,4,4,4,2,0,1,35.08,Education,4,1,5,5,3,1,5,4,2,1,1,0,2,3,39.77
Marketing,Lawyer,3.4139935347216364,9,0,2,1,9,0,3,2,2,0,2,4,1,0,Commerce,Bachelors,25-30,4,0,0,Remote,Any,1,3,2,5,2,3,3,14.15,Education,5,4,5,3,1,4,4,5,1,2,1,0,3,3,45.01
Education,Marketing Specialist,3.233555851935272,1,0,1,1,0,1,4,1,0,1,1,3,0,0,Arts,Bachelors,18-24,7,0,0,Remote,Tier3_City,3,4,0,5,3,2,4,4.42,Healthcare,1,2,2,4,5,5,3,3,4,3,0,0,1,3,53.94
Biology,Judge,4.07270534855812,2,0,2,1,7,1,1,1,1,2,0,4,2,1,Science,Masters,31-35,1,0,0,Hybrid,Tier3_City,1,5,0,2,2,5,4,8.16,Other,1,3,1,1,0,5,5,2,5,1,1,1,2,3,41.29
Architecture,Psychologist,2.699555954755137,8,1,4,1,4,1,1,0,3,2,2,4,3,0,Interdisciplinary,Masters,25-30,4,1,44,Remote,Any,3,1,0,2,1,5,3,23.38,Other,2,2,1,2,5,0,2,3,5,4,0,1,2,2,55.44
Finance,Nurse,2.925969991725564,6,1,3,1,2,0,4,4,0,2,4,0,1,1,Commerce,Bachelors,36-40,4,1,6,Hybrid,Any,1,1,1,1,0,4,1,23.25,Healthcare,4,5,4,4,3,5,2,4,1,5,0,0,1,2,47.8
Medicine,Paralegal,2.7979370105396297,9,2,2,1,9,0,0,0,2,3,3,2,1,0,Science,Bachelors,25-30,14,0,0,Remote,Tier1_City,2,3,2,1,0,3,3,48.7,Healthcare,3,1,3,3,5,2,5,4,3,3,1,1,5,1,52.04
Biology,Social Media Manager,4.701108774039915,1,2,2,0,4,1,0,0,0,1,4,0,4,1,Science,Bachelors,25-30,2,0,0,Remote,Tier1_City,2,4,5,3,0,0,2,24.9,Education,1,4,2,5,3,3,5,5,4,1,1,1,4,2,33.99
Music,Construction Manager,4.235219408981944,9,2,3,1,6,1,2,2,3,3,2,0,1,1,Arts,Masters,40+,13,0,0,Hybrid,Tier1_City,2,3,4,3,4,1,1,34.87,Education,3,4,4,3,0,0,2,4,4,3,1,1,3,1,66.83
Medicine,Market Research Analyst,3.785777307141045,7,0,1,0,3,0,2,1,0,0,0,2,4,1,Science,Bachelors,18-24,9,0,0,Remote,Tier3_City,3,3,5,3,5,3,3,26.13,Finance,2,1,1,5,1,2,2,5,5,5,0,1,4,1,58.58
Law,Marketing Specialist,4.548738219395792,6,1,4,0,6,1,3,3,3,4,4,4,3,0,Arts,Bachelors,31-35,14,1,59,Remote,Tier1_City,2,4,1,3,4,0,2,15.69,Healthcare,1,1,2,4,2,5,2,1,2,4,0,1,3,5,74.69
Psychology,Microbiologist,2.5823952093705667,2,1,2,0,4,0,2,4,0,0,1,2,3,1,Arts,Bachelors,31-35,14,0,0,Office,Tier2_City,5,2,2,5,1,0,5,7.96,Manufacturing,4,1,5,5,0,4,5,5,5,2,1,0,4,3,55.08
Computer Science,Construction Manager,4.13138015759863,8,2,0,1,0,0,1,2,3,3,4,0,1,0,Science,Masters,18-24,12,1,25,Remote,Any,3,4,4,5,5,3,1,43.38,Finance,3,4,3,1,1,0,4,2,2,3,1,0,4,5,62.51
Architecture,Acoustics Specialist,4.615603698585844,4,1,2,1,8,0,2,1,3,3,0,4,1,1,Interdisciplinary,Masters,25-30,4,1,14,Office,Tier2_City,2,3,0,1,2,2,5,10.18,Manufacturing,4,2,1,4,2,1,1,1,2,5,0,1,5,3,52.72
Marketing,Mechanical Engineer,3.6736652377431,6,0,1,1,8,1,1,3,0,1,4,1,2,0,Commerce,Bachelors,25-30,3,0,0,Office,Tier1_City,2,2,0,2,4,3,2,7.55,Tech,3,2,1,2,5,5,1,4,5,3,0,1,5,1,50.75
Medicine,Dentist,4.125858450190767,3,1,3,1,0,1,4,4,3,3,4,0,3,1,Science,Bachelors,31-35,10,0,0,Remote,Tier2_City,1,3,5,2,5,5,4,13.05,Healthcare,2,4,4,3,4,3,4,2,1,5,0,0,1,1,67.58
Computer Science,Financial Analyst,3.729904166604837,1,1,2,1,0,0,3,3,2,2,2,1,3,0,Science,PhD,31-35,4,0,0,Remote,Tier1_City,5,3,0,4,2,4,4,3.12,Finance,1,3,3,3,4,5,1,2,2,3,1,1,2,2,56.6
Computer Science,Illustrator,4.371631007583035,1,2,0,1,9,0,3,3,3,2,1,1,2,1,Science,Bachelors,25-30,9,0,0,Hybrid,Tier2_City,5,3,3,5,5,5,4,6.38,Other,1,5,1,4,4,1,4,2,1,5,1,0,5,4,60.84
Computer Science,Paralegal,3.430218969106897,9,2,1,1,2,0,3,0,4,1,0,3,4,0,Science,Masters,31-35,8,0,0,Hybrid,Tier1_City,3,1,0,3,2,0,5,32.85,Finance,2,4,1,2,2,1,4,4,1,2,1,1,3,3,52.27
Chemistry,Architect,4.375220378966897,2,2,3,1,3,0,4,0,4,1,4,1,4,0,Science,Bachelors,18-24,6,1,43,Hybrid,Tier1_City,5,4,4,3,5,0,1,14.45,Tech,5,3,1,4,3,3,1,4,1,3,1,0,3,4,54.83
Medicine,School Counselor,4.150558602326972,8,2,0,0,2,0,1,4,4,1,3,0,1,1,Science,Masters,31-35,0,0,0,Office,Tier3_City,2,5,1,4,4,1,5,18.91,Tech,3,5,4,1,4,1,1,2,4,2,0,1,4,1,50.67
Music,Biologist,3.17946720858048,8,1,2,1,8,1,3,2,3,4,1,0,2,1,Arts,Bachelors,36-40,2,1,7,Remote,Any,3,1,1,2,4,0,5,42.26,Tech,3,2,1,1,4,4,1,1,5,5,1,0,2,3,56.08
Computer Science,Biologist,3.799912987324293,5,2,2,1,1,0,4,4,2,2,1,1,0,1,Science,PhD,36-40,8,1,8,Hybrid,Any,4,4,3,3,1,1,4,39.33,Finance,5,1,4,2,3,1,3,2,3,3,1,1,4,1,63.1
Architecture,Sound Engineer,3.02275737941194,7,0,3,1,8,0,4,4,4,2,4,2,1,1,Interdisciplinary,Masters,31-35,3,1,19,Flexible,Tier1_City,1,1,3,2,3,0,5,26.14,Education,2,5,5,4,2,4,1,4,1,3,0,1,2,2,63.4
Psychology,Architectural Technologist,4.0199911949291485,1,0,2,1,5,0,3,0,2,0,0,0,4,0,Arts,Masters,25-30,3,0,0,Remote,Tier3_City,1,4,4,4,0,0,2,31.81,Manufacturing,4,1,5,2,2,1,5,4,4,5,1,1,4,1,44.32
Art,Psychologist,4.230233519165713,6,2,1,0,5,1,0,3,4,1,3,2,4,1,Arts,Masters,40+,9,1,40,Remote,Tier2_City,4,2,2,2,4,3,3,7.03,Other,4,3,5,2,3,5,5,5,2,2,0,0,2,4,57.1
Chemistry,Surgeon,3.300852738547274,2,1,2,0,1,1,0,2,4,0,3,2,4,0,Science,Masters,25-30,5,0,0,Hybrid,Tier3_City,3,5,3,2,4,3,3,38.79,Other,2,4,5,1,0,4,3,3,5,5,0,0,5,4,61.59
Computer Science,Acoustics Specialist,3.012701486221721,4,0,4,0,8,1,0,3,1,4,4,0,4,0,Science,Bachelors,31-35,2,0,0,Flexible,Tier3_City,4,2,5,2,2,4,3,27.26,Manufacturing,4,4,2,1,3,0,5,1,3,4,0,1,5,2,43.05
Finance,Physicist,2.541923332587686,2,1,1,0,8,1,0,4,4,0,2,2,2,1,Commerce,Masters,18-24,2,1,35,Remote,Any,5,2,3,3,3,5,4,29.83,Other,2,1,2,2,1,4,1,5,1,5,0,0,5,2,48.89
Education,Aerospace Engineer,2.897679387806658,4,2,4,1,2,1,0,4,1,3,2,4,2,0,Arts,PhD,40+,14,1,59,Hybrid,Tier1_City,2,4,4,1,4,2,4,34.28,Tech,3,5,5,2,1,5,3,3,4,2,0,1,5,1,69.12
Psychology,Principal,2.615719187223135,2,2,4,1,2,1,3,1,3,0,0,0,4,1,Arts,Bachelors,31-35,8,0,0,Remote,Tier3_City,4,3,5,5,5,4,3,26.51,Other,3,5,5,5,0,3,2,4,5,4,0,1,1,1,58.39
Psychology,Landscape Architect,4.540027144280082,3,1,4,0,4,0,1,2,0,2,3,1,0,0,Arts,PhD,31-35,12,1,56,Hybrid,Tier3_City,4,3,1,2,3,0,1,27.52,Education,5,3,3,1,5,1,2,3,3,4,1,0,3,4,60.46
Medicine,Conductor,3.6207756159925664,2,1,4,0,1,1,0,1,0,4,0,3,2,1,Science,Masters,18-24,4,0,0,Remote,Tier1_City,5,3,4,2,0,4,3,26.48,Education,2,4,1,2,0,5,4,4,5,4,0,1,5,2,46.27
Psychology,Doctor,4.393357644625225,6,1,2,0,3,0,3,3,0,1,4,3,1,0,Arts,Bachelors,31-35,13,0,0,Hybrid,Tier1_City,3,3,0,2,5,3,5,26.35,Tech,4,1,3,5,1,0,1,2,3,4,1,1,5,4,67.86
Computer Science,Pharmacist,3.585599334970814,2,2,1,1,4,0,1,3,2,3,4,0,1,1,Science,Bachelors,31-35,6,0,0,Hybrid,Tier1_City,2,5,2,1,2,5,3,38.26,Healthcare,2,2,3,2,3,1,4,1,3,3,1,1,1,2,50.27
Business,Surgeon,3.969389490821804,3,1,2,1,5,1,1,4,1,0,3,3,0,1,Commerce,Bachelors,31-35,4,0,0,Flexible,Any,2,2,3,4,1,0,3,23.08,Finance,1,4,3,5,2,5,2,4,5,1,1,0,3,5,50.43
Computer Science,Architect,2.8699027381651656,2,1,2,1,8,1,2,2,3,0,2,0,4,1,Science,High School,25-30,5,0,0,Office,Any,1,1,2,3,5,0,1,3.14,Healthcare,5,4,3,2,1,4,5,4,5,5,1,1,4,5,53.21
Psychology,Credit Analyst,4.821381206171344,4,1,0,1,6,1,1,4,1,1,1,0,0,1,Arts,Bachelors,25-30,7,0,0,Office,Tier2_City,2,5,4,1,0,4,4,31.77,Education,1,3,3,4,3,1,3,4,3,4,0,0,3,5,50.0
Architecture,Animator,4.582326282138724,4,1,1,1,2,0,0,3,1,4,2,1,4,0,Interdisciplinary,Bachelors,18-24,14,0,0,Remote,Tier2_City,2,4,1,2,5,5,4,47.78,Tech,5,4,3,1,5,5,2,3,2,3,0,0,2,2,56.04
Marketing,Architect,3.712692820607551,7,2,3,1,4,1,2,2,1,1,3,4,4,0,Commerce,Bachelors,25-30,7,0,0,Remote,Tier1_City,2,5,2,1,3,1,5,15.08,Finance,5,3,5,2,1,2,4,4,1,2,1,0,4,3,46.66
Medicine,Data Scientist,4.8040029358722265,1,0,0,1,3,1,3,4,4,2,3,4,0,1,Science,Bachelors,18-24,1,0,0,Hybrid,Tier3_City,2,5,3,1,3,2,3,41.36,Manufacturing,5,3,3,3,2,0,5,2,1,4,0,1,4,5,56.1
Computer Science,Animator,2.6891451841617915,6,1,3,0,9,1,0,1,2,3,1,1,4,1,Science,PhD,25-30,10,0,0,Hybrid,Tier1_City,5,4,0,1,0,5,2,24.41,Other,1,2,2,3,5,5,3,5,4,4,0,0,2,4,57.57
Biology,Construction Manager,4.826409537473808,5,0,1,0,7,0,4,2,1,3,2,3,2,0,Science,Bachelors,18-24,8,0,0,Hybrid,Tier2_City,1,1,2,4,3,4,5,33.22,Education,5,5,1,5,1,2,5,5,5,2,0,1,5,5,62.12
Business,Ecologist,3.062632513396266,0,0,3,0,4,0,3,1,3,3,2,1,2,1,Commerce,Bachelors,18-24,9,0,0,Remote,Any,4,2,4,5,5,4,4,44.87,Finance,2,4,2,1,1,1,2,5,3,1,0,0,3,4,56.21
Engineering,Composer,3.4499072001015927,7,2,2,1,8,0,1,3,3,1,0,0,0,0,Science,Bachelors,18-24,11,0,0,Hybrid,Tier2_City,1,5,5,3,1,2,1,39.24,Finance,2,3,4,5,2,4,5,4,3,1,0,0,2,1,45.61
Business,Construction Manager,2.9274983224873683,9,1,4,1,6,0,2,2,2,3,2,0,0,1,Commerce,High School,36-40,11,0,0,Remote,Tier2_City,3,4,4,4,5,0,4,44.57,Healthcare,1,3,2,1,4,0,5,2,3,3,0,1,3,2,53.58
Education,Investment Banker,4.498302752912411,7,2,3,1,7,1,1,4,4,3,3,4,4,1,Arts,Masters,25-30,11,0,0,Hybrid,Tier1_City,4,4,2,4,1,0,4,3.45,Manufacturing,3,5,4,3,1,5,4,3,1,2,1,1,4,1,64.88
Finance,Investment Banker,2.835783499785572,1,1,2,0,7,0,2,0,1,4,4,3,0,1,Commerce,Masters,25-30,13,0,0,Remote,Tier1_City,1,1,4,5,3,1,1,11.8,Healthcare,3,5,5,3,1,0,5,1,4,1,0,0,4,1,63.91
Law,Biotechnologist,4.487665497975453,1,0,2,1,3,0,0,0,0,3,1,4,0,0,Arts,Masters,25-30,5,1,28,Flexible,Tier2_City,1,5,5,4,5,4,3,22.9,Healthcare,1,3,4,5,1,4,3,3,4,4,1,1,5,5,56.82
Business,Counselor,4.191047153250423,3,0,4,0,7,0,1,3,2,2,3,1,2,0,Commerce,Bachelors,31-35,6,0,0,Remote,Tier1_City,1,4,2,1,3,2,3,42.85,Healthcare,5,4,3,4,0,0,2,4,3,4,0,1,5,4,52.98
Physics,Legal Consultant,4.707356619168289,7,2,3,1,4,1,1,2,1,0,1,3,4,0,Science,Masters,36-40,2,0,0,Flexible,Tier1_City,1,1,2,1,1,4,4,42.4,Healthcare,5,4,3,3,0,5,1,2,3,5,1,0,2,5,44.4
Medicine,Advertising Manager,4.007259693633571,4,1,4,1,4,0,0,0,0,4,4,1,0,1,Science,Bachelors,18-24,3,0,0,Flexible,Tier1_City,1,1,1,2,3,3,5,11.7,Education,5,4,3,1,2,4,5,1,3,5,1,1,3,2,46.47
Finance,Marketing Specialist,3.75799044135767,2,1,1,1,8,1,0,4,4,3,2,1,4,0,Commerce,Bachelors,25-30,5,0,0,Office,Tier2_City,1,4,4,4,4,4,2,9.69,Manufacturing,1,5,4,2,3,5,2,4,3,1,1,1,5,4,49.52
Chemistry,Marketing Specialist,4.611018373413804,9,1,2,1,2,1,2,0,2,1,0,0,0,0,Science,High School,40+,6,0,0,Flexible,Tier1_City,5,4,5,2,2,4,5,42.23,Healthcare,5,4,4,2,5,2,5,2,4,5,1,1,3,3,40.19
Architecture,Sound Engineer,3.918650251355493,6,0,0,1,1,0,2,1,0,0,4,4,2,0,Interdisciplinary,Bachelors,25-30,5,1,23,Remote,Tier2_City,5,5,1,3,5,3,5,28.45,Education,2,4,4,2,0,1,5,3,5,3,1,0,1,4,56.79
Medicine,Forensic Psychologist,4.907993036811094,4,1,4,1,8,1,3,0,4,2,3,3,1,1,Science,Bachelors,18-24,4,0,0,Hybrid,Tier2_City,4,5,5,1,4,3,4,32.46,Other,5,4,1,3,2,0,4,2,4,5,1,0,2,5,59.44
Engineering,Teacher,3.72975490940006,3,2,4,0,5,0,4,3,2,2,0,0,2,0,Science,Bachelors,18-24,13,0,0,Office,Tier1_City,2,2,4,3,3,2,4,41.03,Education,1,5,1,4,0,0,2,2,3,3,1,1,3,1,58.3
Education,Construction Manager,4.50601266951509,6,2,4,1,1,0,1,2,4,3,4,3,3,1,Arts,PhD,18-24,11,0,0,Remote,Tier1_City,1,4,1,5,3,0,2,12.95,Finance,5,1,1,3,5,0,3,3,2,4,1,0,5,1,71.25
Biology,Landscape Architect,3.984951228758609,2,2,4,0,7,1,2,1,2,1,2,2,4,0,Science,Bachelors,40+,1,0,0,Hybrid,Tier3_City,2,3,0,1,2,1,2,9.41,Finance,2,1,3,1,3,2,1,5,5,1,1,0,5,3,40.9
Music,Risk Analyst,3.488941240106354,4,2,1,0,8,0,1,0,4,0,3,2,2,1,Arts,Bachelors,25-30,11,1,18,Hybrid,Tier2_City,5,3,4,3,3,3,2,43.38,Tech,1,4,5,3,0,4,5,1,2,3,1,1,3,3,54.83
Law,Principal,3.074985288462271,2,0,2,1,8,1,1,1,3,3,2,2,0,1,Arts,Bachelors,36-40,14,0,0,Hybrid,Tier1_City,3,2,1,5,2,0,4,8.25,Education,3,1,2,3,4,5,2,3,1,1,1,1,4,2,48.47
Marketing,Web Developer,4.578608837702234,0,1,0,1,4,1,4,3,2,1,0,0,1,1,Commerce,Masters,40+,14,0,0,Flexible,Tier2_City,1,4,5,3,5,2,4,7.14,Tech,1,4,1,3,3,4,2,1,3,5,1,0,1,3,66.66
Marketing,Civil Engineer,4.817094243130571,1,1,3,1,7,0,0,0,0,0,4,2,4,0,Commerce,Bachelors,25-30,6,0,0,Hybrid,Tier1_City,4,1,0,5,1,5,5,16.02,Education,4,5,2,3,3,2,5,4,2,3,0,1,2,2,38.77
Music,Legal Analyst,3.274564279787083,1,1,2,0,8,1,4,3,2,2,0,2,4,0,Arts,Masters,18-24,4,0,0,Remote,Tier1_City,2,3,0,5,2,4,4,17.89,Healthcare,3,4,1,1,0,1,1,4,3,2,0,0,3,2,46.01
Finance,Music Therapist,3.7926314320641135,3,0,4,1,7,1,4,2,0,3,1,0,2,0,Commerce,PhD,18-24,11,0,0,Flexible,Tier2_City,4,5,5,1,2,2,3,14.33,Healthcare,3,2,4,3,5,5,5,5,3,5,0,1,5,2,63.12
Music,Acoustics Specialist,3.212074384405693,9,1,4,1,7,0,3,4,2,2,2,0,4,1,Arts,Bachelors,25-30,8,0,0,Remote,Tier1_City,1,3,0,2,4,2,3,37.86,Tech,1,3,4,4,0,2,1,5,1,1,1,0,2,4,48.03
Education,Animator,4.111864491394094,3,2,3,0,6,0,4,0,4,0,1,2,0,1,Arts,Bachelors,25-30,12,0,0,Flexible,Tier2_City,2,4,1,5,3,3,2,48.75,Healthcare,4,5,3,5,1,5,2,3,5,5,0,0,3,4,66.32
Computer Science,Digital Marketing Specialist,2.5248599329227246,2,0,1,0,9,1,1,3,4,3,0,0,1,1,Science,High School,31-35,10,0,0,Flexible,Tier1_City,2,3,0,5,5,1,4,12.38,Healthcare,3,2,3,1,1,0,5,3,3,4,1,0,5,1,57.04
Business,Art Therapist,4.606095376738818,7,2,2,1,1,1,2,1,3,3,4,4,0,1,Commerce,Masters,25-30,3,0,0,Flexible,Tier1_City,1,2,3,1,1,3,3,39.75,Finance,5,2,2,4,3,1,2,1,5,2,1,1,1,5,57.88
Medicine,Biomedical Engineer,3.951850184460496,4,0,2,1,1,1,2,1,0,3,3,4,0,1,Science,Bachelors,36-40,13,1,57,Office,Tier1_City,3,5,4,2,0,4,5,5.08,Healthcare,4,3,3,2,1,3,5,3,4,1,1,1,3,4,53.34
Business,Microbiologist,2.8398976561356992,4,0,3,1,3,1,4,4,4,0,1,0,3,0,Commerce,Bachelors,25-30,9,0,0,Office,Tier1_City,1,2,3,4,2,3,1,8.59,Finance,4,2,5,2,1,1,5,5,1,2,0,1,3,4,52.72
Architecture,School Psychologist,2.9242648430657145,9,2,4,0,1,0,2,3,2,4,3,1,2,1,Interdisciplinary,Bachelors,31-35,11,0,0,Office,Any,4,1,3,4,0,4,5,27.21,Manufacturing,1,3,5,1,1,5,3,5,4,2,1,1,2,5,58.6
Law,Inorganic Chemist,3.3920960922123524,1,2,1,0,1,0,0,2,4,0,3,1,3,0,Arts,Masters,36-40,1,1,58,Hybrid,Tier1_City,5,1,4,2,3,3,1,49.98,Education,1,4,5,5,5,2,4,5,1,2,0,0,2,1,41.13
Psychology,Urban Planner,3.1571232950592893,5,2,2,1,9,0,4,3,0,2,4,0,2,0,Arts,Bachelors,18-24,6,0,0,Remote,Any,5,1,3,3,2,5,5,47.62,Finance,1,5,3,3,4,5,5,1,2,1,0,0,5,2,46.94
Engineering,Legal Analyst,3.6052318214767096,0,1,4,1,8,1,0,1,4,3,4,1,3,0,Science,Bachelors,18-24,6,0,0,Remote,Any,5,1,0,1,0,1,3,8.26,Other,4,5,1,1,1,0,5,3,2,4,0,1,4,5,46.54
Marketing,School Counselor,4.463300561381452,8,1,0,0,1,1,2,4,3,1,0,1,0,1,Commerce,Masters,18-24,0,0,0,Office,Tier2_City,2,4,2,2,4,5,4,14.27,Other,2,5,2,3,5,5,2,3,3,2,0,0,1,1,41.67
Music,Nurse,2.9401733873376563,1,0,3,0,3,1,3,4,2,2,4,1,2,0,Arts,Masters,18-24,10,0,0,Hybrid,Tier3_City,2,4,3,4,0,0,1,47.45,Finance,1,3,2,3,1,1,1,1,5,2,1,0,5,4,65.48
Law,Paralegal,2.694211482806719,1,0,1,0,1,1,4,4,3,0,3,4,3,0,Arts,Masters,25-30,13,0,0,Hybrid,Any,1,4,5,5,4,1,4,10.08,Finance,2,3,2,2,4,4,2,1,5,3,1,1,5,2,72.82
Psychology,Investment Banker,4.935890314138229,4,0,4,0,4,1,2,4,3,3,4,4,0,0,Arts,Bachelors,25-30,12,0,0,Office,Tier1_City,2,2,4,4,1,3,4,37.91,Other,3,2,1,5,0,1,4,2,5,5,1,1,2,2,74.66
Computer Science,Aerospace Engineer,2.774844843038317,3,0,4,1,6,0,1,4,0,0,1,1,0,0,Science,Masters,25-30,4,0,0,Office,Tier1_City,4,2,1,5,3,2,3,3.05,Education,5,5,3,3,3,3,5,1,5,1,0,0,5,1,43.39
Marketing,Biochemist,4.709739265679248,9,0,3,0,4,1,1,3,3,0,4,2,3,1,Commerce,Masters,40+,2,0,0,Office,Tier1_City,1,3,1,1,5,0,2,32.69,Education,5,2,1,1,2,5,2,3,1,1,0,1,1,4,44.04
Business,Social Media Manager,3.123609001530072,3,2,0,0,6,1,1,4,4,0,3,4,3,0,Commerce,Bachelors,18-24,8,0,0,Remote,Tier2_City,4,5,0,5,0,2,2,26.25,Education,2,4,4,2,0,5,1,3,3,5,0,0,3,5,59.1
Physics,Conductor,4.855145843121758,0,0,4,0,5,1,0,2,0,1,2,4,2,0,Science,Masters,25-30,8,1,12,Hybrid,Tier1_City,5,2,3,2,2,5,1,25.14,Other,4,2,1,3,4,5,4,5,5,4,0,0,4,2,57.02
Education,Physicist,3.0255692412697424,9,0,3,1,1,1,1,2,4,0,1,0,3,0,Arts,Bachelors,18-24,6,0,0,Remote,Any,4,3,2,5,3,1,3,41.97,Healthcare,5,5,3,2,4,1,4,5,3,3,0,0,4,3,47.94
Art,Chemical Engineer,4.514118573165264,5,1,2,1,3,0,1,0,0,2,0,2,2,0,Arts,PhD,25-30,11,0,0,Hybrid,Tier2_City,5,1,1,3,0,0,4,6.79,Finance,2,3,1,2,3,1,5,2,3,3,1,0,3,2,52.17
Marketing,Organic Chemist,3.1350482570798146,6,0,3,0,3,1,1,3,3,0,0,3,3,1,Commerce,Bachelors,25-30,8,0,0,Remote,Any,2,1,2,2,2,5,5,20.73,Education,1,2,3,1,1,5,4,1,5,1,1,0,2,3,45.85
Music,Aerospace Engineer,4.630389948957681,7,1,1,0,4,1,4,3,4,4,0,2,1,1,Arts,Masters,36-40,11,0,0,Office,Tier1_City,1,2,5,1,2,3,5,23.96,Manufacturing,2,2,1,1,2,1,1,4,3,3,1,0,5,2,63.31
Chemistry,Financial Analyst,4.259657470793751,3,0,2,1,7,1,2,2,0,2,3,2,4,0,Science,Bachelors,25-30,1,0,0,Remote,Tier2_City,3,4,0,2,5,2,1,8.82,Other,3,3,1,4,2,0,2,2,1,5,1,1,4,1,48.4
Finance,Biochemist,3.6040737986147686,1,0,2,0,1,0,0,1,0,4,3,0,3,0,Commerce,PhD,18-24,10,0,0,Remote,Tier2_City,4,3,5,3,5,3,1,7.03,Education,2,3,2,3,2,2,4,1,3,2,0,0,2,4,58.42
Biology,Marketing Specialist,4.771578808702374,2,0,3,1,5,0,2,0,4,3,2,2,4,1,Science,Bachelors,25-30,9,0,0,Office,Tier1_City,1,5,4,1,2,4,1,11.44,Tech,1,5,2,2,0,0,3,3,5,1,1,0,5,5,53.72
Computer Science,Credit Analyst,3.923774351762516,7,2,2,0,9,1,2,2,1,2,2,3,0,1,Science,PhD,18-24,7,0,0,Remote,Any,3,3,4,4,5,0,3,14.33,Tech,2,4,2,4,4,1,2,2,3,1,0,0,4,5,58.93
Art,Special Education Teacher,4.397099558247154,6,0,1,0,9,0,4,2,0,0,3,1,3,1,Arts,PhD,18-24,9,1,42,Office,Tier2_City,1,4,0,3,2,2,5,48.4,Finance,1,5,3,1,2,4,1,2,3,1,0,0,4,1,56.5
Computer Science,Music Teacher,4.034007643499299,9,2,1,1,3,0,0,3,3,2,0,1,3,1,Science,Bachelors,31-35,9,0,0,Flexible,Tier1_City,3,4,5,1,0,1,3,25.35,Finance,1,2,5,5,5,4,1,1,5,3,1,1,3,4,56.91
Physics,Architect,4.418734177671119,8,1,4,1,9,0,2,4,2,0,0,2,3,0,Science,Masters,18-24,9,0,0,Hybrid,Any,1,2,2,5,1,1,3,26.98,Finance,3,5,5,2,2,4,5,3,1,1,0,0,2,5,47.12
Marketing,Financial Advisor,4.322875608324249,3,2,1,0,3,1,3,2,1,3,3,1,0,1,Commerce,PhD,25-30,12,0,0,Office,Tier2_City,5,4,5,2,5,1,4,36.23,Healthcare,3,5,5,5,1,1,4,1,5,1,0,1,1,1,69.8
Architecture,AI Researcher,4.352691088475883,8,0,1,1,4,1,3,3,4,0,0,3,1,0,Interdisciplinary,Bachelors,31-35,0,0,0,Office,Tier1_City,3,4,2,1,4,5,3,35.16,Other,5,3,5,5,0,1,5,3,2,4,0,0,4,2,50.59
Business,Legal Consultant,4.642481544231222,5,0,1,1,3,0,3,0,0,4,1,4,0,1,Commerce,Bachelors,25-30,2,0,0,Remote,Tier1_City,1,5,2,2,4,1,3,26.63,Tech,1,4,3,2,5,3,4,3,2,1,1,0,5,1,37.08
Art,AI Researcher,2.881892486750697,4,0,0,1,3,1,2,2,1,2,1,3,3,0,Arts,Bachelors,18-24,7,0,0,Hybrid,Tier2_City,3,4,0,5,4,2,4,18.97,Tech,1,4,2,4,5,3,2,5,3,5,0,0,2,3,56.63
Marketing,Aerospace Engineer,2.805950740239089,0,0,4,1,9,0,0,4,3,0,4,1,1,0,Commerce,Bachelors,40+,10,0,0,Hybrid,Tier2_City,5,1,1,1,1,5,2,18.56,Finance,1,5,2,4,4,2,5,4,4,3,0,0,4,2,58.55
Chemistry,Counselor,4.302714916279758,1,1,4,0,0,1,3,3,2,3,0,3,4,0,Science,High School,25-30,7,0,0,Remote,Tier2_City,3,4,1,4,2,4,4,5.71,Other,5,3,2,2,3,1,5,5,2,1,0,0,1,4,43.78
Medicine,Forensic Psychologist,2.5919165009510743,2,1,0,1,9,1,2,1,2,2,2,4,4,1,Science,Bachelors,31-35,13,1,35,Remote,Tier2_City,3,1,3,3,2,1,1,45.28,Tech,4,3,3,3,1,1,5,2,2,5,1,1,1,4,57.94
Psychology,Pharmacist,2.956693645599826,9,2,0,1,6,1,1,4,0,4,1,0,0,1,Arts,Bachelors,25-30,9,1,59,Hybrid,Tier1_City,1,5,4,1,3,1,2,39.16,Tech,3,2,1,5,1,4,5,2,2,3,0,1,4,2,53.01
Biology,Biochemist,4.990458316457069,4,2,2,0,0,1,3,0,2,3,2,4,0,1,Science,Bachelors,25-30,7,0,0,Office,Tier1_City,4,2,5,5,4,5,5,32.3,Healthcare,3,1,4,4,1,3,3,1,4,3,1,1,3,1,61.25
Computer Science,Urban Planner,2.9332577565369715,3,2,0,0,1,0,2,1,2,4,2,2,0,1,Science,Bachelors,25-30,10,1,54,Flexible,Tier3_City,5,1,4,1,4,1,3,21.62,Manufacturing,1,2,3,2,2,5,3,1,4,1,1,1,4,3,56.97
Finance,Analytical Chemist,4.879101107397823,7,1,3,0,2,1,3,1,1,2,4,0,0,1,Commerce,Masters,25-30,14,1,25,Hybrid,Tier2_City,1,2,3,2,2,4,2,30.38,Finance,5,2,1,1,3,5,5,1,1,3,0,1,4,4,51.92
Computer Science,Acoustics Specialist,4.256425844473155,7,1,4,1,3,1,1,4,3,4,4,2,0,0,Science,Masters,18-24,11,1,27,Hybrid,Tier1_City,2,2,2,1,4,5,5,25.8,Manufacturing,1,2,2,1,0,0,4,5,4,5,1,1,5,5,76.65
Architecture,Psychologist,4.042558260335457,6,2,0,1,1,0,1,0,4,0,3,0,0,0,Interdisciplinary,Bachelors,25-30,10,0,0,Office,Tier1_City,3,1,0,4,2,5,4,15.87,Manufacturing,3,1,2,2,4,3,5,3,1,4,0,0,5,1,52.4
Art,Construction Manager,3.979728417869802,3,2,3,1,1,0,4,3,3,0,0,2,4,1,Arts,Masters,36-40,6,1,41,Office,Any,2,3,4,1,2,0,4,17.03,Healthcare,5,3,5,3,0,5,3,4,5,2,0,0,3,5,56.28
Psychology,Doctor,4.113412952632653,7,2,1,0,6,1,2,2,3,4,1,0,2,1,Arts,Masters,31-35,1,0,0,Remote,Any,1,4,2,3,5,5,1,44.1,Tech,2,3,5,1,5,2,3,2,1,1,0,0,5,4,38.67
Business,Special Education Teacher,4.822890178853194,0,0,3,1,2,0,0,0,2,0,2,4,3,1,Commerce,PhD,18-24,2,0,0,Remote,Tier2_City,4,5,1,1,2,1,1,32.84,Finance,3,4,1,3,1,0,5,2,1,3,1,0,4,4,45.39
Business,AI Researcher,3.961265751926253,9,1,2,0,6,1,2,4,4,4,3,4,2,1,Commerce,High School,25-30,8,1,26,Hybrid,Tier1_City,5,2,2,2,0,5,2,3.07,Education,2,4,4,2,3,4,5,1,2,4,1,0,3,4,57.58
Architecture,Forensic Psychologist,2.6396915954106683,7,2,1,0,3,1,1,0,4,3,4,2,4,0,Interdisciplinary,Bachelors,36-40,1,1,12,Hybrid,Tier2_City,1,3,3,1,0,1,3,18.36,Manufacturing,4,5,1,2,0,3,4,5,3,5,0,1,5,1,48.13
Music,Art Therapist,4.768488360152536,7,0,0,1,3,1,2,2,0,0,4,1,2,1,Arts,PhD,31-35,12,0,0,Office,Tier1_City,4,2,0,4,0,1,4,18.98,Other,2,5,1,5,0,5,3,1,2,3,1,0,5,3,59.91
Education,Clinical Psychologist,3.235486198231441,3,0,2,1,0,0,4,0,3,3,1,4,0,0,Arts,PhD,18-24,6,1,27,Hybrid,Tier2_City,1,3,5,5,0,5,2,36.2,Manufacturing,5,5,4,2,1,1,5,5,2,5,0,1,4,2,59.34
Business,Software Developer,4.216300461008872,3,0,3,0,3,0,1,3,3,1,0,4,2,0,Commerce,Masters,36-40,0,0,0,Remote,Tier3_City,4,5,4,1,1,0,2,35.92,Healthcare,2,4,1,3,5,5,1,3,5,2,1,0,3,1,47.78
Physics,Biomedical Engineer,4.334692286754727,2,2,2,0,5,1,0,4,1,3,4,0,4,1,Science,Masters,25-30,2,0,0,Remote,Tier2_City,2,3,3,1,3,1,2,24.82,Manufacturing,4,4,1,4,5,2,5,1,1,3,0,1,5,3,47.35
Art,Forensic Psychologist,3.519668605720545,7,0,1,0,6,0,2,4,2,3,1,1,4,1,Arts,Bachelors,25-30,12,0,0,Flexible,Tier1_City,4,5,1,3,3,0,1,47.7,Manufacturing,3,2,3,1,1,2,3,3,1,2,1,1,2,5,52.31
Law,Advertising Manager,3.817942469457773,8,1,2,0,5,0,1,4,0,2,2,0,1,0,Arts,Bachelors,25-30,13,1,34,Remote,Tier2_City,5,4,1,4,2,0,4,43.99,Manufacturing,4,3,4,1,0,0,1,2,2,5,0,0,4,1,50.26
Education,Dentist,3.647949952977476,7,2,2,1,2,0,3,4,2,3,2,0,2,1,Arts,Bachelors,36-40,0,1,15,Remote,Tier3_City,2,3,5,5,4,5,1,43.71,Healthcare,5,4,2,5,5,0,1,2,4,2,1,1,2,3,47.53
Physics,Marketing Specialist,3.231405007339024,9,0,3,0,6,0,3,2,1,3,3,3,0,1,Science,Bachelors,36-40,5,1,10,Office,Tier2_City,3,2,0,2,0,3,1,19.37,Tech,2,1,5,4,0,2,1,2,3,4,1,0,1,4,57.64
Engineering,Acoustics Specialist,4.791296614556595,1,2,4,0,1,0,2,2,4,2,4,0,2,1,Science,Masters,36-40,3,0,0,Office,Tier3_City,2,4,5,1,3,3,2,23.26,Other,2,2,2,3,2,3,4,3,2,4,0,0,5,3,54.57
Business,Biotechnologist,3.2918542571304217,7,0,0,1,6,0,3,0,2,1,2,1,1,0,Commerce,Bachelors,18-24,0,0,0,Hybrid,Tier1_City,2,2,5,5,3,1,5,22.69,Manufacturing,5,1,2,3,3,1,5,1,3,5,0,1,2,3,40.81
Psychology,Architectural Technologist,3.246702268782637,7,2,2,1,7,0,2,1,3,0,4,1,2,1,Arts,Bachelors,36-40,4,0,0,Hybrid,Tier3_City,3,2,5,2,0,2,5,23.69,Finance,1,1,5,5,1,4,1,5,2,3,1,1,1,4,45.13
Biology,Game Developer,2.8187712830805687,6,1,3,0,2,1,3,0,0,3,0,2,0,1,Science,PhD,18-24,13,0,0,Flexible,Tier2_City,2,4,4,4,1,3,5,44.79,Other,5,3,5,2,4,1,4,5,2,5,1,0,4,2,57.53
Chemistry,Zoologist,4.692618489696264,7,0,0,1,2,1,0,0,1,2,2,3,0,0,Science,Bachelors,25-30,3,0,0,Remote,Tier1_City,2,4,1,4,1,5,2,14.71,Manufacturing,5,1,1,4,4,3,3,1,5,2,1,0,2,2,44.56
Business,Biochemist,4.7630541234880965,5,2,2,1,1,1,2,2,3,0,1,2,0,0,Commerce,PhD,25-30,13,0,0,Hybrid,Tier2_City,3,5,3,5,3,5,3,40.7,Manufacturing,4,1,4,1,1,0,1,4,2,1,0,1,3,3,53.67
Finance,Education Administrator,2.658974177865612,4,1,0,0,4,1,4,1,3,3,4,3,4,1,Commerce,PhD,25-30,10,0,0,Hybrid,Tier2_City,3,3,1,2,1,3,4,27.16,Finance,4,1,5,4,5,4,5,5,4,1,1,1,4,5,73.84
Law,Curriculum Developer,3.0608818298434213,1,1,0,1,8,1,3,2,0,0,4,4,1,0,Arts,Masters,31-35,9,1,10,Remote,Tier2_City,5,5,4,4,5,2,2,14.71,Healthcare,5,1,4,5,3,1,1,5,4,4,1,1,4,3,67.57
Architecture,Market Research Analyst,2.787184202778868,4,0,0,1,7,1,0,3,4,4,3,1,2,0,Interdisciplinary,Bachelors,25-30,13,0,0,Hybrid,Tier1_City,2,1,2,5,0,4,2,27.78,Education,3,2,1,2,5,1,3,1,1,4,1,1,3,5,56.23
Business,Lawyer,3.828892398124956,7,0,0,1,0,1,3,1,0,3,2,2,0,0,Commerce,Bachelors,36-40,10,1,16,Office,Tier1_City,2,1,1,4,3,1,1,12.19,Finance,2,2,2,4,4,4,3,1,2,1,0,0,4,4,50.78
Engineering,Analytical Chemist,4.530748536624289,0,1,0,1,9,0,2,2,4,2,0,2,3,1,Science,Bachelors,18-24,9,0,0,Hybrid,Any,2,5,1,4,0,4,5,8.08,Education,5,3,5,2,2,2,1,1,1,2,1,0,1,2,45.46
Computer Science,Nurse,2.80993738494751,7,0,4,0,2,0,0,2,0,4,4,1,3,1,Science,Bachelors,25-30,1,0,0,Flexible,Tier2_City,5,5,1,4,1,4,2,42.39,Tech,1,3,5,4,1,4,5,4,1,5,0,1,5,4,43.07
Medicine,Composer,4.634204550316898,9,2,3,0,2,0,3,0,2,3,4,3,4,0,Science,Bachelors,36-40,12,0,0,Hybrid,Tier1_City,2,3,2,3,0,0,3,35.87,Tech,2,1,1,1,4,1,4,3,3,3,0,1,4,2,58.61
Chemistry,Financial Analyst,4.704865267617766,7,1,2,0,2,1,0,4,1,3,3,4,2,0,Science,PhD,18-24,6,0,0,Office,Any,3,4,4,2,1,0,4,12.63,Manufacturing,3,5,4,3,4,4,1,2,5,1,0,0,2,2,63.12
Engineering,Music Therapist,3.1555600462946303,1,1,4,0,8,1,4,1,3,4,0,1,3,0,Science,Bachelors,31-35,11,0,0,Office,Tier1_City,3,1,3,5,1,1,3,47.29,Other,5,1,4,4,5,5,3,3,3,2,0,0,4,1,55.83
Music,Curriculum Developer,3.782184641880428,7,2,3,0,8,0,2,4,3,3,4,3,0,1,Arts,Masters,31-35,14,0,0,Office,Tier2_City,3,4,4,5,0,2,2,4.15,Manufacturing,3,1,3,3,1,1,4,3,4,5,1,1,3,1,72.48
Music,Financial Controller,3.639249665436894,9,1,1,1,2,0,0,4,0,3,1,1,3,1,Arts,High School,25-30,7,1,31,Office,Tier1_City,3,2,0,2,1,0,2,18.66,Healthcare,2,3,2,3,3,5,5,1,3,1,1,0,2,1,36.34
Physics,Biochemist,3.937704656214101,9,2,2,0,4,1,2,1,4,0,4,1,0,1,Science,Masters,31-35,3,1,16,Office,Any,4,2,5,2,5,3,1,4.02,Education,1,4,3,3,5,3,1,1,5,3,1,1,3,4,60.02
Physics,Forensic Psychologist,3.1369283214522468,2,2,2,1,5,1,1,2,2,3,3,0,1,1,Science,PhD,18-24,8,0,0,Hybrid,Tier1_City,3,4,3,2,2,1,3,9.69,Tech,2,3,4,5,1,5,3,1,4,5,0,0,4,3,69.19
Biology,Software Developer,3.945362781044258,9,0,4,1,7,0,1,3,4,3,0,1,4,1,Science,Bachelors,36-40,2,0,0,Hybrid,Tier3_City,5,2,2,2,0,5,1,11.46,Tech,2,2,3,1,0,2,4,2,3,2,1,0,1,1,39.36
Medicine,Manager,3.30393579934106,8,1,4,1,5,0,4,3,1,1,4,4,1,1,Science,Bachelors,18-24,12,1,45,Remote,Tier2_City,4,1,0,1,2,4,3,41.09,Manufacturing,5,3,4,3,4,4,2,3,5,3,0,0,2,5,69.81
Computer Science,Musician,4.096015183480569,2,0,3,0,0,1,2,2,0,0,1,0,1,0,Science,Masters,25-30,5,1,53,Office,Tier1_City,2,1,1,5,0,1,5,49.67,Manufacturing,2,4,5,1,0,3,4,2,2,1,1,1,4,4,30.89
Art,Cybersecurity Analyst,4.821206194661546,4,0,4,1,5,1,3,1,3,2,1,4,0,1,Arts,Masters,18-24,10,0,0,Hybrid,Tier1_City,3,2,1,1,1,5,5,43.76,Healthcare,5,1,1,4,3,3,3,5,2,4,0,0,4,4,62.4
Education,Special Education Teacher,4.674225344992319,8,0,3,0,2,0,2,0,2,2,2,1,4,1,Arts,Masters,25-30,13,1,29,Hybrid,Tier1_City,2,1,5,4,1,5,3,32.85,Manufacturing,5,4,3,1,0,2,3,3,1,4,1,0,3,1,52.45
Business,Biologist,2.889951308031395,7,2,2,0,5,0,2,1,4,3,2,0,4,1,Commerce,Bachelors,31-35,14,0,0,Remote,Any,3,2,4,4,3,0,1,36.98,Other,3,3,5,2,3,0,2,2,3,2,1,1,4,2,55.45
Art,Analytical Chemist,4.780378926881944,7,0,2,1,3,1,3,2,0,2,3,2,1,0,Arts,Bachelors,36-40,13,0,0,Office,Tier3_City,3,3,2,5,5,5,5,27.57,Manufacturing,1,5,5,3,1,4,2,2,4,4,0,1,1,1,64.04
Law,Investment Banker,4.319532319356373,4,0,0,1,2,0,1,3,1,3,2,0,1,1,Arts,PhD,31-35,6,0,0,Flexible,Any,4,3,2,4,3,2,2,22.86,Other,5,2,1,4,2,5,2,4,1,5,0,1,2,1,55.44
Marketing,Risk Analyst,4.898335751802966,9,1,3,1,7,1,4,3,2,4,0,3,0,1,Commerce,PhD,25-30,6,0,0,Office,Tier1_City,3,4,1,2,2,5,4,35.53,Other,4,4,1,3,2,2,5,2,3,4,0,0,4,3,66.16
Medicine,Music Therapist,4.511967459579338,0,0,2,1,6,1,2,3,2,2,4,0,1,1,Science,Bachelors,36-40,5,0,0,Hybrid,Tier1_City,3,2,1,1,1,5,1,48.74,Healthcare,3,3,5,3,1,5,3,2,4,4,0,1,3,3,53.6
Engineering,Composer,3.8399509026854783,0,0,2,0,2,0,1,0,4,3,2,2,3,0,Science,Masters,25-30,8,0,0,Hybrid,Tier2_City,1,3,5,2,3,4,3,4.36,Manufacturing,5,1,5,4,5,2,1,4,2,5,0,0,1,2,63.96
Engineering,Art Director,2.8154718602098425,1,0,2,1,9,0,0,0,2,4,4,4,3,1,Science,Bachelors,25-30,14,1,41,Hybrid,Tier2_City,5,3,5,4,1,2,4,17.76,Other,5,3,3,4,4,1,5,2,1,2,1,1,5,3,54.02
Business,Forensic Psychologist,3.463769097737288,9,0,0,1,3,0,4,0,0,0,2,0,3,0,Commerce,Bachelors,25-30,0,0,0,Remote,Tier3_City,5,1,5,1,0,1,4,18.51,Other,3,1,3,5,3,2,3,3,4,1,0,1,1,3,35.48
Computer Science,Curriculum Developer,4.76831692396171,0,1,1,0,5,1,4,4,0,1,2,0,1,0,Science,Bachelors,25-30,12,0,0,Hybrid,Tier3_City,2,4,2,2,3,2,2,22.47,Manufacturing,2,5,2,5,0,2,4,1,3,2,0,0,4,4,57.3
Psychology,Art Therapist,3.5603713288718835,2,0,3,1,8,0,1,0,1,1,4,4,4,0,Arts,Bachelors,36-40,8,0,0,Hybrid,Any,2,4,2,5,2,2,1,32.46,Manufacturing,5,2,2,5,2,4,2,3,1,4,0,1,4,3,50.07
Psychology,Industrial-Organizational Psychologist,2.6882001531476734,4,0,2,0,2,0,1,1,0,2,3,0,2,0,Arts,Bachelors,18-24,12,0,0,Flexible,Tier1_City,4,3,4,2,3,1,4,27.15,Education,1,4,5,1,0,2,4,1,4,2,0,0,2,1,47.22
Finance,Lawyer,3.1341362459051885,1,2,0,0,0,1,3,4,2,1,0,1,3,1,Commerce,High School,25-30,8,0,0,Hybrid,Tier3_City,2,3,1,4,1,4,1,3.88,Tech,5,3,2,2,0,5,1,4,3,1,0,0,4,5,41.1
Art,Physicist,2.549992726436792,0,1,2,0,9,1,3,0,0,3,2,3,0,1,Arts,Bachelors,31-35,3,1,47,Hybrid,Tier2_City,1,4,2,1,4,5,2,22.35,Finance,3,3,5,2,0,2,5,2,4,5,1,0,1,1,48.99
Art,Human Resources Specialist,4.294789813281943,1,1,4,0,9,0,3,4,0,1,1,4,2,0,Arts,Masters,36-40,12,1,11,Flexible,Tier2_City,2,1,0,5,4,2,3,32.11,Tech,4,4,1,1,5,0,4,4,1,5,0,0,5,3,63.68
Education,Urban Planner,3.897982069787252,2,1,2,0,0,0,1,3,4,1,0,3,0,1,Arts,Masters,36-40,11,0,0,Hybrid,Tier2_City,3,5,0,1,5,2,4,26.73,Education,3,1,1,5,4,3,1,4,3,5,0,1,1,1,70.09
Chemistry,Industrial-Organizational Psychologist,4.685248735192692,5,1,1,1,1,0,1,2,4,4,0,4,3,0,Science,Masters,25-30,14,0,0,Remote,Any,2,1,0,5,1,1,4,43.99,Finance,3,2,3,2,2,4,4,4,5,2,1,1,4,1,65.96
Engineering,Psychologist,4.579310577082564,4,0,4,1,9,1,4,3,2,1,2,2,1,1,Science,PhD,31-35,11,1,28,Hybrid,Tier2_City,2,5,3,1,0,3,4,21.73,Tech,1,5,4,5,0,0,3,3,1,4,0,1,4,1,66.35
Biology,Civil Engineer,2.6000718875557007,0,1,1,1,2,1,2,3,4,3,0,1,2,1,Science,High School,25-30,4,0,0,Hybrid,Tier1_City,3,4,0,4,3,2,1,3.59,Healthcare,2,4,5,4,0,5,4,4,4,5,1,1,5,3,55.64
Marketing,Nuclear Physicist,3.0241450267045504,5,0,2,1,9,0,4,2,0,1,3,1,3,0,Commerce,Masters,25-30,2,0,0,Office,Tier2_City,1,4,2,5,4,0,4,16.39,Education,1,2,3,1,5,4,2,2,5,4,0,1,5,4,54.68
Physics,Special Education Teacher,4.051008999522615,9,1,4,1,0,1,1,0,3,2,3,0,1,1,Science,Masters,36-40,6,0,0,Remote,Any,5,4,3,3,0,5,1,9.38,Healthcare,1,3,2,5,2,3,2,5,3,3,0,0,2,4,48.91
Biology,Architect,3.546599265479664,3,0,2,1,8,0,3,1,4,3,0,3,1,0,Science,Bachelors,36-40,14,1,44,Office,Tier3_City,1,2,5,1,1,5,5,14.76,Healthcare,5,2,5,1,5,2,3,4,2,5,1,1,5,5,56.09
Biology,Risk Analyst,3.887299657823569,9,2,2,1,0,1,2,3,0,0,1,2,0,0,Science,Bachelors,36-40,1,0,0,Flexible,Tier1_City,1,2,1,1,0,4,5,20.02,Tech,4,5,3,3,0,2,5,1,4,1,1,1,3,5,32.91
Marketing,Software Developer,3.62286431854218,2,2,4,0,7,1,4,1,4,1,1,4,4,0,Commerce,Bachelors,18-24,7,1,49,Hybrid,Tier3_City,4,2,2,2,1,2,1,34.8,Other,3,2,2,1,3,5,2,2,4,4,0,0,4,3,59.36
Marketing,Industrial-Organizational Psychologist,2.978554232878804,8,2,4,1,1,0,3,2,2,4,4,0,4,0,Commerce,Masters,36-40,8,0,0,Remote,Tier1_City,4,4,0,5,5,1,5,18.24,Finance,1,3,5,1,2,1,4,2,1,3,0,0,2,4,61.83
Law,Landscape Architect,3.2875640591166,0,2,1,0,0,0,2,1,1,3,1,4,1,1,Arts,Bachelors,36-40,5,0,0,Hybrid,Tier1_City,3,3,5,3,3,0,2,44.55,Other,1,5,3,5,0,3,2,5,2,5,1,0,1,2,56.04
Law,Legal Consultant,2.564150875912116,6,0,0,1,0,0,0,1,3,1,3,1,2,0,Arts,Masters,25-30,8,0,0,Hybrid,Tier2_City,4,4,5,4,0,1,2,17.08,Manufacturing,2,5,4,1,4,2,3,2,1,4,0,0,2,5,49.93
Physics,Fluid Mechanics Engineer,3.5380975306213425,8,0,1,0,2,0,2,2,2,0,3,3,3,0,Science,Masters,25-30,5,0,0,Hybrid,Tier2_City,5,5,1,2,3,2,5,9.44,Manufacturing,2,5,3,3,5,4,5,2,5,4,0,1,4,4,58.3
Engineering,Landscape Architect,3.774758950102784,4,2,1,0,9,1,0,4,4,3,4,0,0,0,Science,Masters,31-35,2,0,0,Hybrid,Tier1_City,3,1,5,3,0,0,3,10.94,Education,4,3,5,4,3,5,3,4,2,3,1,0,4,4,51.87
Law,Cybersecurity Analyst,4.041456751520527,2,2,0,0,8,0,4,4,3,2,4,4,1,0,Arts,Masters,25-30,9,0,0,Hybrid,Tier3_City,4,5,0,5,1,4,1,46.93,Healthcare,3,1,2,2,5,4,4,5,2,1,0,1,5,4,63.68
Law,Web Developer,4.309121407138738,1,0,2,0,7,0,4,4,4,1,3,4,4,0,Arts,Masters,40+,2,0,0,Flexible,Tier3_City,2,1,4,3,1,4,5,24.38,Education,1,3,5,4,1,1,2,4,1,2,0,0,5,1,56.98
Art,Forensic Psychologist,4.019677437743644,4,2,4,1,4,1,3,0,2,1,2,3,4,0,Arts,Bachelors,25-30,1,0,0,Hybrid,Tier2_City,4,5,3,1,0,4,1,21.95,Tech,5,1,5,1,4,2,4,5,2,1,1,0,3,5,34.62
Business,Manager,3.526214471937592,0,2,4,0,2,1,4,2,0,4,4,4,3,0,Commerce,Bachelors,31-35,4,1,51,Hybrid,Tier1_City,5,1,5,1,5,3,5,6.24,Healthcare,2,1,3,3,1,4,2,5,4,2,1,1,3,3,60.24
Physics,Teacher,3.6887800355439992,6,0,4,1,1,0,4,1,1,4,0,1,0,1,Science,Masters,31-35,12,1,21,Flexible,Tier1_City,4,3,1,2,1,1,2,37.47,Manufacturing,1,3,5,3,1,5,2,4,3,1,1,0,4,3,56.58
Education,Financial Advisor,4.749974280947022,2,2,4,0,9,1,3,4,3,3,3,1,3,0,Arts,Bachelors,25-30,13,1,7,Remote,Tier1_City,3,1,0,5,2,2,3,35.65,Tech,5,2,1,4,0,3,1,2,1,1,1,1,4,3,57.75
Business,Data Scientist,2.83607220311528,2,0,4,0,6,1,4,2,3,4,2,1,1,0,Commerce,Bachelors,36-40,3,1,7,Remote,Tier1_City,2,4,4,5,2,0,1,20.66,Tech,1,3,4,5,3,5,3,3,5,5,0,1,3,1,61.2
Computer Science,Teacher,3.057460725418918,4,0,2,1,2,1,1,2,0,2,3,2,4,0,Science,Bachelors,25-30,11,0,0,Flexible,Any,3,5,3,3,3,5,3,35.51,Other,4,5,2,2,5,1,1,4,1,4,0,1,3,4,52.58
Education,Nurse,3.7154412359158826,8,0,0,1,0,1,0,2,1,0,3,2,3,0,Arts,PhD,25-30,5,0,0,Remote,Tier2_City,2,2,0,2,2,5,2,20.27,Education,4,2,4,1,0,2,4,5,1,1,1,1,5,4,39.31
Marketing,Accountant,2.7152045048672773,8,0,2,1,8,0,4,4,1,0,0,3,0,1,Commerce,Bachelors,18-24,4,1,26,Remote,Tier1_City,2,3,2,5,2,1,4,6.44,Education,5,4,3,1,4,5,4,4,5,4,0,0,2,2,53.16
Medicine,Special Education Teacher,3.6018315713812603,3,0,4,0,9,1,4,4,3,3,2,0,2,0,Science,Masters,25-30,5,0,0,Hybrid,Tier1_City,5,5,4,1,5,2,4,37.69,Other,2,4,3,4,5,2,5,2,5,4,0,1,5,1,71.78
Business,Judge,3.914406615647868,7,2,3,1,6,1,3,2,2,4,3,3,2,0,Commerce,Bachelors,31-35,3,0,0,Remote,Any,1,3,1,3,5,3,1,48.36,Finance,4,4,1,3,1,1,2,3,5,4,0,0,3,5,63.58
Chemistry,Education Administrator,3.4650159518620014,1,2,4,0,2,1,0,4,2,2,4,4,2,1,Science,Bachelors,36-40,13,1,23,Hybrid,Tier2_City,5,2,0,4,4,2,2,33.47,Manufacturing,2,5,3,3,0,0,1,2,3,4,0,0,1,5,65.94
Marketing,Biotechnologist,4.922019861486525,3,1,1,1,8,1,0,1,2,1,3,1,1,1,Commerce,Masters,25-30,12,0,0,Hybrid,Tier2_City,1,2,1,1,4,1,1,15.99,Manufacturing,5,5,3,5,4,5,5,5,5,1,0,0,3,5,62.05
Psychology,Biomedical Engineer,3.4462187713925028,4,0,4,1,1,1,4,2,0,3,1,2,2,1,Arts,Bachelors,25-30,2,1,25,Hybrid,Tier2_City,1,2,2,2,5,2,1,15.69,Education,5,1,3,2,4,4,1,5,5,2,1,1,1,4,50.32
Music,Financial Advisor,4.213013268152564,6,1,0,1,3,1,1,3,3,4,1,2,4,0,Arts,Masters,18-24,0,0,0,Remote,Tier1_City,5,2,1,5,4,5,1,46.66,Manufacturing,1,5,4,1,5,4,4,5,2,4,0,1,5,1,47.6
Finance,Brand Manager,3.8570257686664,9,1,4,1,8,1,0,3,4,0,1,0,2,0,Commerce,Masters,31-35,4,0,0,Flexible,Any,4,2,4,1,5,5,3,17.25,Manufacturing,5,1,1,4,1,1,5,5,1,4,1,1,5,5,48.63
Chemistry,Accountant,3.879521113869933,0,0,3,1,2,1,0,0,1,0,1,2,3,1,Science,Masters,40+,5,1,54,Remote,Tier1_City,5,4,3,4,4,0,5,39.11,Tech,1,4,5,5,5,2,3,3,5,5,0,0,5,4,54.89
Business,Counselor,3.912827295161717,3,1,0,0,0,0,1,3,4,0,0,2,1,0,Commerce,Bachelors,31-35,4,0,0,Hybrid,Tier3_City,3,1,0,4,1,3,2,33.22,Other,2,3,2,2,5,0,5,3,5,1,0,1,4,3,42.72
Engineering,Accountant,3.7277095993380978,9,2,4,0,6,0,1,1,2,0,0,2,2,1,Science,Masters,31-35,4,1,7,Flexible,Tier1_City,3,2,5,2,5,5,3,30.85,Other,1,3,1,1,5,3,2,5,3,1,1,0,4,4,39.42
Finance,Aerospace Engineer,2.865384627217137,5,0,0,1,2,1,2,2,3,0,4,0,0,0,Commerce,Masters,25-30,11,1,51,Hybrid,Tier2_City,3,5,3,1,3,0,5,11.51,Healthcare,2,5,4,2,0,2,4,4,5,1,1,1,5,3,62.96
Business,Art Director,2.852179223684222,5,0,3,0,0,1,2,4,3,3,2,1,3,0,Commerce,Masters,18-24,5,0,0,Remote,Any,3,5,0,3,3,3,1,4.62,Healthcare,4,4,5,1,3,4,3,1,3,2,1,1,2,1,53.58
Chemistry,Legal Analyst,4.167770153519452,0,0,4,1,6,1,4,1,2,1,2,1,2,1,Science,Bachelors,31-35,3,0,0,Remote,Tier3_City,1,2,1,1,5,5,4,25.97,Finance,2,4,5,2,4,1,4,4,5,4,0,0,4,2,57.04
Psychology,Art Director,3.333591254457648,1,1,4,1,1,1,3,1,4,3,4,4,0,0,Arts,Bachelors,31-35,13,0,0,Flexible,Tier1_City,1,3,1,4,2,3,3,49.44,Healthcare,3,1,2,2,0,0,2,4,4,3,0,0,2,2,67.87
Chemistry,Judge,4.822060597628278,8,1,1,0,1,0,2,4,1,1,4,3,1,1,Science,PhD,31-35,11,0,0,Office,Tier2_City,5,2,4,2,3,2,2,12.2,Other,1,1,5,4,5,4,4,5,4,2,1,1,4,5,72.17
Music,Surgeon,2.559761605568004,8,1,1,0,4,1,3,4,0,4,4,4,2,0,Arts,Masters,36-40,3,1,36,Flexible,Tier1_City,2,4,1,2,2,0,2,28.23,Manufacturing,4,4,1,5,3,4,3,3,2,4,1,0,3,3,61.47
Biology,Nuclear Physicist,3.2723454518096373,7,0,2,1,9,0,3,2,2,2,2,1,4,0,Science,Bachelors,31-35,10,0,0,Office,Any,2,1,2,3,3,3,5,34.54,Other,2,5,5,3,1,5,5,3,2,5,1,0,5,3,57.77
Physics,Music Teacher,4.777117066152379,7,1,3,1,0,1,2,1,3,3,1,0,3,1,Science,Bachelors,31-35,12,0,0,Hybrid,Tier3_City,1,5,4,2,0,3,3,25.73,Tech,5,5,4,2,5,2,5,4,3,3,1,1,4,5,53.29
Finance,Art Therapist,3.5828908468325302,1,1,3,0,4,1,0,0,2,4,0,4,1,1,Commerce,Bachelors,36-40,7,0,0,Remote,Tier1_City,4,2,0,2,0,2,1,26.83,Other,1,4,5,4,3,1,5,4,4,5,1,1,3,1,55.33
Music,Animator,2.825947578174759,4,1,0,0,2,1,0,0,1,3,2,2,4,1,Arts,Bachelors,40+,10,0,0,Flexible,Tier1_City,1,1,1,2,5,5,5,34.08,Healthcare,2,3,4,3,1,0,3,4,3,1,0,1,2,2,51.22
Physics,Financial Controller,3.63442743482389,5,1,2,1,6,0,0,2,1,0,4,3,0,0,Science,Bachelors,25-30,7,1,58,Hybrid,Tier1_City,4,1,0,2,3,5,2,41.3,Manufacturing,4,3,5,5,5,2,5,5,4,2,1,0,4,2,55.11
Music,Dentist,3.597711578458951,1,0,3,1,9,1,0,4,1,0,4,4,1,1,Arts,Bachelors,18-24,11,0,0,Hybrid,Tier3_City,2,2,1,2,1,1,3,18.66,Other,5,1,2,5,4,3,1,2,5,3,1,1,2,5,60.21
Engineering,Digital Marketing Specialist,4.759393624951256,5,1,4,1,2,0,0,2,3,3,4,4,2,1,Science,Masters,25-30,2,0,0,Hybrid,Tier2_City,1,1,4,4,2,1,4,45.27,Manufacturing,1,4,1,2,2,4,1,1,2,3,1,0,5,1,50.02
Physics,Analytical Chemist,4.979628731080874,1,0,0,0,7,1,1,1,1,1,2,1,3,0,Science,Bachelors,31-35,6,0,0,Remote,Tier1_City,5,5,5,1,3,5,1,25.79,Education,4,3,4,1,2,2,5,5,5,1,0,0,4,2,45.83
Business,Special Education Teacher,3.2309056096476128,1,1,0,0,0,1,2,3,1,0,2,0,0,0,Commerce,Masters,18-24,14,1,41,Hybrid,Any,3,2,2,5,5,4,2,34.11,Other,5,5,5,5,4,5,2,1,3,4,1,1,5,3,62.36
Physics,Physical Chemist,3.06871519070692,4,2,1,0,8,1,0,1,3,4,4,3,2,0,Science,Bachelors,18-24,4,1,54,Hybrid,Tier1_City,2,3,0,2,2,4,3,8.01,Education,3,2,3,4,3,4,3,2,4,3,0,0,1,2,53.78
Computer Science,Organic Chemist,4.385267302220215,8,1,1,1,3,0,0,1,3,4,1,2,1,1,Science,Bachelors,18-24,4,1,32,Remote,Tier1_City,1,2,3,5,4,3,4,26.15,Healthcare,5,2,3,2,2,2,2,2,3,2,0,0,5,5,44.11
Psychology,Graphic Designer,3.111286532942968,9,1,1,1,0,0,2,0,1,3,3,3,1,1,Arts,Bachelors,31-35,11,0,0,Remote,Tier1_City,1,5,1,5,5,5,2,3.76,Education,1,4,1,5,5,1,4,5,3,2,1,0,2,2,62.65
Psychology,Teacher,3.177707292057616,9,1,0,1,6,0,1,1,4,1,1,0,3,0,Arts,Bachelors,25-30,12,0,0,Hybrid,Tier1_City,3,2,4,4,3,1,4,21.38,Manufacturing,3,1,4,2,1,5,2,3,4,5,1,0,2,5,59.33
Music,Accountant,3.186166190453796,6,0,1,0,3,0,4,4,0,1,0,3,2,0,Arts,Masters,25-30,2,1,24,Hybrid,Tier2_City,2,2,0,2,1,3,2,5.56,Manufacturing,2,2,2,1,4,0,2,3,2,2,1,0,5,4,38.64
Finance,Investment Banker,4.694845807633398,0,0,0,0,4,1,4,1,3,2,1,1,4,0,Commerce,Masters,18-24,1,1,43,Remote,Tier2_City,5,2,4,5,4,0,5,45.16,Education,3,5,2,5,0,1,2,1,4,1,1,1,4,1,48.61
Psychology,Physicist,3.579184643070281,9,2,4,1,3,1,3,4,4,0,4,1,0,1,Arts,Bachelors,31-35,12,0,0,Remote,Tier1_City,5,4,0,2,5,1,5,34.62,Tech,3,5,1,2,2,4,5,3,2,2,1,1,4,2,59.73
Computer Science,Astronomer,3.3811934120705183,8,2,1,0,3,1,0,0,1,0,4,2,3,1,Science,Bachelors,25-30,2,1,31,Flexible,Tier1_City,5,4,2,3,3,1,5,40.22,Education,3,5,2,4,3,4,4,4,5,2,1,0,2,4,44.51
Chemistry,Chemist,3.184802318184934,2,1,4,1,9,0,3,1,1,1,0,1,3,1,Science,Bachelors,25-30,14,1,51,Remote,Tier1_City,2,5,5,3,0,1,3,24.98,Tech,5,2,5,5,4,2,4,4,3,1,1,0,2,5,45.11
Law,AI Researcher,4.0641559956946125,3,1,4,0,7,0,3,4,3,0,2,3,4,0,Arts,Masters,31-35,6,0,0,Remote,Tier1_City,5,1,1,3,3,4,5,43.04,Education,3,3,1,1,5,5,5,2,5,4,1,1,3,2,67.2
Computer Science,Musician,4.640988993428207,7,0,2,0,4,1,0,4,3,1,0,0,3,0,Science,Masters,25-30,2,0,0,Hybrid,Tier1_City,4,2,0,5,0,2,3,44.03,Manufacturing,3,5,4,3,2,2,1,5,2,3,0,0,4,2,41.39
Physics,Investment Banker,2.967340406724677,0,2,3,1,8,1,0,3,3,4,0,0,1,1,Science,Bachelors,25-30,14,0,0,Remote,Tier1_City,1,2,3,3,0,2,1,19.77,Other,2,1,2,3,2,2,1,3,5,1,1,1,3,4,52.21
Biology,Quantum Physicist,4.052851071503724,5,1,3,1,1,0,2,0,4,3,1,4,2,0,Science,Masters,31-35,10,1,27,Hybrid,Tier1_City,4,4,1,4,5,4,5,20.71,Manufacturing,3,4,5,2,4,4,4,2,1,4,1,1,2,2,64.81
Physics,Financial Advisor,3.773490778845944,6,0,0,0,4,1,0,2,1,3,0,3,4,0,Science,Masters,25-30,12,0,0,Flexible,Tier3_City,2,3,1,4,3,5,3,26.89,Education,5,4,2,5,0,0,3,4,2,1,0,1,2,4,51.88
Art,Cybersecurity Analyst,3.6032537368060256,2,2,1,0,0,1,1,4,2,1,1,4,4,0,Arts,High School,31-35,1,1,33,Hybrid,Tier1_City,5,4,4,5,3,5,2,4.99,Finance,4,4,1,5,4,3,5,3,2,1,0,0,3,4,36.67
Law,Inorganic Chemist,2.5738029971080167,7,0,0,0,0,1,4,4,4,2,0,0,0,1,Arts,Bachelors,18-24,3,0,0,Office,Tier2_City,5,1,1,2,0,4,3,49.8,Tech,4,3,1,1,0,3,2,3,4,5,0,1,4,1,51.13
Psychology,Legal Secretary,3.3552742133333178,6,1,1,1,6,1,0,2,3,4,1,0,3,1,Arts,PhD,18-24,11,0,0,Flexible,Tier1_City,5,2,0,1,2,4,3,19.88,Finance,5,4,2,3,4,3,3,5,2,3,0,0,4,1,61.72
Physics,Fluid Mechanics Engineer,4.294458779343851,1,2,0,1,1,0,4,0,4,4,2,3,3,0,Science,Masters,31-35,4,0,0,Remote,Tier2_City,3,2,2,2,4,5,2,25.13,Manufacturing,5,4,1,4,1,3,1,3,5,3,0,1,2,5,66.06
Law,Curriculum Developer,4.554656987024955,6,0,4,1,2,0,2,1,3,0,3,3,2,0,Arts,Bachelors,31-35,12,1,53,Hybrid,Tier3_City,3,5,0,2,1,2,3,38.47,Tech,3,2,3,3,1,1,4,3,3,5,0,1,1,3,63.62
Art,Dentist,3.2066156028287933,8,0,3,0,4,1,0,1,2,1,1,1,3,0,Arts,Bachelors,18-24,6,0,0,Hybrid,Tier2_City,5,3,5,2,3,3,2,16.98,Other,5,3,1,5,4,0,1,5,3,3,0,0,1,1,46.95
Chemistry,Microbiologist,3.7175275839576782,2,0,1,0,3,0,2,2,0,1,4,3,0,1,Science,Bachelors,18-24,0,0,0,Hybrid,Tier1_City,1,5,1,2,4,4,4,12.48,Education,3,3,4,4,5,3,4,1,4,3,1,0,2,1,45.39
Law,Data Scientist,3.051570718338155,1,2,1,1,4,1,4,2,0,2,3,0,3,1,Arts,Bachelors,36-40,13,1,33,Office,Tier1_City,3,3,3,1,4,3,5,8.99,Tech,1,2,2,4,0,0,5,3,1,2,0,1,1,4,52.22
Biology,School Counselor,3.009838061294767,3,1,2,1,1,0,4,2,4,4,4,4,1,0,Science,Masters,31-35,7,0,0,Office,Tier3_City,2,3,5,3,2,3,1,27.82,Tech,2,1,3,1,5,5,4,5,5,1,0,0,2,4,67.14
Art,Art Therapist,3.7366915086351935,4,0,1,1,8,1,0,0,4,3,1,2,1,1,Arts,Bachelors,25-30,9,1,22,Hybrid,Tier2_City,5,3,3,2,4,0,3,3.26,Healthcare,2,4,2,2,2,0,3,2,1,3,1,0,4,4,47.52
Computer Science,Biologist,2.6913492533949643,1,2,0,0,9,1,3,1,2,4,4,2,0,0,Science,Masters,31-35,2,0,0,Remote,Tier1_City,1,3,5,4,3,2,2,36.35,Other,2,1,1,2,4,3,3,2,1,4,1,0,4,3,53.33
Music,Artist,3.256563365162714,7,2,4,1,5,1,4,2,1,1,4,2,2,1,Arts,Masters,18-24,13,0,0,Remote,Any,3,5,0,5,5,3,5,24.69,Tech,1,2,3,1,5,5,3,4,2,5,1,1,1,1,66.17
Finance,Human Resources Specialist,3.844125835899805,2,0,2,0,5,1,2,4,3,3,0,1,4,0,Commerce,Bachelors,25-30,10,0,0,Hybrid,Tier2_City,2,2,0,5,5,2,3,28.0,Other,2,2,2,5,5,1,3,5,3,3,0,0,1,2,65.51
Marketing,Clinical Psychologist,3.554802513002984,2,0,2,0,7,0,1,0,3,3,2,3,4,0,Commerce,Bachelors,18-24,5,1,54,Remote,Tier3_City,3,2,0,4,4,2,5,15.37,Manufacturing,3,2,1,5,2,2,2,3,2,4,1,0,4,1,52.69
Law,Artist,2.6456263233603416,7,0,2,1,0,0,0,1,4,4,4,2,1,0,Arts,Bachelors,25-30,3,0,0,Office,Tier1_City,2,5,0,2,3,0,4,11.38,Other,4,2,1,2,4,2,1,2,5,1,1,0,5,5,48.36
Art,Counselor,3.326037086508028,1,1,2,0,3,1,3,0,4,1,2,2,0,1,Arts,Masters,18-24,13,1,41,Hybrid,Tier1_City,5,4,4,1,3,5,3,35.9,Finance,2,5,2,3,5,1,5,3,1,1,1,0,5,3,52.71
Physics,Musician,4.14980213602708,5,0,2,1,9,0,4,0,3,4,1,3,4,0,Science,Bachelors,25-30,4,0,0,Office,Tier2_City,1,1,0,3,0,2,2,12.88,Finance,2,2,2,1,3,4,5,5,4,1,1,1,3,5,45.79
Psychology,Investment Banker,3.178512414956612,6,1,1,0,2,1,4,2,3,2,2,4,2,1,Arts,Masters,25-30,9,0,0,Hybrid,Tier2_City,4,3,4,5,2,3,4,39.66,Other,3,1,2,3,0,3,5,2,4,3,0,0,3,4,68.91
Architecture,Paralegal,3.544973055351676,8,2,0,1,0,0,1,1,2,4,4,0,2,0,Interdisciplinary,Masters,25-30,11,0,0,Office,Tier1_City,3,5,1,3,1,5,3,12.57,Education,3,2,3,1,3,5,1,4,1,2,0,1,1,2,49.32
Psychology,Lawyer,4.315489523516352,2,2,4,0,9,0,1,0,1,2,1,0,0,1,Arts,Bachelors,18-24,14,1,57,Flexible,Tier2_City,1,3,0,1,0,5,5,31.8,Healthcare,2,1,3,1,5,4,4,2,1,3,1,0,3,3,38.07
Music,Microbiologist,4.8600279339188255,0,0,2,0,9,1,1,0,4,0,4,0,1,0,Arts,PhD,25-30,5,0,0,Office,Tier2_City,4,3,0,5,1,1,4,33.26,Finance,5,2,4,2,5,0,5,4,1,2,1,0,5,3,47.94
Engineering,Biochemist,2.511181866803874,6,1,1,1,9,0,4,1,1,3,2,1,3,0,Science,PhD,31-35,1,0,0,Hybrid,Tier1_City,5,3,3,3,3,3,2,26.77,Finance,1,2,3,2,3,2,5,5,4,5,1,1,2,2,55.03
Medicine,Chemical Engineer,2.556990115442308,6,2,0,0,1,0,2,3,3,4,3,0,4,1,Science,Bachelors,25-30,12,1,14,Remote,Tier2_City,2,5,1,1,5,3,3,49.85,Tech,4,5,1,3,5,4,2,1,4,2,1,0,2,5,62.26
Art,Actuary,3.579782942880583,9,0,1,1,7,1,0,1,0,3,2,2,3,0,Arts,Bachelors,31-35,14,0,0,Hybrid,Tier1_City,5,2,1,3,0,2,5,20.66,Other,4,2,3,5,5,0,5,5,2,4,1,1,5,1,49.22
Computer Science,Mechanical Engineer,2.6303284224804697,1,2,4,1,1,0,0,2,2,0,1,3,3,1,Science,PhD,25-30,2,0,0,Hybrid,Tier2_City,1,4,0,2,4,3,5,44.52,Manufacturing,1,4,2,4,0,0,5,4,4,1,0,0,2,5,44.86
Biology,Doctor,4.634125412585611,4,2,2,0,4,0,4,1,3,1,1,2,3,1,Science,PhD,25-30,14,0,0,Flexible,Tier1_City,1,4,1,1,4,1,4,10.95,Other,2,5,2,3,4,1,4,3,2,3,0,1,3,2,64.62
Engineering,Game Developer,3.513852512411732,1,2,2,0,2,1,4,1,1,3,0,4,1,1,Science,Bachelors,25-30,7,0,0,Hybrid,Tier2_City,3,5,2,3,1,2,3,18.85,Other,2,5,3,1,0,0,5,2,5,2,1,1,1,1,53.65
Education,Manager,3.5759623600147674,7,2,4,0,6,0,4,1,4,2,3,4,1,0,Arts,High School,40+,7,0,0,Hybrid,Tier1_City,4,1,5,2,3,4,5,9.83,Manufacturing,2,4,1,4,0,4,5,2,1,1,1,1,5,3,55.23
Architecture,Physician Assistant,2.6883260706941297,1,2,1,1,5,0,4,2,2,3,0,4,0,1,Interdisciplinary,Bachelors,18-24,0,1,7,Office,Tier3_City,4,4,3,2,5,3,4,31.37,Education,2,5,4,4,1,0,1,4,5,1,1,0,4,2,47.02
Medicine,Manager,2.5229333787660884,6,1,3,0,3,0,0,3,3,4,1,4,3,0,Science,PhD,18-24,9,0,0,Hybrid,Tier2_City,3,4,1,1,1,3,1,33.0,Manufacturing,2,2,2,4,1,3,2,2,4,2,0,1,4,5,66.39
Chemistry,Industrial-Organizational Psychologist,3.102958467701784,8,0,2,1,5,0,3,1,1,4,4,2,4,1,Science,Bachelors,31-35,7,0,0,Hybrid,Tier2_City,5,3,2,4,5,0,5,24.31,Finance,4,4,5,4,5,5,1,4,3,5,1,0,1,2,63.44
Art,Graphic Designer,4.677282079417488,7,0,1,0,5,0,1,3,1,1,4,3,3,0,Arts,Bachelors,36-40,10,1,47,Remote,Any,4,5,0,5,2,4,4,36.85,Tech,2,2,4,4,2,1,5,3,3,1,0,1,2,3,54.91
Computer Science,AI Researcher,4.821265398157534,9,1,0,0,1,0,0,4,2,2,1,3,3,0,Science,Masters,40+,1,0,0,Remote,Tier1_City,5,2,3,1,5,4,1,43.78,Manufacturing,3,5,5,3,0,3,2,1,4,5,1,1,4,4,57.96
Business,Microbiologist,3.200687286349245,8,1,0,0,2,0,2,2,0,4,2,1,1,1,Commerce,High School,25-30,9,1,10,Office,Tier2_City,2,5,5,2,4,1,4,39.5,Healthcare,5,3,5,2,3,4,4,5,3,5,1,0,4,3,57.63
Psychology,Astronomer,3.30907931086052,3,2,2,0,5,1,4,3,2,3,0,3,2,0,Arts,Masters,25-30,9,0,0,Office,Tier1_City,1,5,3,2,0,4,5,14.36,Healthcare,2,4,5,2,3,5,1,3,5,3,0,0,5,3,64.64
Art,Art Therapist,4.080810919200851,3,2,0,0,8,1,2,4,3,3,2,0,3,1,Arts,Bachelors,31-35,12,0,0,Hybrid,Any,2,4,3,1,0,0,1,18.06,Healthcare,3,1,2,1,1,0,4,3,2,2,1,1,2,4,49.91
Biology,Aerospace Engineer,4.02624117360662,3,0,3,0,5,0,4,0,3,2,3,1,1,1,Science,Masters,25-30,7,0,0,Hybrid,Tier3_City,3,3,2,4,0,1,4,20.87,Manufacturing,4,5,2,5,5,4,5,2,3,4,1,1,2,2,61.17
Law,Industrial-Organizational Psychologist,2.663796644145215,6,1,3,0,3,1,0,0,1,3,0,4,4,0,Arts,Bachelors,31-35,11,0,0,Hybrid,Tier3_City,4,5,4,5,5,4,3,12.58,Tech,3,3,5,3,0,0,5,2,5,4,0,1,1,4,60.93
Finance,School Counselor,3.088908857621985,8,2,3,0,8,1,0,4,2,4,0,0,0,0,Commerce,Masters,36-40,9,0,0,Hybrid,Tier1_City,2,2,3,3,4,1,1,19.98,Manufacturing,1,5,5,4,4,0,2,1,2,3,1,0,5,3,56.52
Architecture,Architect,4.044456880738271,7,1,4,0,9,1,0,0,3,2,2,1,1,0,Interdisciplinary,Masters,31-35,4,0,0,Remote,Tier1_City,1,3,2,1,5,4,4,14.19,Finance,1,2,4,2,5,0,4,4,3,2,0,1,1,1,47.64
Business,Legal Analyst,4.231417607010806,4,2,0,1,5,1,3,1,3,1,3,2,4,1,Commerce,Bachelors,25-30,0,0,0,Office,Tier1_City,4,3,5,5,3,4,3,49.8,Manufacturing,3,2,2,1,1,1,5,4,5,5,0,1,3,1,53.13
Finance,Actuary,2.6107681263313167,3,0,2,0,0,0,1,4,4,4,4,0,4,1,Commerce,High School,25-30,7,0,0,Hybrid,Tier2_City,5,2,4,5,4,5,1,39.81,Other,2,2,5,4,1,4,4,3,3,5,0,0,1,5,62.98
Art,Physicist,3.5744683238829618,1,2,3,0,8,1,1,2,4,0,1,1,2,1,Arts,Bachelors,31-35,11,0,0,Hybrid,Tier1_City,4,2,2,2,4,4,4,43.42,Healthcare,2,3,1,1,5,1,4,3,5,5,1,1,3,5,62.27
Biology,Composer,4.939633371038745,3,1,4,0,1,0,1,2,0,4,4,2,2,1,Science,Bachelors,25-30,4,0,0,Remote,Tier1_City,1,2,2,3,5,3,5,46.34,Healthcare,2,2,2,4,3,0,2,2,5,4,0,1,2,3,56.58
Computer Science,Zoologist,3.43563365584685,1,0,1,0,5,1,0,3,4,2,4,0,0,0,Science,Masters,25-30,14,0,0,Hybrid,Tier2_City,4,5,2,1,5,4,1,34.26,Other,3,5,2,4,5,5,2,4,4,4,1,1,1,2,70.13
Finance,Manager,3.922889355291528,5,1,2,1,6,0,4,2,1,4,4,2,3,0,Commerce,Masters,18-24,0,0,0,Remote,Tier3_City,2,3,3,2,0,3,1,11.27,Tech,1,5,1,2,5,1,5,1,1,4,1,1,5,4,48.31
Chemistry,Nuclear Physicist,3.9247302712444254,4,2,1,1,8,0,4,3,3,3,4,4,4,0,Science,Bachelors,18-24,14,0,0,Hybrid,Tier1_City,3,3,0,2,4,2,3,38.65,Education,1,5,5,2,4,1,5,3,4,1,0,1,4,2,70.7
Physics,Civil Engineer,4.739031752452665,8,2,4,0,3,1,1,4,1,4,2,1,4,1,Science,Masters,25-30,3,1,6,Hybrid,Any,2,1,5,4,0,5,4,3.73,Healthcare,4,4,3,4,4,2,4,2,4,3,1,1,5,2,51.45
Law,AI Researcher,3.097748972310334,4,2,4,0,5,0,4,3,1,1,1,2,1,1,Arts,Masters,36-40,12,0,0,Hybrid,Tier1_City,4,1,3,5,3,0,5,8.32,Healthcare,1,5,2,2,3,1,1,5,3,4,1,1,4,4,65.5
Business,Architect,2.9375578346179534,9,2,0,1,5,0,0,2,0,1,0,3,1,0,Commerce,Masters,25-30,0,0,0,Remote,Tier1_City,5,1,5,1,2,1,3,4.39,Education,1,2,5,3,3,4,5,5,4,1,0,1,4,1,32.46
Physics,Investment Banker,2.6140259352142503,4,2,4,0,7,1,1,3,1,0,1,1,2,1,Science,Bachelors,25-30,12,0,0,Flexible,Tier3_City,4,5,5,1,0,1,1,9.37,Manufacturing,5,4,1,4,3,3,4,5,4,4,1,1,1,1,50.57
Business,Art Director,3.7908072034770153,7,0,4,0,2,1,2,0,0,1,3,3,3,1,Commerce,Bachelors,25-30,8,0,0,Hybrid,Tier2_City,1,5,3,1,5,2,3,38.34,Healthcare,1,4,1,2,4,4,4,5,3,1,0,1,5,4,46.02
Art,Doctor,3.1288888570142444,6,0,1,1,5,0,1,2,0,2,0,2,4,0,Arts,Bachelors,18-24,9,1,52,Hybrid,Any,2,2,3,2,1,4,3,44.62,Tech,3,4,2,1,4,4,3,3,5,4,1,1,2,4,49.39
Architecture,Chemist,3.2457513732818963,3,0,1,1,1,0,0,0,2,0,3,1,2,0,Interdisciplinary,Bachelors,40+,1,0,0,Hybrid,Tier2_City,2,5,3,4,2,0,3,16.11,Manufacturing,2,4,1,1,1,3,3,4,1,1,1,1,5,1,25.77
Education,Geneticist,4.1999469114828045,9,0,1,1,2,1,4,1,0,2,2,0,3,0,Arts,Bachelors,36-40,7,0,0,Hybrid,Any,4,3,4,3,3,2,1,8.6,Manufacturing,3,3,1,1,2,1,1,4,3,1,0,1,4,2,42.62
Education,Biomedical Engineer,4.004308925462531,1,0,1,0,9,1,1,3,0,4,2,3,4,1,Arts,Bachelors,18-24,3,0,0,Hybrid,Tier1_City,3,3,4,2,5,2,2,15.83,Healthcare,2,5,5,5,1,3,2,4,3,2,1,1,2,4,51.7
Physics,Marketing Manager,3.6055354704448654,3,0,0,1,4,0,2,4,0,2,1,1,2,0,Science,Bachelors,31-35,8,1,6,Office,Tier2_City,4,4,2,3,2,1,3,33.41,Manufacturing,2,3,1,1,0,3,1,1,5,4,1,1,2,1,55.46
Biology,Teacher,4.333161739378058,8,2,3,0,3,1,1,1,4,4,4,2,3,0,Science,Masters,25-30,1,1,12,Office,Any,3,4,1,4,5,3,2,19.46,Manufacturing,4,1,3,1,5,4,1,1,1,3,1,0,3,4,49.09
Art,Credit Analyst,4.904656971038518,9,1,0,1,4,0,4,0,4,1,1,2,3,0,Arts,Bachelors,40+,11,0,0,Hybrid,Tier1_City,4,5,5,5,0,3,5,48.17,Tech,1,3,5,3,5,5,5,4,4,4,0,0,3,2,61.83
Chemistry,Sound Engineer,3.36897200647603,3,0,2,0,4,0,3,1,0,2,0,2,4,0,Science,Bachelors,25-30,2,0,0,Hybrid,Tier1_City,2,4,1,1,5,4,5,9.16,Manufacturing,4,4,5,3,2,4,4,3,2,3,0,0,3,1,40.21
Architecture,Advertising Manager,2.6507196332240586,2,0,4,0,1,1,3,4,2,0,3,0,2,0,Interdisciplinary,Bachelors,18-24,1,1,54,Remote,Tier1_City,3,5,0,3,3,4,5,49.55,Other,2,5,2,5,4,5,1,5,4,1,0,1,4,4,46.45
Engineering,Web Developer,4.608786551910085,8,0,4,1,8,0,0,2,4,1,2,0,3,0,Science,Bachelors,25-30,9,0,0,Remote,Any,1,2,2,2,1,2,4,3.59,Healthcare,5,5,5,3,5,2,2,5,5,5,0,1,3,4,61.41
Engineering,Digital Marketing Specialist,3.0060755591880213,4,1,3,0,4,0,3,4,0,3,0,4,2,1,Science,Masters,36-40,13,0,0,Hybrid,Tier2_City,3,2,5,3,0,4,1,24.23,Healthcare,5,2,2,2,1,0,4,4,1,2,1,0,2,3,51.47
Computer Science,Counselor,4.265783654942947,9,1,0,0,7,1,3,3,1,4,0,4,0,0,Science,Bachelors,18-24,4,1,8,Flexible,Tier2_City,5,4,0,5,0,3,2,14.84,Other,4,3,1,1,4,1,5,2,3,2,1,1,1,3,47.43
Biology,Interior Designer,3.2359393868885427,9,2,1,0,9,1,3,4,4,3,4,1,4,1,Science,Bachelors,31-35,10,0,0,Hybrid,Tier3_City,1,5,4,1,3,0,4,29.62,Other,4,5,4,2,2,3,3,3,1,2,0,1,5,2,63.05
Physics,Investment Banker,3.877642950689153,0,0,4,1,7,1,2,2,1,2,4,0,0,1,Science,Bachelors,18-24,0,0,0,Office,Tier3_City,4,4,3,3,3,1,2,7.54,Other,1,1,3,5,5,4,1,2,5,3,0,1,3,2,46.42
Computer Science,Legal Analyst,3.107711719637679,6,0,1,1,7,0,4,0,4,4,2,3,1,0,Science,Bachelors,36-40,11,0,0,Remote,Tier2_City,5,3,0,5,2,3,1,44.16,Education,4,1,3,2,4,5,4,2,1,1,0,1,5,4,58.37
Music,Game Developer,4.434968256716783,3,0,0,1,9,0,0,2,1,4,1,1,0,0,Arts,Bachelors,18-24,2,1,46,Hybrid,Any,1,5,0,2,1,5,3,9.42,Finance,4,3,1,2,5,4,3,3,5,3,1,0,4,1,41.23
Finance,Data Scientist,4.3312685164822735,1,0,0,1,2,1,4,3,1,4,4,4,2,1,Commerce,Masters,36-40,0,0,0,Hybrid,Tier2_City,4,1,4,4,5,4,4,30.61,Education,3,2,4,2,1,1,5,3,1,5,1,0,2,2,57.24
Engineering,Conductor,3.602797594178664,4,1,2,0,2,0,2,0,1,4,1,1,1,0,Science,Bachelors,25-30,9,1,37,Office,Tier2_City,3,3,2,2,2,1,1,4.57,Tech,4,1,5,3,2,2,2,1,1,2,0,0,4,4,43.52
Computer Science,Fluid Mechanics Engineer,2.7946131952500024,2,1,1,0,9,0,0,0,2,0,2,4,2,0,Science,Bachelors,25-30,14,0,0,Remote,Tier1_City,4,5,3,1,5,5,4,17.62,Tech,4,2,4,1,5,4,5,1,1,3,1,1,1,4,49.54
Music,School Psychologist,4.050846384012646,9,2,1,1,8,0,0,4,4,4,4,3,4,1,Arts,High School,40+,13,1,42,Hybrid,Tier1_City,2,4,3,2,5,1,5,10.04,Healthcare,3,3,5,2,1,3,2,5,2,5,1,0,4,2,69.49
Business,Chemical Engineer,4.801375087018,5,0,4,1,1,1,0,0,0,0,4,4,4,0,Commerce,Bachelors,40+,7,1,45,Flexible,Any,1,4,2,2,5,2,4,48.96,Finance,2,5,5,4,5,1,2,1,3,4,0,1,3,1,51.1
Business,Biochemist,3.660038930005163,0,1,0,1,0,0,2,1,0,1,2,4,4,0,Commerce,Masters,31-35,14,0,0,Flexible,Tier1_City,3,4,5,2,2,4,3,3.57,Education,2,2,5,1,1,3,2,2,2,5,0,0,2,2,59.92
Business,School Psychologist,2.950873855899998,0,2,0,0,9,1,4,3,1,1,2,4,4,1,Commerce,Masters,18-24,11,0,0,Flexible,Tier1_City,4,5,4,2,0,2,3,19.56,Finance,3,1,4,1,4,0,5,3,1,5,1,0,1,2,58.3
Physics,Geneticist,3.1796265935633192,0,1,3,1,6,1,0,0,3,3,1,3,4,1,Science,Masters,25-30,3,0,0,Hybrid,Tier2_City,3,4,5,1,3,1,2,17.23,Healthcare,1,2,1,4,2,4,1,5,3,1,1,0,3,4,42.67
Psychology,Teacher,3.836340270918855,9,0,1,0,4,0,2,2,3,4,3,1,0,0,Arts,Bachelors,25-30,2,0,0,Flexible,Tier2_City,3,5,4,5,0,2,4,33.9,Manufacturing,4,5,5,5,4,5,3,1,4,3,1,1,5,2,50.76
Biology,Clinical Psychologist,4.05593411135386,9,1,1,0,0,1,0,3,0,0,1,3,3,0,Science,Bachelors,25-30,7,0,0,Office,Tier1_City,1,5,0,3,1,4,5,5.65,Healthcare,1,5,1,5,5,1,4,5,1,3,1,0,5,5,41.69
Law,Astronomer,3.5259550526186154,3,0,1,1,4,0,4,0,2,2,2,3,0,0,Arts,Masters,25-30,12,1,6,Flexible,Tier3_City,3,4,1,4,2,3,3,41.1,Healthcare,5,1,5,1,2,4,1,4,1,2,1,0,3,2,55.28
Chemistry,Market Research Analyst,4.041768915871657,7,0,2,1,2,1,1,2,3,3,2,2,4,1,Science,PhD,18-24,8,0,0,Flexible,Tier2_City,1,2,1,3,1,0,2,24.93,Finance,1,2,1,3,0,0,1,1,3,5,1,0,3,4,63.02
Psychology,Conductor,3.368891251171372,2,2,0,0,9,0,1,1,0,2,4,2,3,0,Arts,Bachelors,31-35,7,0,0,Flexible,Any,3,2,4,3,3,5,5,24.28,Tech,4,2,1,5,0,1,4,5,4,5,0,1,5,2,55.8
Education,Software Developer,3.217964141065038,1,2,2,1,6,0,1,2,2,2,0,0,3,1,Arts,Bachelors,31-35,5,0,0,Remote,Tier2_City,3,3,2,4,3,3,5,13.66,Manufacturing,2,4,1,5,2,3,4,3,1,5,0,1,1,3,45.95
Finance,Brand Manager,3.599789046101707,4,0,2,0,7,1,2,1,4,3,0,1,4,1,Commerce,Bachelors,18-24,13,0,0,Remote,Tier2_City,4,5,5,1,4,1,5,26.03,Manufacturing,4,1,2,2,4,3,3,2,1,4,0,0,2,4,54.43
Physics,Civil Engineer,3.801897649420824,3,0,1,1,5,0,2,0,4,0,1,3,3,0,Science,Bachelors,25-30,14,0,0,Office,Tier1_City,5,4,2,4,1,3,1,20.1,Tech,4,2,4,2,3,0,1,3,5,5,0,0,5,3,60.8
Medicine,Market Research Analyst,2.7508441451957992,2,0,1,1,0,1,1,4,0,1,4,2,0,0,Science,Bachelors,25-30,2,1,38,Hybrid,Tier1_City,1,4,1,1,0,2,3,14.52,Finance,4,3,5,5,2,4,3,4,2,5,0,0,5,3,43.76
Biology,Education Administrator,3.16140053143348,0,0,3,1,9,1,4,0,4,3,4,2,1,1,Science,Bachelors,31-35,7,0,0,Hybrid,Tier1_City,2,4,5,3,1,4,1,10.93,Finance,1,4,5,3,1,1,1,1,3,4,1,1,2,1,65.24
Medicine,Financial Analyst,4.0100588168846745,3,1,4,1,1,0,0,1,2,3,1,3,3,0,Science,Masters,18-24,12,1,13,Office,Tier1_City,1,2,2,1,2,3,1,37.23,Tech,2,1,2,2,0,3,4,4,2,2,1,0,2,2,52.53
Marketing,Dentist,3.374530240712934,3,1,0,0,9,1,3,4,3,2,3,3,3,1,Commerce,Bachelors,31-35,4,1,50,Remote,Any,3,1,2,5,3,3,3,9.68,Education,2,5,1,3,2,3,2,2,1,1,1,0,3,2,52.23
Engineering,Counselor,3.635537461439725,3,2,2,1,9,1,3,4,3,0,3,1,1,0,Science,Bachelors,25-30,4,1,13,Remote,Any,5,5,5,4,3,4,4,10.9,Finance,1,1,1,1,2,4,3,1,2,2,1,1,4,2,45.95
Psychology,Illustrator,4.827988192702378,1,1,3,0,4,1,0,0,4,2,3,0,0,1,Arts,High School,25-30,11,0,0,Hybrid,Tier2_City,1,3,3,5,1,2,2,30.12,Tech,1,3,5,3,2,0,3,1,4,3,1,0,2,3,51.28
Law,Psychologist,4.0228120753298775,0,2,2,0,9,0,4,3,3,0,1,3,0,0,Arts,Masters,31-35,8,0,0,Remote,Tier1_City,3,3,5,3,1,0,3,13.63,Education,1,3,3,2,1,0,2,2,1,5,1,1,2,5,58.64
Education,Teacher,3.733532343043719,2,0,1,0,0,0,0,4,1,0,3,2,3,0,Arts,Bachelors,31-35,0,0,0,Office,Tier1_City,2,3,2,4,5,3,2,24.59,Healthcare,5,5,5,4,4,0,1,4,3,4,1,1,4,5,42.38
Art,Physician Assistant,3.7520225737216615,4,0,2,0,4,1,2,3,4,0,4,2,1,0,Arts,Masters,18-24,6,0,0,Flexible,Tier1_City,4,5,3,3,1,5,4,28.99,Manufacturing,5,5,5,3,3,3,2,3,5,3,1,0,4,5,62.78
Marketing,Lawyer,4.916187816666697,4,1,4,0,6,0,4,2,2,4,1,0,4,0,Commerce,Bachelors,25-30,7,1,19,Office,Any,4,5,5,5,5,1,3,15.9,Tech,4,5,2,5,1,3,2,2,1,2,0,1,4,1,51.58
Physics,Surgeon,3.148243526453635,2,2,2,0,5,0,3,1,1,4,4,3,2,0,Science,Masters,40+,10,0,0,Office,Tier2_City,1,3,3,3,2,2,5,19.15,Finance,5,4,1,3,3,3,5,5,3,3,1,1,3,1,65.16
Engineering,Legal Analyst,3.021052283960884,9,0,4,0,9,0,3,0,1,3,0,3,0,1,Science,Bachelors,18-24,9,0,0,Remote,Tier3_City,1,3,5,4,2,2,3,12.88,Manufacturing,1,3,4,3,0,5,1,3,4,1,0,0,1,3,51.68
Finance,Risk Analyst,3.692329604793583,1,1,1,0,9,0,3,0,0,3,4,1,3,1,Commerce,Bachelors,36-40,2,0,0,Hybrid,Tier2_City,2,4,1,4,0,3,4,24.64,Education,1,5,5,3,3,5,2,1,5,5,1,0,5,4,49.22
Law,Fluid Mechanics Engineer,2.591020454692983,8,1,1,0,6,1,1,2,3,4,0,1,4,1,Arts,Bachelors,31-35,7,0,0,Office,Tier2_City,4,1,3,3,1,5,1,49.64,Manufacturing,1,3,5,5,3,3,2,2,1,4,1,0,5,3,50.88
Art,Financial Analyst,2.761047707292218,4,2,0,0,0,1,0,0,1,1,1,3,3,0,Arts,Bachelors,31-35,0,0,0,Office,Tier2_City,3,2,4,4,0,4,3,20.05,Other,2,4,4,3,0,3,5,2,2,2,1,0,1,4,29.73
Engineering,Accountant,4.702256612433774,0,0,4,0,1,1,0,4,0,3,3,4,2,0,Science,Bachelors,25-30,7,0,0,Remote,Tier1_City,1,5,0,4,4,3,5,33.71,Tech,2,4,2,4,1,3,5,5,2,5,1,0,1,5,57.7
Marketing,Art Therapist,3.347193458243889,9,0,4,1,1,0,0,3,4,3,1,4,1,1,Commerce,Masters,25-30,6,1,15,Office,Tier2_City,5,1,3,3,2,3,3,32.89,Healthcare,5,3,3,5,1,2,5,4,1,3,0,0,4,4,54.5
Physics,Ecologist,3.4462026054557127,1,2,1,0,1,0,2,0,4,0,1,1,1,0,Science,Bachelors,36-40,3,0,0,Flexible,Any,4,3,4,5,3,4,1,39.96,Education,3,5,2,4,0,5,4,5,3,1,0,1,4,4,41.43
Marketing,Fluid Mechanics Engineer,2.667588424835677,6,0,4,1,4,1,0,4,2,4,2,1,0,0,Commerce,High School,25-30,10,0,0,Remote,Tier2_City,3,3,4,4,5,1,3,36.46,Education,3,1,5,4,1,1,3,5,4,3,1,0,4,4,60.12
Education,Physicist,3.7817807411440887,6,1,1,1,8,1,1,2,1,0,4,1,2,0,Arts,Bachelors,18-24,6,0,0,Remote,Tier2_City,4,3,2,4,4,4,5,3.55,Education,1,2,2,4,4,0,5,4,3,1,1,0,3,2,48.03
Psychology,Urban Planner,2.864937320822827,9,2,4,0,2,0,2,0,1,0,3,3,0,1,Arts,Masters,31-35,9,0,0,Hybrid,Tier2_City,2,3,4,4,3,3,4,17.53,Manufacturing,2,3,4,5,5,1,1,1,3,1,1,1,1,3,52.45
Education,Financial Analyst,4.684870971623439,1,1,1,0,6,1,1,4,0,1,3,3,1,0,Arts,PhD,18-24,13,0,0,Remote,Tier1_City,5,4,2,4,4,0,5,43.9,Healthcare,4,4,2,2,3,5,4,2,2,2,0,1,1,1,61.6
Chemistry,Brand Manager,4.701208296050851,3,1,0,0,3,0,3,2,1,4,2,4,1,1,Science,Masters,31-35,10,1,16,Flexible,Tier2_City,3,5,4,3,0,4,4,28.36,Tech,5,5,5,5,1,4,3,3,1,4,1,1,3,2,65.07
Music,School Psychologist,3.580914442665195,8,0,1,1,3,1,2,0,1,2,3,3,2,1,Arts,Bachelors,31-35,6,0,0,Flexible,Tier1_City,3,3,1,5,0,1,5,7.9,Tech,2,2,4,3,3,0,4,1,5,1,1,1,1,5,45.55
Music,Legal Consultant,4.3709320327130685,8,0,0,0,9,0,1,0,1,4,3,3,0,0,Arts,Masters,36-40,12,0,0,Hybrid,Any,1,3,1,5,5,4,2,15.98,Manufacturing,1,3,4,4,5,5,5,1,2,3,0,0,4,2,60.26
Computer Science,Forensic Psychologist,4.100819165005799,7,1,3,0,2,0,3,0,4,4,2,1,2,1,Science,PhD,31-35,9,1,38,Office,Tier1_City,2,5,1,1,2,4,3,16.32,Other,1,1,5,3,5,0,2,1,2,5,0,1,4,3,71.39
Engineering,Interior Designer,4.754478522615465,7,2,0,0,9,0,4,3,1,0,4,3,2,0,Science,Masters,18-24,12,1,38,Office,Tier2_City,2,2,1,4,5,2,3,44.04,Tech,3,1,5,4,1,3,2,3,1,4,0,0,4,1,65.89
Biology,Industrial-Organizational Psychologist,4.905577373988627,3,2,4,0,9,1,2,3,2,1,4,4,2,0,Science,Bachelors,25-30,11,0,0,Hybrid,Tier1_City,3,4,5,4,3,2,1,29.01,Tech,1,4,5,4,3,3,4,2,5,2,1,0,4,4,67.95
Architecture,Acoustics Specialist,3.573267814733324,9,1,4,0,9,1,4,4,1,4,3,1,3,1,Interdisciplinary,Bachelors,31-35,0,0,0,Hybrid,Tier1_City,4,4,1,1,4,3,2,31.59,Healthcare,1,4,3,3,0,4,3,1,5,5,0,0,4,5,59.34
Music,Data Scientist,3.779679946208253,3,1,0,0,3,0,0,2,3,2,3,4,0,0,Arts,Bachelors,25-30,2,1,10,Office,Tier2_City,3,1,4,5,5,3,1,20.25,Manufacturing,4,4,5,1,0,1,3,5,3,1,0,0,2,5,46.46
Music,Biologist,4.631354875404946,4,1,4,1,2,1,3,0,2,3,0,2,3,0,Arts,Bachelors,40+,6,0,0,Office,Any,3,4,3,2,1,4,3,5.83,Manufacturing,5,3,2,4,0,1,1,3,2,1,0,1,4,4,39.39
Medicine,Zoologist,2.7350279526518566,0,0,4,0,6,0,1,2,4,4,0,1,3,1,Science,Masters,31-35,10,0,0,Remote,Tier3_City,3,1,3,2,1,0,1,6.54,Education,4,1,1,1,4,1,5,4,3,1,1,0,2,1,50.42
Physics,Game Developer,4.294194529731201,6,1,4,0,3,1,0,1,0,1,0,0,2,0,Science,Bachelors,18-24,12,0,0,Hybrid,Tier1_City,3,2,3,5,2,5,4,22.76,Tech,3,1,3,5,4,4,2,2,5,4,1,0,3,1,51.5
Marketing,Nurse,4.812766466267061,6,2,1,1,3,0,1,2,4,3,4,1,4,0,Commerce,Bachelors,36-40,4,0,0,Hybrid,Tier2_City,3,5,1,4,5,3,2,11.34,Finance,2,4,3,4,0,2,3,5,1,1,0,1,3,3,51.27
Physics,Mechanical Engineer,2.6727561705883645,7,1,4,1,8,0,3,3,3,1,4,3,4,1,Science,Masters,18-24,8,0,0,Office,Tier1_City,3,3,1,2,3,4,5,7.9,Other,3,4,1,4,3,1,1,3,3,5,1,1,2,5,72.47
Education,Conductor,2.725312692747913,0,0,0,0,4,0,0,3,1,1,4,3,2,0,Arts,Masters,18-24,6,0,0,Hybrid,Tier2_City,4,1,4,3,1,4,4,15.33,Healthcare,1,5,2,5,0,0,4,3,1,5,1,1,1,3,54.64
Biology,Chemist,4.154876237647298,0,2,1,0,1,1,2,4,4,0,4,1,0,0,Science,Bachelors,31-35,2,0,0,Hybrid,Tier1_City,5,4,5,3,2,5,5,37.88,Healthcare,5,1,3,3,0,0,1,4,3,1,0,0,4,4,46.07
Marketing,Actuary,3.570584311060564,1,2,3,0,6,0,3,2,0,2,3,3,4,1,Commerce,Masters,36-40,14,1,22,Office,Tier3_City,5,3,3,1,5,4,1,6.43,Other,1,4,3,3,2,3,2,3,1,4,0,1,5,5,64.66
Education,Interior Designer,4.227576104265602,8,0,4,1,9,0,4,4,3,4,4,4,0,0,Arts,Bachelors,25-30,0,0,0,Hybrid,Tier1_City,1,2,5,5,2,5,3,24.07,Other,5,4,5,1,4,5,5,2,1,3,0,1,1,4,51.93
Chemistry,Pharmacist,2.757066904007784,5,1,4,1,6,0,1,1,2,4,3,2,3,1,Science,Masters,25-30,4,0,0,Remote,Tier1_City,5,5,2,5,3,5,4,41.83,Finance,5,4,4,5,4,3,1,5,2,5,0,0,1,4,59.12
Psychology,Advertising Manager,3.090094186657898,0,0,1,0,1,1,2,0,1,0,2,2,3,1,Arts,Masters,25-30,13,0,0,Flexible,Any,4,1,1,2,1,4,2,15.59,Education,5,5,3,4,0,1,4,3,1,2,0,1,5,2,50.77
Education,Financial Analyst,2.9097274483947926,9,1,1,0,8,0,3,3,3,2,2,0,4,0,Arts,Bachelors,25-30,14,1,13,Remote,Any,3,4,0,4,1,4,5,17.19,Finance,2,1,2,1,0,1,1,4,5,4,1,1,5,5,60.73
Psychology,Construction Manager,3.525728178286325,7,2,4,0,2,1,0,3,4,0,4,1,0,0,Arts,Masters,25-30,12,0,0,Remote,Tier1_City,2,3,0,5,1,2,4,44.56,Other,3,1,4,3,2,3,4,2,1,3,0,1,4,1,54.52
Business,Urban Planner,2.5425839546526854,5,0,1,1,7,0,4,1,1,2,3,0,4,0,Commerce,Masters,18-24,9,1,16,Remote,Tier1_City,4,3,0,2,0,5,3,33.55,Other,2,1,1,4,2,5,1,3,1,2,0,0,2,2,53.93
Art,Architectural Technologist,2.5503400787329973,9,2,2,0,3,1,4,1,1,1,0,2,2,1,Arts,Bachelors,31-35,12,0,0,Remote,Tier3_City,2,3,4,2,1,1,2,40.49,Finance,2,5,3,3,4,0,2,1,4,5,1,1,4,2,59.01
Law,Inorganic Chemist,3.157752099328748,5,1,2,0,1,1,3,0,4,4,1,3,2,1,Arts,Bachelors,36-40,4,0,0,Hybrid,Tier2_City,1,5,2,5,4,5,2,16.59,Education,2,3,2,1,4,5,3,1,2,4,1,0,4,2,52.48
Finance,Physician Assistant,4.557854264137838,0,2,2,1,7,0,4,4,0,1,2,2,1,1,Commerce,Masters,25-30,6,1,14,Hybrid,Any,4,1,1,2,0,1,5,49.85,Finance,4,5,1,3,4,4,5,4,2,4,0,1,4,3,54.41
Biology,Actuary,4.471226325288779,3,2,2,1,1,1,0,0,2,3,3,0,0,0,Science,Bachelors,18-24,13,1,10,Hybrid,Tier1_City,3,5,4,1,5,4,4,9.62,Education,4,2,5,3,4,4,4,1,2,5,0,1,4,5,59.04
Law,Curriculum Developer,4.522925537679042,2,0,2,1,3,0,2,0,0,2,1,1,1,1,Arts,Bachelors,36-40,0,0,0,Remote,Tier1_City,3,4,3,1,0,3,4,48.21,Other,4,5,5,5,3,4,2,1,2,4,0,0,1,3,35.99
Art,Zoologist,3.5991177573921367,1,1,0,0,7,1,0,2,3,2,0,2,4,1,Arts,Masters,31-35,9,0,0,Remote,Tier1_City,4,1,3,5,0,0,2,45.4,Other,2,2,4,1,0,1,4,2,2,5,1,0,1,1,49.32
Medicine,Interior Designer,2.5479394438192364,8,1,0,0,1,0,1,0,4,3,0,3,4,0,Science,Masters,36-40,1,0,0,Hybrid,Tier2_City,4,2,1,4,0,4,1,28.94,Other,1,4,1,4,3,4,3,2,4,4,0,0,2,1,49.93
Architecture,Nurse,3.385196771325452,9,2,0,0,3,1,4,1,0,2,0,4,3,1,Interdisciplinary,Bachelors,18-24,10,0,0,Hybrid,Tier3_City,3,2,5,1,2,0,2,30.51,Tech,4,2,4,3,1,2,4,5,1,5,1,1,5,5,57.77
Education,Investment Banker,4.078260863527631,7,0,3,1,2,1,3,4,2,1,3,4,4,1,Arts,Bachelors,18-24,5,0,0,Hybrid,Tier3_City,2,5,1,1,4,2,3,39.43,Education,4,5,1,3,4,5,3,5,3,4,0,0,3,5,58.71
Business,Paralegal,4.311880765902638,0,1,2,1,4,0,4,1,1,4,3,4,2,1,Commerce,Bachelors,25-30,7,0,0,Remote,Any,4,5,0,5,3,1,4,17.42,Other,2,3,1,2,4,1,3,5,1,1,0,0,2,2,49.66
Computer Science,Paralegal,4.618646523500713,8,1,4,0,8,0,1,2,1,0,3,1,4,1,Science,Bachelors,31-35,3,1,53,Remote,Tier1_City,3,5,2,3,1,2,5,27.79,Manufacturing,3,1,5,1,0,5,4,2,2,1,0,1,4,5,29.84
Architecture,Software Developer,4.5988448135347975,4,0,3,0,6,1,2,1,2,4,2,3,1,0,Interdisciplinary,Bachelors,25-30,2,1,38,Remote,Tier3_City,5,2,0,2,0,3,4,45.41,Manufacturing,1,5,4,1,4,2,2,2,5,3,1,1,4,5,47.05
Law,Aerospace Engineer,3.500127921750696,4,0,4,1,1,1,0,0,0,4,0,3,2,1,Arts,Masters,25-30,2,0,0,Remote,Tier3_City,4,2,2,1,3,3,2,6.21,Finance,5,1,5,4,4,1,1,2,4,3,1,0,1,2,45.68
Psychology,Financial Analyst,2.532451080592252,3,2,4,0,7,0,2,1,1,2,2,2,4,1,Arts,Bachelors,18-24,2,0,0,Office,Tier3_City,1,1,4,3,2,5,3,45.56,Manufacturing,5,2,1,5,3,1,2,1,3,5,0,1,2,1,48.33
Computer Science,Analytical Chemist,3.6689477161290327,5,2,1,1,4,1,2,0,4,2,1,2,3,0,Science,Bachelors,25-30,1,1,18,Hybrid,Tier2_City,1,1,4,4,3,4,1,37.25,Education,1,4,5,4,1,4,2,5,2,1,1,1,5,5,37.99
Finance,Brand Manager,2.6951206071781573,5,0,3,0,2,0,0,2,0,0,3,2,3,1,Commerce,Bachelors,31-35,0,0,0,Remote,Tier2_City,4,5,5,3,0,5,4,39.18,Tech,2,4,4,1,3,1,2,1,3,3,0,0,3,3,30.94
Art,Dentist,4.275872347620128,0,2,0,1,5,0,0,2,1,1,4,3,1,0,Arts,PhD,25-30,14,0,0,Hybrid,Tier2_City,3,3,2,5,5,3,2,6.04,Education,3,5,4,3,2,2,4,5,4,5,1,1,2,1,70.94
Marketing,Marketing Specialist,4.8717265735228,5,0,2,1,5,1,1,1,3,1,1,3,2,0,Commerce,Bachelors,31-35,4,0,0,Hybrid,Tier2_City,2,1,4,4,4,3,2,11.82,Healthcare,3,2,2,5,4,5,1,4,2,4,0,0,5,1,49.13
Physics,Pharmacist,4.174928465053366,4,1,0,1,2,0,4,2,1,2,3,0,4,1,Science,Bachelors,25-30,9,0,0,Hybrid,Tier1_City,4,2,2,4,3,5,2,46.49,Finance,5,2,5,5,3,0,1,1,4,1,0,1,4,4,57.16
Art,Lawyer,4.13082574921604,2,2,1,1,9,0,0,1,0,0,4,1,2,1,Arts,Bachelors,25-30,4,0,0,Remote,Tier2_City,1,4,5,3,0,2,3,8.83,Other,3,1,2,1,0,2,3,5,4,5,0,1,3,3,44.16
Medicine,Graphic Designer,2.8180478886647595,5,2,0,0,7,1,1,0,0,2,1,3,0,0,Science,Masters,25-30,4,1,15,Office,Tier3_City,2,3,5,5,0,0,2,32.67,Tech,5,2,1,1,5,3,1,3,1,5,0,0,3,5,40.03
Chemistry,Dentist,3.3723615461393583,9,0,0,1,2,1,3,3,0,0,4,2,1,1,Science,Masters,25-30,3,0,0,Office,Tier1_City,5,2,5,1,1,1,2,39.79,Finance,4,3,5,4,1,5,2,4,2,2,0,1,5,3,47.62
Art,Legal Secretary,3.687127941487546,9,2,1,0,1,1,2,4,1,0,3,1,1,1,Arts,Bachelors,18-24,14,0,0,Hybrid,Tier2_City,2,3,4,3,5,3,2,13.87,Healthcare,2,4,3,2,5,1,4,1,2,3,0,0,2,2,54.53
Physics,Surgeon,3.1072785715771083,6,2,2,0,5,0,2,4,2,0,2,1,1,1,Science,Bachelors,31-35,2,0,0,Hybrid,Tier2_City,5,4,5,1,1,5,4,35.84,Manufacturing,3,3,2,1,1,2,1,1,5,5,1,0,2,5,47.92
Psychology,Electrical Engineer,3.70845096306592,9,2,3,1,7,1,1,3,1,0,0,4,2,0,Arts,Bachelors,36-40,11,1,21,Remote,Tier3_City,1,5,3,3,5,3,2,6.08,Healthcare,2,3,4,1,0,4,3,3,1,5,1,1,2,1,55.44
Education,Physician Assistant,2.971515728768884,2,0,4,1,3,1,3,4,0,2,3,1,0,1,Arts,Bachelors,25-30,2,1,32,Office,Tier2_City,5,3,1,1,4,2,3,26.44,Manufacturing,4,1,2,4,0,3,1,2,2,3,1,1,3,1,47.91
Biology,Physicist,3.836624275805389,9,2,2,0,0,0,2,0,1,2,4,0,3,1,Science,Bachelors,18-24,1,0,0,Hybrid,Tier2_City,2,4,4,3,1,1,4,18.72,Finance,1,2,5,1,4,0,4,3,2,2,0,1,5,5,31.97
Chemistry,AI Researcher,4.22657414165489,3,1,4,1,7,0,0,2,3,2,0,4,4,0,Science,Bachelors,40+,4,1,15,Remote,Tier2_City,1,4,4,4,4,2,2,33.35,Finance,1,1,2,4,1,2,2,2,3,3,0,0,1,3,45.93
Computer Science,Biochemist,4.091195848256023,6,2,3,0,1,0,4,4,1,3,4,0,3,0,Science,Bachelors,25-30,3,0,0,Hybrid,Tier1_City,2,3,3,2,2,0,1,44.78,Other,1,4,4,1,0,2,1,1,5,2,0,0,3,5,53.39
Business,Web Developer,2.667534392713876,8,0,3,0,0,0,2,2,1,3,0,1,1,1,Commerce,Bachelors,18-24,5,0,0,Flexible,Tier1_City,4,3,0,4,2,2,3,8.9,Other,5,1,2,3,2,2,4,2,4,2,1,1,3,5,42.0
Art,Accountant,4.53335260836967,7,0,0,0,3,0,1,4,2,0,1,0,4,1,Arts,Bachelors,25-30,1,0,0,Hybrid,Tier1_City,2,3,3,1,5,1,1,24.16,Finance,5,3,2,1,1,3,3,3,5,1,0,1,2,5,36.64
Finance,Physician Assistant,3.8889803156630594,3,0,1,0,1,0,0,0,1,4,0,4,1,0,Commerce,Masters,31-35,1,0,0,Hybrid,Tier1_City,4,3,4,5,5,1,3,22.89,Other,1,1,3,2,0,4,2,5,1,1,1,0,1,1,33.71
Business,Forensic Psychologist,4.600953442306095,7,2,4,1,2,1,1,0,3,4,3,3,2,0,Commerce,Bachelors,25-30,7,0,0,Hybrid,Tier2_City,4,5,3,4,1,3,1,18.22,Education,4,2,1,5,3,3,3,4,5,5,0,1,1,4,65.26
Computer Science,Software Developer,4.176644055953655,0,1,4,1,8,1,0,2,1,3,4,0,4,1,Science,Bachelors,25-30,5,0,0,Remote,Any,5,2,3,2,2,0,2,25.57,Tech,5,1,4,4,0,4,5,1,5,5,0,0,4,3,55.0
Physics,Music Teacher,4.812465446721076,9,2,4,1,1,1,4,3,1,1,0,2,1,1,Science,Bachelors,25-30,2,0,0,Hybrid,Tier1_City,4,1,5,1,3,4,1,44.39,Education,1,2,1,2,5,4,3,4,5,5,1,0,1,5,52.72
Architecture,Education Administrator,3.0828173899184907,3,2,1,1,1,1,0,0,3,0,3,0,2,1,Interdisciplinary,PhD,18-24,4,0,0,Office,Any,5,5,3,4,3,3,1,48.76,Healthcare,2,3,3,4,1,0,3,3,3,1,0,1,2,4,44.33
Physics,Risk Analyst,2.6213918479346328,0,2,0,0,2,1,1,3,1,2,0,3,0,1,Science,Masters,25-30,2,0,0,Flexible,Tier2_City,4,3,2,3,3,5,3,3.13,Tech,1,2,5,2,5,1,1,4,1,1,0,1,4,3,38.89
Business,Counselor,4.126557531426426,0,0,1,1,9,1,2,4,2,1,0,4,2,1,Commerce,Bachelors,31-35,10,0,0,Office,Tier1_City,1,4,3,5,2,2,2,37.73,Finance,1,2,5,4,5,5,1,5,4,3,0,1,1,3,58.69
Art,Judge,2.8119674863287814,6,2,3,1,5,0,4,4,0,4,3,0,0,0,Arts,Bachelors,31-35,1,0,0,Hybrid,Tier1_City,5,5,3,1,3,2,3,31.91,Finance,2,2,3,4,4,1,3,5,1,5,0,1,5,5,46.87
Chemistry,Game Developer,2.722516711952173,5,2,2,1,7,0,3,1,2,1,2,1,3,1,Science,Bachelors,18-24,2,0,0,Office,Tier3_City,2,1,4,4,4,1,2,49.74,Finance,5,2,5,5,2,2,4,5,4,3,1,0,4,3,48.63
Computer Science,Music Teacher,2.909262100341864,9,1,2,0,3,0,3,0,3,2,3,0,2,0,Science,Bachelors,18-24,0,1,41,Flexible,Tier2_City,5,1,2,1,0,5,5,7.23,Manufacturing,2,4,5,1,0,1,5,3,3,3,0,0,4,4,35.74
Finance,Musician,2.765231121807173,1,2,4,0,7,1,1,4,0,3,2,4,2,1,Commerce,High School,31-35,13,1,36,Hybrid,Tier1_City,1,5,0,3,5,1,4,41.13,Healthcare,5,5,2,4,1,5,1,5,1,1,1,0,2,2,50.05
Law,Teacher,3.5001657347183146,7,1,4,0,9,1,2,3,4,3,3,0,3,1,Arts,Masters,36-40,6,0,0,Remote,Tier1_City,4,4,2,2,1,5,4,46.89,Education,4,4,2,4,0,2,2,1,3,3,0,0,1,5,62.57
Architecture,Biotechnologist,4.7599050567988375,1,1,0,1,5,0,4,0,2,0,3,0,0,0,Interdisciplinary,Bachelors,25-30,5,0,0,Flexible,Any,1,4,2,4,4,1,3,45.87,Other,5,1,2,5,5,3,4,5,3,1,0,0,1,5,48.81
Marketing,Actuary,3.924175871908031,6,2,0,1,1,0,0,2,1,0,0,0,2,1,Commerce,Masters,25-30,4,0,0,Remote,Tier1_City,3,4,2,1,3,4,2,29.35,Healthcare,3,4,3,4,0,1,1,3,2,1,0,0,3,3,34.18
Chemistry,Conductor,2.626045628367246,8,1,1,0,1,1,2,2,2,2,2,3,3,1,Science,Bachelors,18-24,5,1,11,Remote,Tier3_City,1,2,4,1,0,4,1,18.4,Manufacturing,5,4,5,4,1,0,2,5,5,1,1,1,2,2,51.12
Computer Science,Financial Advisor,4.108592929427637,3,2,4,0,1,0,1,1,2,3,0,2,3,1,Science,Masters,25-30,7,0,0,Hybrid,Tier1_City,1,4,5,1,1,3,4,33.08,Manufacturing,3,2,1,3,3,0,2,4,4,4,0,0,1,4,53.8
Biology,Teacher,4.545614008289872,4,1,4,0,2,0,3,0,0,4,2,0,0,1,Science,Masters,18-24,2,1,55,Hybrid,Tier2_City,1,1,1,2,4,4,3,17.39,Healthcare,5,1,4,3,1,0,3,5,2,1,0,0,5,1,37.59
Engineering,Doctor,3.233107481623943,0,2,1,0,1,1,2,4,0,4,0,3,3,0,Science,Bachelors,31-35,2,0,0,Office,Tier2_City,2,3,4,1,1,5,3,22.38,Manufacturing,2,1,5,3,1,3,5,3,3,5,1,1,3,2,49.39
Engineering,Forensic Psychologist,3.3590068291675257,5,1,1,1,4,0,3,2,1,0,4,1,4,0,Science,Bachelors,25-30,11,1,48,Hybrid,Tier2_City,2,3,4,5,5,1,3,23.95,Other,5,3,3,5,4,2,1,4,3,2,0,0,5,3,61.16
Music,Curriculum Developer,2.944082292891376,5,0,0,1,9,0,1,2,1,3,2,0,0,0,Arts,Bachelors,36-40,4,0,0,Remote,Tier1_City,1,1,0,5,2,5,2,17.19,Tech,1,2,2,4,0,3,3,2,2,3,0,0,4,4,44.92
Business,Conductor,4.149642189453148,7,2,4,0,3,1,4,4,3,2,2,0,2,0,Commerce,Bachelors,31-35,4,1,10,Hybrid,Tier1_City,3,4,5,1,3,3,3,19.07,Finance,5,4,4,5,0,3,3,1,4,5,0,1,2,3,59.69
Physics,Fluid Mechanics Engineer,2.636553663698394,5,2,3,0,4,1,0,3,1,4,0,2,3,0,Science,Bachelors,36-40,13,0,0,Office,Tier3_City,3,3,0,5,4,3,5,3.34,Education,2,3,4,5,1,3,5,5,5,1,1,0,5,5,58.29
Chemistry,Forensic Psychologist,2.613335918698179,8,1,1,0,0,1,0,3,2,2,0,1,0,0,Science,Masters,25-30,10,1,8,Office,Tier1_City,5,1,0,4,4,0,1,16.96,Manufacturing,2,3,4,2,5,4,4,3,1,5,1,1,2,3,56.94
Biology,Judge,4.571192385495702,7,2,1,1,9,1,1,2,4,1,2,4,1,1,Science,Bachelors,18-24,0,0,0,Hybrid,Tier2_City,1,4,1,5,0,4,3,25.2,Education,5,4,1,1,3,3,3,1,5,5,0,1,4,5,48.1
Finance,Organic Chemist,2.76813228637076,0,1,3,0,2,0,0,0,4,0,2,3,3,0,Commerce,PhD,40+,3,0,0,Remote,Tier3_City,5,2,2,1,0,2,2,11.13,Finance,5,1,2,2,4,1,4,4,5,5,0,0,4,1,54.66
Medicine,Legal Analyst,2.659301669103816,5,1,3,1,0,0,4,2,0,0,4,1,3,0,Science,Bachelors,31-35,8,1,45,Hybrid,Tier3_City,4,3,1,3,0,2,1,40.86,Other,5,2,2,1,3,2,5,3,2,4,1,1,3,3,49.11
Education,Electrical Engineer,3.1848626127047224,4,1,2,1,1,1,3,4,2,4,0,1,2,1,Arts,PhD,36-40,7,1,54,Remote,Tier1_City,3,4,2,4,1,0,1,28.27,Healthcare,4,2,2,2,3,0,3,5,2,2,0,1,5,4,55.21
Engineering,Physician Assistant,2.72226887270468,9,0,2,0,7,1,3,1,3,3,1,2,4,0,Science,Bachelors,18-24,2,0,0,Remote,Tier2_City,4,4,1,2,3,1,4,40.31,Other,3,4,2,4,4,5,1,5,2,4,0,1,4,3,49.16
Medicine,Architectural Technologist,4.367678753957876,5,2,1,0,3,0,0,0,2,1,0,1,2,1,Science,Masters,25-30,4,0,0,Office,Tier2_City,4,3,5,1,1,0,3,9.02,Finance,5,2,5,5,5,4,4,2,4,1,0,1,5,5,39.17
Business,Paralegal,4.034183405343116,2,0,4,1,8,1,1,2,4,1,2,1,4,0,Commerce,Bachelors,31-35,4,1,37,Hybrid,Tier1_City,1,4,4,2,3,1,3,41.56,Education,5,5,4,2,5,2,5,1,2,5,1,1,2,4,49.62
Architecture,Biomedical Engineer,3.448696481159274,1,0,0,0,2,1,0,4,0,3,2,3,4,1,Interdisciplinary,Bachelors,18-24,6,1,24,Hybrid,Tier1_City,3,5,4,3,4,4,2,48.04,Tech,3,3,4,2,4,2,2,5,2,2,0,0,3,1,46.94
Music,Social Media Manager,4.272954196677985,2,0,0,0,0,1,1,2,0,1,0,0,2,0,Arts,Masters,25-30,7,0,0,Office,Tier1_City,5,5,2,2,1,4,5,19.57,Healthcare,1,3,4,4,3,3,3,4,2,5,1,0,4,4,47.33
Education,Judge,4.020843377453467,3,2,2,1,2,1,2,1,0,1,1,3,4,1,Arts,Bachelors,25-30,8,0,0,Hybrid,Tier2_City,4,2,2,1,1,3,5,16.35,Manufacturing,4,5,3,5,5,0,3,4,3,1,1,0,5,3,43.52
Physics,Chemist,2.977299953916168,3,1,3,1,4,1,0,2,2,2,4,1,4,1,Science,Masters,18-24,6,1,7,Remote,Tier3_City,1,1,2,1,1,3,4,33.4,Tech,4,2,2,1,3,2,3,4,4,3,1,0,4,4,50.64
Computer Science,Urban Planner,4.685755736126552,4,0,4,1,9,1,4,1,4,4,3,3,0,1,Science,Masters,18-24,14,0,0,Remote,Any,2,5,3,3,2,3,5,32.89,Finance,1,1,5,2,3,1,1,4,1,3,1,1,5,5,66.76
Education,Ecologist,4.95780304115037,6,2,1,0,4,0,0,1,0,3,0,2,2,1,Arts,Bachelors,25-30,1,1,52,Remote,Tier3_City,3,5,0,1,5,3,2,8.29,Education,3,5,5,1,5,0,1,1,5,2,0,1,3,2,36.09
Medicine,Aerospace Engineer,2.6633170001846027,6,0,1,1,3,1,2,3,4,2,0,3,4,0,Science,Bachelors,18-24,7,1,38,Flexible,Tier2_City,2,2,3,3,3,2,4,46.56,Education,3,5,3,3,0,1,2,2,1,5,0,1,5,2,57.28
Business,Legal Secretary,2.62778207895712,0,2,0,1,5,0,3,3,4,1,4,4,4,0,Commerce,Masters,31-35,7,1,46,Office,Any,5,5,3,3,3,3,3,25.52,Education,2,3,3,2,0,4,3,2,4,5,1,1,3,1,73.5
Medicine,Music Therapist,4.107026597759107,7,1,3,0,3,0,3,4,3,1,3,0,4,0,Science,Bachelors,18-24,10,1,45,Hybrid,Tier2_City,5,5,4,1,1,3,5,38.93,Finance,3,1,4,5,0,2,5,3,3,5,1,1,2,1,66.91
Art,School Psychologist,3.665789167559768,8,1,2,0,1,1,1,2,2,1,4,4,4,1,Arts,Masters,25-30,12,1,6,Remote,Tier2_City,5,3,5,5,2,3,2,19.89,Healthcare,4,1,4,3,0,4,1,1,5,3,1,1,2,4,65.83
Music,Graphic Designer,4.013402272635935,8,1,0,0,3,0,1,1,2,2,2,0,2,0,Arts,Masters,36-40,13,1,47,Remote,Any,3,2,4,3,1,1,2,15.29,Manufacturing,2,2,4,3,5,1,1,3,2,4,1,1,2,1,57.28
Engineering,Actuary,3.2473233259300835,7,0,3,1,9,1,3,1,3,2,2,0,1,1,Science,Bachelors,25-30,1,1,22,Office,Tier1_City,4,4,2,1,3,5,3,8.23,Tech,5,1,4,2,5,4,2,5,4,3,1,0,4,3,43.46
Biology,Data Scientist,3.3696284328982795,0,0,1,0,8,1,3,1,3,2,2,1,0,0,Science,Bachelors,25-30,12,0,0,Flexible,Tier1_City,1,4,4,5,5,3,2,15.9,Finance,5,2,4,2,4,1,5,3,5,5,0,1,3,4,67.22
Music,Principal,3.79212196355729,1,1,2,0,2,0,4,2,0,3,2,0,1,1,Arts,Masters,31-35,5,0,0,Remote,Tier3_City,4,1,2,3,5,0,4,49.69,Education,5,4,2,3,1,3,4,4,5,3,0,0,5,5,60.32
Engineering,Judge,3.920324986513694,0,2,1,0,2,1,2,4,4,1,2,2,1,1,Science,Bachelors,36-40,12,0,0,Flexible,Any,3,1,5,5,4,3,4,33.92,Manufacturing,2,5,5,2,5,3,1,2,1,4,0,0,1,5,57.74
Business,Sound Engineer,3.387566327333292,7,0,1,0,5,1,2,3,2,3,0,1,2,0,Commerce,Bachelors,18-24,9,1,59,Hybrid,Tier1_City,2,5,5,4,2,3,1,40.73,Education,4,5,2,5,0,4,5,2,5,3,0,0,2,5,61.38
Architecture,Art Director,3.4736460721680342,3,1,1,1,0,0,0,2,1,1,2,3,0,1,Interdisciplinary,Bachelors,25-30,0,0,0,Remote,Tier3_City,1,5,3,4,5,2,3,48.05,Finance,3,2,5,5,3,5,4,2,5,4,1,1,4,4,48.47
Business,Analytical Chemist,3.086283862236081,5,2,3,1,8,1,2,0,1,3,4,1,4,0,Commerce,Bachelors,31-35,10,0,0,Remote,Tier2_City,5,4,0,5,2,5,2,6.71,Education,2,2,1,3,1,5,1,1,1,3,1,0,2,3,54.45
Biology,Mechanical Engineer,3.430230131735787,2,1,1,0,5,0,1,0,0,0,3,2,1,0,Science,Bachelors,25-30,6,0,0,Office,Tier3_City,2,2,4,3,1,3,5,10.74,Finance,4,2,1,2,0,1,1,4,3,1,1,0,2,4,36.92
Education,Inorganic Chemist,3.4025895458632824,1,1,4,1,6,1,3,3,1,3,1,3,0,1,Arts,Bachelors,31-35,9,1,12,Hybrid,Tier1_City,4,3,3,1,4,5,4,46.61,Education,3,5,1,3,2,2,5,3,3,3,1,0,4,3,56.75
Computer Science,Legal Secretary,4.62608213614009,9,2,4,1,2,0,2,3,4,3,1,0,3,0,Science,Masters,40+,1,1,34,Office,Any,1,1,5,2,3,1,3,29.53,Finance,1,2,5,5,2,0,1,5,5,1,1,1,3,4,51.88
Law,Marketing Manager,4.413286085637423,1,0,3,1,9,0,1,3,4,4,1,4,2,0,Arts,Bachelors,36-40,14,1,14,Remote,Any,5,5,2,1,5,4,3,32.84,Education,4,5,3,2,4,4,4,1,4,4,1,1,4,5,71.63
Computer Science,Art Director,3.882131644022468,7,2,4,0,4,1,0,3,0,1,3,3,2,1,Science,Bachelors,25-30,4,0,0,Office,Tier2_City,1,1,4,2,5,5,4,23.1,Manufacturing,1,5,2,5,2,2,1,5,4,1,0,1,2,3,45.8
Finance,Principal,4.969249374454822,0,0,4,1,9,1,3,1,0,2,3,0,2,1,Commerce,PhD,18-24,13,0,0,Remote,Any,4,4,5,2,0,5,1,41.28,Manufacturing,5,3,3,2,4,1,3,1,5,4,1,1,4,4,62.67
Medicine,Music Therapist,3.0746461612199645,3,1,3,0,8,1,4,3,2,4,4,4,1,0,Science,Masters,40+,6,0,0,Remote,Any,3,2,0,3,3,3,3,27.31,Education,5,3,5,4,5,1,4,4,5,2,0,0,5,1,68.86
Medicine,Financial Advisor,2.7839110209829,0,1,0,0,8,1,0,3,2,0,4,4,2,0,Science,Masters,25-30,9,0,0,Remote,Tier2_City,4,4,4,5,5,3,2,41.83,Education,4,4,4,5,5,4,5,1,5,2,1,1,2,2,69.61
Business,Doctor,4.752463976674125,8,1,1,1,3,1,3,3,1,4,0,3,2,0,Commerce,Bachelors,18-24,10,0,0,Office,Any,3,3,2,1,5,3,5,49.63,Finance,1,4,3,1,4,2,5,5,3,4,0,1,5,3,63.87
Chemistry,Pharmacist,3.1803866001126435,3,2,4,0,3,1,3,1,1,0,4,4,1,0,Science,Masters,31-35,14,0,0,Office,Any,5,2,3,5,3,2,5,33.4,Finance,2,1,5,2,5,5,1,1,5,3,0,1,5,5,64.81
Art,Geneticist,2.8679101460658987,3,0,2,1,6,1,4,4,0,0,3,0,3,0,Arts,High School,25-30,14,0,0,Remote,Tier1_City,4,3,5,4,4,4,4,27.85,Finance,3,2,1,4,4,4,4,4,4,1,0,0,1,4,51.7
Marketing,Architect,4.527280245471351,1,2,3,0,4,1,4,4,1,0,0,1,3,0,Commerce,Bachelors,25-30,8,0,0,Hybrid,Tier1_City,4,3,3,3,2,2,3,20.16,Healthcare,5,5,4,4,1,3,5,2,2,5,0,1,1,4,54.29
Education,Chemist,4.659598747573679,9,1,4,1,4,0,4,3,4,3,3,2,3,1,Arts,Bachelors,36-40,13,0,0,Office,Tier1_City,4,2,0,3,3,2,5,12.15,Education,5,1,1,4,1,1,3,1,1,3,1,0,2,3,64.13
Medicine,Lawyer,2.946920969292101,0,1,2,0,6,1,1,3,3,4,2,0,1,1,Science,Bachelors,18-24,0,0,0,Remote,Tier2_City,4,3,0,4,2,2,3,33.86,Other,5,3,3,5,2,3,2,5,2,1,1,0,4,2,37.52
Art,Financial Advisor,4.689978830337145,5,2,1,1,5,0,4,1,4,3,1,1,4,1,Arts,Masters,18-24,8,0,0,Flexible,Tier1_City,3,1,3,1,4,1,4,5.94,Education,5,5,3,1,1,4,3,5,4,4,1,1,2,2,64.91
Chemistry,Special Education Teacher,3.606950273257555,6,1,2,0,9,1,4,1,3,0,0,1,4,1,Science,Bachelors,25-30,10,0,0,Flexible,Tier1_City,3,5,1,4,4,4,1,47.95,Education,4,1,2,4,0,1,3,1,4,4,1,0,5,5,61.06
Computer Science,Architect,2.6912555605041217,2,2,1,0,6,1,2,1,4,1,2,0,1,0,Science,Masters,31-35,4,0,0,Hybrid,Any,2,2,3,1,1,1,5,33.44,Education,4,3,2,3,4,5,4,4,5,4,0,1,2,3,52.25
Marketing,Nurse,4.752271434633883,6,2,3,1,6,0,1,0,3,4,3,1,1,1,Commerce,Masters,18-24,5,0,0,Hybrid,Tier3_City,5,4,2,2,0,1,2,48.09,Finance,1,4,5,2,0,5,1,3,2,3,0,0,3,5,50.94
Chemistry,Special Education Teacher,4.985109098387172,8,1,0,1,8,0,0,3,1,3,4,4,3,1,Science,Masters,25-30,13,0,0,Office,Any,5,4,4,3,4,4,4,15.8,Finance,2,2,3,2,1,4,5,2,2,3,0,0,4,3,64.42
Medicine,Composer,3.100021812766924,5,0,3,1,2,0,2,1,2,1,0,0,4,1,Science,Bachelors,31-35,7,1,21,Remote,Any,3,5,1,1,4,1,1,47.49,Healthcare,1,2,1,1,5,5,1,4,3,1,0,0,4,2,37.69
Marketing,Social Media Manager,4.310155074907815,8,1,3,0,6,1,0,0,0,0,1,1,2,1,Commerce,Masters,36-40,14,0,0,Hybrid,Tier1_City,2,4,3,5,2,4,2,31.77,Finance,2,1,2,1,3,0,4,3,3,2,0,0,4,5,42.62
Engineering,Psychologist,3.666950185836728,7,2,4,1,3,1,4,3,3,4,1,1,3,1,Science,Bachelors,18-24,10,0,0,Remote,Tier2_City,2,5,4,5,4,5,2,41.08,Other,4,3,1,5,1,2,4,5,3,4,1,1,5,3,66.63
Architecture,Graphic Designer,2.581461936562495,0,0,3,0,4,0,4,1,1,2,2,4,1,0,Interdisciplinary,Bachelors,36-40,13,1,45,Flexible,Tier1_City,4,1,5,3,3,5,5,11.41,Education,5,1,5,3,4,1,5,1,2,3,0,1,5,5,60.02
Finance,Biochemist,4.061245225276791,9,1,4,1,2,1,4,3,2,4,3,0,4,1,Commerce,PhD,18-24,1,0,0,Office,Tier2_City,2,4,0,4,1,3,3,26.51,Education,1,3,1,2,3,5,3,5,5,5,0,1,3,1,61.42
Education,Fluid Mechanics Engineer,2.6146647299850097,5,2,1,0,0,1,1,1,0,0,1,3,3,1,Arts,Bachelors,31-35,11,0,0,Remote,Tier1_City,5,4,5,4,1,2,4,29.74,Tech,2,3,1,4,3,1,4,1,1,2,1,1,5,5,40.24
Medicine,Forensic Psychologist,4.004294655321469,6,0,1,0,0,1,1,1,1,0,3,4,3,0,Science,Bachelors,25-30,6,0,0,Hybrid,Tier1_City,1,1,3,1,3,5,2,21.46,Finance,3,2,4,4,4,3,5,2,2,1,0,1,2,3,46.14
Architecture,Data Scientist,2.695515133676609,1,1,4,0,9,1,1,4,3,3,3,0,0,1,Interdisciplinary,Masters,18-24,11,0,0,Hybrid,Tier1_City,3,4,1,4,5,5,5,14.9,Tech,2,4,5,2,5,0,3,1,5,4,1,0,1,1,70.53
Architecture,Game Developer,3.820211270817429,3,1,2,1,4,0,1,4,3,1,0,4,1,1,Interdisciplinary,Bachelors,31-35,3,0,0,Office,Tier2_City,4,4,2,3,4,1,1,45.52,Education,1,4,2,3,2,3,2,5,1,2,1,0,1,2,44.93
Finance,Musician,3.51537886400628,1,2,4,1,1,1,4,3,1,0,2,0,1,0,Commerce,Masters,18-24,8,0,0,Hybrid,Any,2,1,4,1,0,4,2,7.0,Finance,4,5,4,3,5,2,2,3,5,5,1,0,3,1,63.22
Finance,Social Media Manager,3.158018300150279,0,2,0,0,8,1,1,2,0,1,4,2,2,1,Commerce,Bachelors,18-24,5,1,32,Hybrid,Tier1_City,3,1,5,2,4,0,1,10.24,Education,5,3,3,4,5,4,4,3,5,3,1,0,4,2,52.5
Psychology,Human Resources Specialist,4.132544940364416,4,0,3,1,7,0,0,1,2,4,4,2,4,0,Arts,Bachelors,25-30,6,0,0,Remote,Tier2_City,3,1,4,4,1,1,4,18.06,Tech,3,2,3,2,5,0,5,3,3,2,0,1,3,4,49.39
Psychology,Biomedical Engineer,2.942403882276409,0,2,1,0,6,1,1,4,2,3,0,3,4,1,Arts,Bachelors,31-35,10,1,16,Hybrid,Tier2_City,3,4,3,4,0,1,5,46.23,Tech,1,3,2,4,1,3,2,1,2,3,1,1,3,5,51.05
Education,Nurse,4.2994816067468005,6,0,1,1,1,1,4,1,3,2,0,0,3,0,Arts,Bachelors,18-24,5,1,43,Remote,Tier2_City,5,5,2,1,5,4,1,29.52,Manufacturing,4,5,5,5,5,4,1,4,1,3,0,0,3,4,48.86
Engineering,Data Scientist,3.618719515028731,2,0,3,0,5,0,2,2,2,1,2,1,3,0,Science,Bachelors,18-24,10,1,56,Remote,Any,4,5,2,5,2,0,3,20.54,Manufacturing,2,2,3,2,5,5,1,5,3,3,0,1,1,5,55.47
Art,Conductor,3.3669984052724096,0,0,4,0,4,0,1,2,3,3,2,2,1,1,Arts,Masters,18-24,7,1,19,Hybrid,Tier1_City,1,2,0,4,2,0,1,21.93,Finance,4,3,3,3,1,2,5,5,1,3,1,0,3,2,55.57
Art,Interior Designer,3.0987680181068544,5,0,4,1,6,0,4,0,2,1,4,2,0,1,Arts,Bachelors,25-30,5,0,0,Hybrid,Tier1_City,4,2,3,3,4,3,1,42.38,Finance,4,4,3,4,5,2,1,4,1,5,1,0,4,2,56.13
Music,Judge,4.728010079591557,8,2,2,0,4,0,0,4,1,0,3,2,3,1,Arts,PhD,25-30,6,1,32,Flexible,Tier1_City,2,4,5,4,4,1,5,4.26,Finance,5,4,5,1,3,5,4,3,4,3,0,0,5,2,56.28
Law,Financial Analyst,4.122620588810236,0,0,3,0,6,0,3,1,4,4,2,0,4,0,Arts,High School,18-24,7,0,0,Office,Tier2_City,4,4,4,2,0,2,5,3.53,Finance,1,5,3,1,3,0,2,3,1,4,1,0,5,5,49.33
Architecture,Forensic Psychologist,4.44530009353282,4,1,1,0,1,1,1,0,0,2,0,3,0,1,Interdisciplinary,Bachelors,18-24,14,1,26,Hybrid,Tier1_City,5,5,0,4,0,5,2,5.17,Finance,4,4,2,5,4,5,2,5,5,5,0,0,1,1,58.35
Computer Science,Web Developer,4.553438125551217,6,1,1,0,0,1,1,3,4,1,0,0,0,0,Science,Masters,25-30,0,0,0,Flexible,Tier1_City,1,3,4,5,5,1,1,25.05,Finance,2,3,2,1,4,0,5,1,1,5,0,0,4,3,39.73
Art,Architectural Technologist,4.627405438191255,7,2,4,1,2,1,0,2,1,4,4,1,3,1,Arts,PhD,31-35,14,0,0,Office,Tier3_City,4,2,5,4,4,2,1,30.32,Other,2,5,2,5,2,5,3,1,3,1,0,1,5,3,62.04
Finance,Acoustics Specialist,4.316924085737231,8,1,2,1,9,1,1,0,2,3,4,4,0,1,Commerce,High School,31-35,9,1,29,Hybrid,Tier1_City,2,5,0,1,1,2,5,32.35,Finance,5,1,4,5,5,1,2,2,4,3,1,1,1,1,60.52
Education,Doctor,4.387107930228618,2,1,4,1,5,0,4,1,1,0,2,1,0,0,Arts,Masters,36-40,11,0,0,Hybrid,Tier2_City,4,4,5,4,2,4,3,37.36,Tech,4,5,2,3,3,2,3,3,4,2,1,1,3,2,60.38
Biology,Art Therapist,3.0199040781458333,2,1,2,0,3,1,2,3,2,4,1,4,4,1,Science,Masters,18-24,3,0,0,Flexible,Any,5,2,3,5,5,1,5,11.92,Tech,2,4,1,3,1,5,3,5,5,5,1,1,5,4,68.5
Physics,Architectural Technologist,4.1143986347825,3,2,0,0,6,0,0,3,0,3,4,0,3,0,Science,Bachelors,40+,5,0,0,Hybrid,Tier2_City,3,2,5,1,0,4,3,15.33,Tech,2,2,3,2,5,1,5,1,3,1,0,0,5,4,36.63
Chemistry,Risk Analyst,3.88692942195205,0,0,0,1,4,0,0,0,2,4,3,3,0,0,Science,Masters,25-30,0,1,49,Office,Tier2_City,5,2,0,3,1,3,5,14.44,Other,5,5,2,4,4,4,3,2,4,2,0,1,5,1,46.27
Psychology,Interior Designer,3.010469143593061,9,0,0,1,2,1,1,3,0,0,2,2,3,1,Arts,High School,40+,3,0,0,Remote,Tier1_City,5,4,0,1,4,2,4,10.01,Education,4,3,5,1,5,0,3,4,4,2,1,1,3,1,33.89
Business,Nuclear Physicist,4.964261182318694,3,1,4,0,3,0,4,1,2,3,1,4,0,1,Commerce,Masters,25-30,5,0,0,Office,Tier2_City,5,5,2,2,3,0,1,14.49,Healthcare,5,5,5,4,0,1,5,1,4,5,1,0,1,5,65.26
Business,AI Researcher,4.109547455595549,5,1,4,1,2,0,1,3,2,2,2,0,2,1,Commerce,PhD,25-30,6,1,56,Remote,Tier3_City,1,3,5,1,0,2,3,31.84,Education,4,4,5,4,1,2,5,1,2,2,1,0,5,5,53.45
Architecture,Legal Secretary,4.414079645450045,5,0,0,0,5,0,4,2,4,3,0,0,2,0,Interdisciplinary,Masters,25-30,12,0,0,Remote,Tier3_City,4,4,2,3,5,3,4,20.22,Finance,2,5,4,5,5,4,5,5,3,3,0,1,3,4,70.03
Music,Data Scientist,4.338105921872182,2,1,0,1,4,1,4,4,4,4,1,3,3,0,Arts,Bachelors,25-30,5,0,0,Office,Tier2_City,2,2,5,4,3,2,3,39.09,Healthcare,1,3,5,1,3,0,5,3,4,3,1,0,3,2,59.51
Physics,Nurse,2.710935761662202,1,2,3,1,6,1,3,2,4,1,1,3,1,0,Science,High School,36-40,10,1,29,Office,Tier3_City,3,1,4,1,1,4,2,28.21,Tech,2,3,4,3,4,2,5,5,3,2,0,1,1,2,53.84
Psychology,Paralegal,2.661199550264505,7,1,3,0,1,0,4,3,0,2,1,4,2,0,Arts,PhD,31-35,3,0,0,Hybrid,Tier1_City,3,5,2,1,2,1,2,12.97,Tech,1,4,3,4,5,3,1,4,5,3,1,0,1,4,58.93
Architecture,Human Resources Specialist,3.566044796919928,8,2,0,0,6,1,4,3,3,4,4,2,0,1,Interdisciplinary,Bachelors,40+,11,0,0,Hybrid,Tier1_City,1,4,3,1,1,0,1,24.97,Manufacturing,4,3,1,5,4,4,4,3,3,3,0,0,1,4,67.99
Medicine,Conductor,3.5034963270496524,2,2,2,1,0,0,2,0,1,3,4,1,0,1,Science,High School,31-35,12,0,0,Remote,Tier3_City,2,2,3,1,2,4,4,30.89,Finance,4,4,5,3,0,4,2,5,5,5,1,1,1,5,58.17
Medicine,Architect,4.299313708335338,6,0,0,1,5,0,2,2,2,3,4,4,2,1,Science,Masters,25-30,6,0,0,Remote,Tier1_City,3,3,0,3,1,5,4,43.71,Finance,3,5,5,5,2,3,5,1,2,1,1,0,3,4,54.42
Education,Marketing Specialist,3.9326650751677694,3,1,0,1,6,0,1,2,0,1,2,3,1,0,Arts,Bachelors,18-24,9,0,0,Hybrid,Any,2,2,4,5,0,1,2,42.18,Manufacturing,4,5,4,4,1,0,3,5,5,2,0,1,2,5,49.73
Computer Science,Brand Manager,4.1804124959650775,5,1,1,1,9,1,4,2,0,0,2,2,1,0,Science,Bachelors,40+,13,0,0,Remote,Tier2_City,2,2,3,5,0,0,1,23.04,Education,4,1,4,4,4,2,2,3,5,3,0,1,5,4,60.0
Psychology,Interior Designer,4.214551389975767,2,2,3,1,4,1,3,4,4,3,2,1,2,0,Arts,Bachelors,25-30,1,0,0,Hybrid,Tier2_City,4,4,0,1,5,3,2,33.44,Manufacturing,3,4,1,4,2,5,5,2,1,4,1,0,3,2,52.15
Finance,Credit Analyst,4.922218401125758,4,2,3,1,6,1,1,4,2,1,2,1,2,0,Commerce,Bachelors,31-35,5,0,0,Office,Tier3_City,1,3,4,3,3,2,4,17.0,Other,1,2,2,1,5,4,1,2,5,1,0,1,4,1,48.95
Music,Biochemist,4.273781727576992,5,1,3,0,8,1,4,4,2,2,0,2,1,1,Arts,Masters,25-30,4,0,0,Remote,Tier3_City,5,1,3,3,1,0,3,32.75,Finance,4,4,4,1,0,1,3,4,2,4,0,1,2,1,48.48
Biology,Mechanical Engineer,3.0937890765375493,4,1,1,1,2,1,2,2,3,4,4,2,4,0,Science,Masters,25-30,1,1,28,Remote,Tier3_City,5,4,1,1,1,5,4,45.9,Other,5,5,1,4,5,5,1,5,5,2,1,1,4,2,57.28
Art,Music Therapist,3.4573064584051894,8,2,2,0,5,1,2,2,4,0,1,3,4,1,Arts,Bachelors,36-40,8,1,12,Flexible,Tier2_City,3,5,0,2,3,3,1,32.35,Other,4,5,3,1,0,5,4,1,5,5,0,0,5,2,61.9
Architecture,Legal Secretary,4.123046158372413,6,2,0,1,1,1,0,0,1,3,3,1,3,1,Interdisciplinary,Masters,18-24,12,0,0,Office,Tier2_City,3,3,3,1,4,1,4,17.28,Other,4,3,5,5,1,0,4,4,2,5,0,0,4,2,63.44
Music,Legal Secretary,3.4553325470131164,8,2,3,0,7,1,0,3,2,0,0,4,1,0,Arts,Masters,25-30,6,0,0,Remote,Any,1,1,1,2,5,0,5,33.27,Tech,2,1,5,5,1,0,5,4,5,1,1,0,3,1,52.16
Physics,Aerospace Engineer,2.565866314769324,5,2,2,1,0,0,1,0,3,4,3,2,2,0,Science,Masters,18-24,13,1,34,Remote,Any,4,1,5,1,1,3,4,45.43,Manufacturing,4,2,1,2,4,2,4,4,5,2,0,0,5,5,63.96
Chemistry,Financial Advisor,3.427177614861181,3,0,3,0,7,0,1,2,1,2,1,0,2,0,Science,High School,31-35,2,0,0,Office,Tier1_City,3,3,0,2,5,1,5,9.44,Healthcare,4,1,1,3,4,3,5,3,3,3,1,1,3,3,38.48
Chemistry,Advertising Manager,3.329044716075124,5,2,1,0,2,0,0,3,3,0,4,0,1,0,Science,Masters,18-24,14,1,33,Hybrid,Tier3_City,3,5,3,2,1,4,2,25.68,Tech,5,4,5,5,1,4,5,2,1,2,0,0,4,5,53.81
Business,Pharmacist,2.534083038385922,3,0,0,1,0,0,4,1,2,4,3,0,1,1,Commerce,Bachelors,18-24,6,0,0,Office,Any,2,2,0,1,1,2,5,18.09,Education,3,4,4,3,1,5,4,3,5,5,1,1,1,2,60.11
Medicine,Conductor,3.8781764646786456,0,1,1,1,0,0,2,1,2,1,2,1,0,0,Science,Masters,25-30,10,1,32,Hybrid,Tier2_City,1,4,2,2,4,3,4,14.35,Tech,3,5,2,2,5,4,4,2,4,4,1,0,4,1,61.06
Chemistry,Advertising Manager,3.810314607220548,0,0,4,1,0,1,2,1,0,4,2,2,4,1,Science,Masters,25-30,10,0,0,Flexible,Tier2_City,5,5,5,4,0,4,4,21.62,Education,3,3,3,2,4,1,1,5,2,3,1,0,4,2,53.88
Computer Science,Brand Manager,2.848382111339001,0,2,1,1,8,1,4,0,2,1,2,4,1,1,Science,Bachelors,25-30,5,0,0,Office,Tier2_City,1,1,1,5,5,5,4,21.52,Tech,2,2,2,3,5,1,1,3,4,4,0,1,1,3,58.53
Biology,Mechanical Engineer,4.2776520053924205,5,1,4,0,9,1,0,1,1,3,3,3,0,0,Science,PhD,18-24,6,1,14,Remote,Tier1_City,5,5,4,3,3,5,1,12.89,Finance,4,3,2,4,4,1,1,1,4,4,1,0,1,1,63.62
Finance,Geneticist,3.6114421093092486,3,0,1,0,2,1,2,1,1,4,3,2,1,0,Commerce,Bachelors,40+,3,1,54,Hybrid,Tier1_City,2,2,4,2,5,1,2,21.97,Other,1,2,2,3,4,1,3,5,4,4,0,1,1,3,53.29
Architecture,Psychologist,4.483810025008259,7,2,3,1,6,1,2,2,4,2,4,4,2,0,Interdisciplinary,Masters,40+,12,0,0,Hybrid,Tier3_City,4,5,0,2,4,0,5,32.79,Education,1,1,5,5,0,2,3,3,4,3,1,0,4,4,74.7
Law,Legal Secretary,4.3033283709833405,3,0,1,1,9,0,4,1,4,4,3,0,2,1,Arts,High School,25-30,12,1,42,Remote,Tier2_City,5,5,0,3,2,2,3,4.21,Education,5,5,2,3,3,2,2,1,2,5,0,0,2,5,64.76
Law,Nurse,4.61660277531681,8,1,1,0,2,1,0,4,3,0,2,1,4,0,Arts,PhD,31-35,9,0,0,Remote,Tier1_City,2,1,2,2,2,1,5,49.49,Manufacturing,2,3,4,5,1,5,5,5,1,5,1,1,5,1,63.53
Engineering,Marketing Manager,3.902235673838013,5,0,4,1,4,1,3,4,2,4,0,4,4,0,Science,Bachelors,25-30,12,0,0,Remote,Tier2_City,4,5,1,3,4,3,4,16.91,Tech,2,4,4,5,0,1,5,5,4,1,1,1,3,5,63.96
Medicine,Legal Secretary,4.932701629582946,6,2,0,1,8,1,3,2,4,2,4,3,4,1,Science,Bachelors,18-24,7,0,0,Hybrid,Tier1_City,2,4,0,1,4,2,3,32.31,Education,4,5,4,5,4,1,3,1,3,4,1,1,5,2,69.41
Engineering,Zoologist,3.826373898218966,5,1,1,1,7,1,4,0,2,0,2,2,4,1,Science,Bachelors,25-30,7,0,0,Hybrid,Any,4,3,4,4,0,4,3,16.33,Education,1,2,1,4,3,1,3,1,5,4,1,0,4,4,52.99
Psychology,Construction Manager,3.774585035184804,8,0,4,1,8,1,4,1,4,4,0,4,2,0,Arts,Bachelors,25-30,6,1,43,Remote,Tier2_City,3,1,1,4,5,2,5,21.5,Tech,2,5,3,4,3,5,5,4,4,1,0,1,3,3,59.21
Chemistry,Art Therapist,4.617839499486172,3,1,2,1,9,1,4,0,1,4,4,2,1,0,Science,Bachelors,25-30,12,0,0,Office,Tier2_City,4,3,1,5,5,4,5,28.81,Tech,5,4,4,2,0,4,2,3,4,3,1,0,4,1,63.86
Chemistry,Chemical Engineer,4.030631065080599,0,1,2,1,5,1,0,1,4,4,3,2,0,1,Science,Masters,25-30,6,0,0,Hybrid,Tier1_City,5,5,2,2,2,1,5,31.76,Healthcare,1,4,2,1,2,2,4,2,5,1,0,1,2,4,54.41
Medicine,Web Developer,2.839083434280985,8,2,0,0,9,1,3,1,1,3,0,1,0,0,Science,Bachelors,36-40,9,0,0,Flexible,Tier3_City,4,2,5,5,3,0,5,39.21,Manufacturing,2,2,1,4,2,0,2,1,5,2,0,0,3,1,55.31
Music,Landscape Architect,3.574759317900604,5,1,4,0,9,1,4,4,1,0,1,2,1,1,Arts,High School,25-30,12,0,0,Office,Any,1,1,0,1,5,5,2,40.21,Education,4,5,5,4,4,2,3,2,2,3,0,0,4,1,56.12
Physics,Astronomer,4.667411606432781,5,0,1,1,7,0,0,4,4,2,4,1,4,0,Science,Bachelors,31-35,12,0,0,Flexible,Tier3_City,4,5,1,4,1,2,1,27.38,Tech,4,3,4,2,5,5,3,4,5,2,0,1,3,4,64.37
Finance,Industrial-Organizational Psychologist,4.093349473517604,6,1,0,1,4,0,0,3,4,1,1,2,2,1,Commerce,Masters,18-24,7,0,0,Flexible,Tier2_City,2,5,2,1,1,0,1,6.56,Education,4,5,2,2,5,2,4,2,1,2,0,0,5,4,47.24
Marketing,Art Director,3.360684343121118,3,1,0,0,5,0,0,4,4,4,4,3,1,0,Commerce,Masters,25-30,0,1,27,Hybrid,Tier3_City,5,2,4,1,0,0,5,29.22,Healthcare,4,4,2,2,2,5,4,1,3,4,0,0,5,5,53.11
Marketing,Paralegal,2.650428375594763,6,2,4,1,7,0,0,0,1,4,4,4,3,1,Commerce,Masters,25-30,5,0,0,Hybrid,Tier1_City,3,5,2,2,0,5,1,25.45,Healthcare,1,2,5,3,5,4,2,3,4,3,1,1,2,5,55.79
Engineering,Clinical Psychologist,4.794085235394915,8,2,2,1,9,1,4,3,0,1,3,1,3,1,Science,Masters,25-30,1,0,0,Remote,Tier1_City,3,4,2,1,2,2,5,13.12,Education,1,1,1,5,4,5,5,2,2,1,0,1,2,2,43.0
Engineering,Legal Analyst,2.9491147164855924,6,2,0,0,5,1,2,0,4,1,3,0,4,0,Science,Bachelors,31-35,0,0,0,Hybrid,Tier2_City,2,2,5,4,3,2,5,3.48,Manufacturing,2,1,2,4,2,4,5,5,4,5,0,0,2,4,46.47
Education,Manager,4.32836510241378,7,2,0,1,3,0,2,1,4,1,0,1,0,0,Arts,Bachelors,31-35,11,0,0,Remote,Tier1_City,3,1,2,5,3,0,5,17.85,Finance,5,5,3,5,0,1,1,2,1,4,0,1,2,3,54.89
Art,Mechanical Engineer,4.539217598637782,2,2,1,1,3,0,0,3,1,3,1,3,1,1,Arts,Bachelors,25-30,9,0,0,Office,Tier1_City,5,1,0,4,4,3,2,15.2,Education,3,4,4,1,3,3,2,4,4,5,1,1,2,3,58.85
Architecture,Landscape Architect,2.5055601079774856,9,0,3,0,7,0,2,4,2,1,3,0,1,0,Interdisciplinary,Masters,31-35,6,0,0,Remote,Tier2_City,2,3,2,2,0,3,4,25.7,Healthcare,3,5,1,2,1,2,3,4,3,4,1,1,2,2,51.34
Marketing,Credit Analyst,3.3086007053503863,3,1,4,0,5,0,3,2,0,0,4,0,4,1,Commerce,PhD,36-40,5,0,0,Remote,Tier2_City,5,4,4,4,5,2,1,38.8,Manufacturing,4,2,4,1,3,3,1,1,1,2,0,0,5,3,46.82
Physics,Fluid Mechanics Engineer,4.464181928490175,3,2,3,1,2,1,0,4,0,2,1,3,0,0,Science,Bachelors,31-35,4,1,21,Remote,Any,3,4,1,3,1,0,1,23.63,Other,2,3,4,2,2,0,2,3,4,5,1,0,2,2,45.27
Medicine,Human Resources Specialist,3.653346182894106,1,1,2,0,3,0,4,2,2,0,3,4,2,0,Science,High School,18-24,14,0,0,Flexible,Tier1_City,3,1,3,5,5,0,2,47.72,Tech,3,1,5,2,3,1,5,2,5,3,1,0,1,5,63.86
Law,Surgeon,3.871769460917909,5,1,3,0,7,0,2,4,4,0,1,1,1,0,Arts,Bachelors,31-35,4,1,52,Remote,Any,1,5,5,3,1,1,2,13.4,Other,3,5,3,1,2,2,4,1,5,3,0,1,4,3,52.39
Computer Science,Financial Advisor,3.5910219238278565,4,1,2,1,8,0,2,4,4,4,4,2,3,0,Science,Bachelors,18-24,8,0,0,Flexible,Tier1_City,2,4,0,3,2,0,5,13.38,Manufacturing,3,4,3,5,4,4,3,3,3,3,1,0,5,1,69.2
Computer Science,Composer,2.8961556354871374,2,2,1,1,2,0,3,3,3,4,4,4,2,0,Science,Masters,36-40,8,0,0,Remote,Tier2_City,4,4,3,2,1,5,5,31.41,Manufacturing,3,1,5,1,1,4,1,4,1,3,0,0,4,3,62.53
Medicine,Microbiologist,4.041855404359727,8,0,2,1,6,1,2,3,3,1,2,1,1,1,Science,Bachelors,25-30,11,0,0,Office,Tier1_City,2,5,5,1,5,3,4,45.12,Education,3,1,4,3,4,3,4,2,2,4,1,0,5,3,63.12
Biology,Biotechnologist,3.367998741899344,5,1,4,0,8,0,3,0,2,4,2,0,1,1,Science,PhD,25-30,11,0,0,Hybrid,Tier2_City,5,2,5,3,5,1,1,34.58,Manufacturing,2,3,3,4,1,4,3,1,5,3,0,0,5,2,71.85
Medicine,Pharmacist,3.774377907293984,8,1,2,1,3,1,0,1,1,1,1,1,2,1,Science,Bachelors,18-24,5,0,0,Hybrid,Any,3,5,2,4,3,5,2,34.66,Tech,3,5,4,4,4,3,5,2,5,5,1,1,4,5,51.15
Education,Actuary,3.152410616534005,2,1,1,0,6,1,1,3,4,4,3,1,4,1,Arts,PhD,25-30,12,1,47,Flexible,Tier3_City,1,3,0,1,3,3,4,40.9,Other,3,3,1,5,5,1,5,2,4,2,1,1,2,3,76.24
Architecture,Education Administrator,3.379078099633229,7,0,4,0,8,0,4,2,0,0,4,0,0,1,Interdisciplinary,Masters,36-40,14,0,0,Remote,Tier1_City,2,3,4,4,0,5,1,34.43,Education,2,4,5,5,4,3,5,5,1,5,0,0,5,5,60.94
Medicine,Clinical Psychologist,2.572725911475496,4,0,1,1,2,0,2,3,4,3,3,2,0,1,Science,Masters,18-24,2,0,0,Remote,Tier2_City,5,1,3,4,5,4,4,38.69,Healthcare,1,4,5,5,3,2,2,4,5,1,1,1,3,3,63.22
Art,Architectural Technologist,3.27624885631234,2,1,4,1,7,0,0,0,3,2,4,2,0,0,Arts,Masters,25-30,6,0,0,Hybrid,Tier2_City,1,2,1,1,2,2,4,43.71,Tech,1,5,3,1,1,4,3,3,4,1,1,1,2,2,52.62
Architecture,Risk Analyst,4.725694252336067,2,0,0,1,8,1,0,0,0,1,1,3,2,1,Interdisciplinary,Masters,36-40,3,0,0,Office,Tier1_City,1,4,5,1,1,4,5,3.37,Education,1,1,1,1,3,4,2,4,2,3,0,0,4,5,32.71
Marketing,Clinical Psychologist,4.535064988924183,2,2,0,0,3,1,0,1,3,3,0,1,3,1,Commerce,Masters,25-30,4,0,0,Flexible,Any,1,1,4,4,0,2,4,44.62,Education,3,2,4,1,4,2,5,1,2,3,0,0,4,2,41.6
Physics,Legal Analyst,4.104068958870238,3,2,4,1,0,0,2,3,3,2,4,0,3,0,Science,Masters,25-30,6,1,14,Office,Tier1_City,3,1,4,2,4,3,5,13.12,Finance,2,3,3,2,3,0,3,4,5,3,1,0,5,5,61.53
Finance,Software Developer,3.676601671982277,7,0,3,0,6,0,3,0,3,4,3,2,3,1,Commerce,Masters,25-30,14,0,0,Hybrid,Tier2_City,5,4,3,5,4,3,1,45.87,Tech,1,1,4,1,2,1,3,1,5,1,1,0,5,2,66.08
Business,Curriculum Developer,3.610565390053537,7,0,1,0,5,0,3,1,1,3,0,0,1,1,Commerce,PhD,25-30,11,1,19,Hybrid,Tier1_City,1,4,1,5,1,4,1,15.51,Manufacturing,4,4,1,4,5,3,5,4,5,5,0,0,3,3,64.31
Marketing,Art Director,3.614199614498941,9,1,3,0,6,1,2,2,1,0,4,3,3,0,Commerce,Masters,18-24,6,0,0,Hybrid,Tier1_City,3,5,0,2,1,5,5,24.4,Tech,4,4,2,4,4,1,2,1,1,3,1,1,1,4,50.18
Finance,Physical Chemist,4.14004367122558,9,1,1,0,1,1,2,1,1,3,3,4,3,1,Commerce,Masters,18-24,14,0,0,Hybrid,Any,3,3,4,1,1,2,3,46.89,Tech,2,1,3,2,2,2,1,1,5,4,1,1,3,2,65.13
Art,Astronomer,3.549428788417192,6,1,0,1,6,1,3,0,0,4,2,1,0,1,Arts,Masters,31-35,9,0,0,Remote,Tier1_City,3,4,0,4,3,2,4,8.16,Finance,3,1,3,1,5,1,5,2,4,1,0,0,3,3,55.33
Finance,Organic Chemist,3.638783254543805,9,1,3,1,6,0,3,0,4,0,0,0,4,1,Commerce,Bachelors,36-40,7,0,0,Office,Tier1_City,2,5,4,5,1,1,1,38.03,Manufacturing,1,4,5,1,4,0,5,5,2,5,0,0,2,5,46.33
Architecture,Artist,4.21450228139423,0,1,4,1,0,0,0,0,2,2,3,1,3,1,Interdisciplinary,Bachelors,18-24,0,0,0,Remote,Tier3_City,3,3,2,4,4,0,4,21.45,Other,3,3,2,3,2,5,1,5,1,1,0,1,3,2,28.77
Finance,Dentist,3.4295771998021647,4,1,3,1,0,1,3,4,4,1,3,0,4,1,Commerce,Bachelors,18-24,4,0,0,Hybrid,Tier1_City,5,2,5,2,1,5,3,4.13,Finance,1,3,3,3,5,5,1,2,2,4,1,1,1,1,54.55
Music,Marketing Manager,3.221193292802073,3,2,3,0,3,0,0,3,2,4,1,0,0,0,Arts,Bachelors,25-30,14,0,0,Remote,Tier2_City,4,2,4,4,5,5,4,47.14,Finance,5,1,4,4,2,1,3,5,1,4,1,1,5,4,56.1
Chemistry,Investment Banker,4.863350294771808,8,1,1,0,3,1,4,3,2,4,4,2,0,0,Science,Masters,36-40,11,1,20,Hybrid,Tier2_City,2,2,0,2,2,1,3,8.54,Finance,5,5,1,5,4,3,1,3,2,5,1,0,4,3,72.63
Art,Marketing Specialist,2.8642155463708017,0,1,4,0,6,0,2,0,0,0,3,4,0,1,Arts,Bachelors,25-30,8,0,0,Hybrid,Any,1,4,1,1,4,3,2,39.38,Tech,3,4,2,4,2,2,3,2,5,2,0,1,4,1,53.73
Chemistry,Art Therapist,2.62544596769934,2,2,4,1,1,1,3,1,2,1,4,4,1,0,Science,Masters,36-40,14,1,55,Remote,Tier3_City,3,3,3,2,2,4,3,21.06,Other,4,2,5,2,1,0,1,5,5,3,0,0,1,2,66.54
Music,Geneticist,4.245395635773242,2,0,3,1,5,1,4,1,4,0,3,1,3,1,Arts,Bachelors,18-24,6,0,0,Remote,Any,2,3,1,2,4,5,1,41.1,Finance,3,4,5,1,2,0,2,2,4,4,0,1,5,4,55.88
Computer Science,Electrical Engineer,2.714857026715292,4,0,3,1,0,0,4,2,2,2,4,1,4,0,Science,High School,36-40,10,1,11,Remote,Tier2_City,2,2,4,5,0,2,5,38.26,Healthcare,1,3,4,3,4,0,3,2,5,2,1,0,2,3,59.75
Biology,Teacher,2.573651972379042,8,1,3,0,2,0,3,1,4,3,0,2,4,0,Science,Masters,25-30,11,0,0,Remote,Tier1_City,5,1,0,4,5,1,5,32.76,Manufacturing,3,3,1,4,5,4,2,2,2,3,1,0,5,3,62.2
Music,Analytical Chemist,4.094400687368749,0,0,3,1,0,0,0,2,2,1,4,0,3,0,Arts,Masters,31-35,12,0,0,Remote,Tier1_City,1,3,2,5,4,4,4,47.14,Other,3,2,5,2,1,1,1,5,4,2,1,1,2,2,55.88
Engineering,Financial Controller,2.6291543860134867,7,1,3,1,5,1,2,1,0,1,4,2,3,1,Science,Bachelors,25-30,1,1,53,Office,Tier3_City,4,3,1,3,5,4,2,7.65,Manufacturing,1,3,5,5,1,3,2,5,2,4,1,1,2,5,47.68
Art,Physician Assistant,4.123336726311963,5,1,3,1,5,1,3,3,2,4,4,3,3,0,Arts,Masters,31-35,0,0,0,Hybrid,Tier2_City,4,5,2,2,4,5,4,40.53,Other,4,2,1,4,1,4,5,3,3,5,1,0,2,5,65.28
Chemistry,Aerospace Engineer,3.544759834851414,2,2,0,0,9,1,2,4,0,3,3,0,4,1,Science,Masters,18-24,7,0,0,Hybrid,Tier1_City,2,2,3,3,2,0,3,34.53,Finance,5,3,2,1,3,3,1,2,4,4,1,0,5,1,56.41
Education,Organic Chemist,3.178788001152244,9,0,0,0,3,1,4,0,3,4,0,0,3,0,Arts,Bachelors,18-24,8,0,0,Hybrid,Any,2,1,2,5,2,2,5,17.79,Other,1,2,3,1,1,3,3,5,4,4,0,1,2,4,57.86
Education,Chemist,3.7534665807353615,9,0,4,1,9,1,2,3,3,3,0,2,0,1,Arts,Bachelors,25-30,9,0,0,Office,Tier1_City,1,5,3,4,4,4,3,28.66,Tech,3,5,3,3,5,3,1,3,1,3,1,0,5,3,53.02
Medicine,Financial Analyst,3.5325943479789625,3,0,4,0,5,0,0,1,2,1,1,2,4,0,Science,PhD,36-40,4,1,19,Remote,Tier2_City,2,1,2,5,4,2,5,33.3,Other,2,4,1,2,3,3,4,4,2,1,1,1,3,2,42.19
Physics,Digital Marketing Specialist,4.225149782282211,6,2,2,0,7,0,4,4,1,0,4,4,3,0,Science,Bachelors,31-35,13,1,14,Flexible,Tier3_City,3,1,4,4,3,5,5,37.6,Education,3,3,1,5,5,1,5,3,2,5,1,0,4,4,70.4
Physics,AI Researcher,3.723963404034982,3,0,1,1,0,0,2,4,0,1,3,2,4,1,Science,Bachelors,25-30,10,1,28,Flexible,Tier3_City,4,1,2,4,5,1,5,11.79,Education,3,1,1,5,0,1,3,5,2,3,0,0,5,1,61.03
Psychology,Art Director,2.8402999221813605,8,0,0,1,5,0,3,2,2,4,1,1,4,1,Arts,Bachelors,25-30,5,1,49,Remote,Tier1_City,3,4,5,1,5,4,1,7.8,Tech,2,2,4,2,5,3,1,4,5,4,0,1,4,3,61.67
Computer Science,Sound Engineer,3.611750731848777,6,2,0,1,6,0,2,0,2,4,1,1,3,1,Science,Masters,18-24,14,0,0,Office,Tier2_City,5,3,1,2,5,5,3,7.8,Finance,3,2,4,3,2,3,5,1,1,5,0,0,5,1,62.45
Education,Social Media Manager,3.109823032027302,9,1,4,1,2,0,0,4,4,0,3,1,1,1,Arts,Masters,36-40,1,0,0,Remote,Tier1_City,2,3,1,5,5,4,4,16.81,Finance,2,2,1,1,3,0,3,5,1,1,0,0,2,5,40.31
Psychology,Analytical Chemist,3.14906605703632,6,0,3,0,3,0,4,3,2,2,4,2,1,0,Arts,Masters,31-35,10,1,10,Remote,Tier2_City,1,5,1,4,0,1,2,10.25,Healthcare,3,3,4,5,4,4,5,3,2,5,1,0,4,2,68.32
Biology,Illustrator,3.9591475509182006,3,0,0,0,7,0,0,4,0,4,2,1,1,1,Science,Bachelors,31-35,4,0,0,Remote,Tier2_City,5,1,3,5,0,2,4,28.18,Education,4,4,3,2,1,1,3,4,5,4,0,0,2,5,48.84
Architecture,Game Developer,4.066263020285554,6,0,2,1,2,1,3,3,3,2,2,3,1,0,Interdisciplinary,Masters,25-30,11,0,0,Office,Any,5,1,3,5,1,2,3,23.54,Education,5,1,1,3,5,0,5,2,2,5,0,1,3,1,69.63
Education,Mechanical Engineer,3.4085801605035537,4,0,0,0,4,0,0,2,3,2,1,3,2,0,Arts,Bachelors,40+,3,0,0,Office,Tier1_City,1,3,4,4,4,4,2,44.97,Manufacturing,4,2,3,1,4,2,3,3,5,4,0,1,4,4,52.41
Psychology,Biomedical Engineer,3.632610440696924,9,0,0,0,2,1,1,4,2,4,2,0,1,1,Arts,Bachelors,36-40,7,1,55,Hybrid,Tier3_City,5,1,3,3,4,5,4,36.72,Finance,1,2,3,2,1,0,3,5,3,5,1,1,3,5,59.64
Biology,Sound Engineer,4.828107095834193,3,2,3,1,5,1,0,3,4,1,2,3,1,0,Science,Bachelors,31-35,7,0,0,Hybrid,Tier3_City,3,1,4,2,4,1,2,12.67,Tech,1,2,4,3,5,4,4,3,1,5,0,1,2,5,57.29
Law,Physicist,3.208970260382064,9,0,1,0,8,0,0,3,3,0,1,2,1,1,Arts,Bachelors,25-30,13,1,9,Hybrid,Tier2_City,5,1,2,2,4,3,3,5.15,Finance,3,2,5,4,4,2,3,2,3,5,0,0,1,4,57.2
Marketing,Accountant,2.5337152281507564,5,2,3,0,0,1,2,2,3,2,0,1,1,1,Commerce,Masters,31-35,4,0,0,Hybrid,Tier1_City,1,2,0,1,5,2,5,36.33,Finance,1,1,5,2,2,3,4,1,4,1,0,0,3,1,46.59
Engineering,Legal Secretary,3.110145609108941,6,0,2,1,6,0,3,4,1,4,4,2,1,1,Science,PhD,25-30,10,0,0,Flexible,Tier1_City,4,2,1,1,5,3,3,42.75,Healthcare,1,2,2,5,5,0,1,3,1,4,0,0,3,1,76.3
Business,Mechanical Engineer,3.5063282290598137,4,2,2,1,4,0,4,2,3,2,0,1,3,0,Commerce,Bachelors,25-30,7,1,14,Hybrid,Tier3_City,2,2,1,1,0,4,1,35.95,Other,3,1,2,2,2,4,1,5,3,4,1,1,3,3,49.29
Architecture,Financial Advisor,4.096415792177219,2,0,1,0,3,0,3,2,3,1,2,4,4,0,Interdisciplinary,Masters,25-30,5,1,56,Hybrid,Any,1,5,4,2,2,3,2,33.26,Other,3,1,5,1,0,0,5,4,3,1,0,0,3,4,49.93
Architecture,School Counselor,4.333112530440468,4,2,2,1,4,0,3,3,3,3,1,1,2,1,Interdisciplinary,Masters,25-30,9,0,0,Hybrid,Tier2_City,3,1,3,3,3,5,3,14.72,Tech,5,2,1,2,4,4,2,1,4,4,0,1,2,1,67.57
Business,Forensic Psychologist,4.867681661151315,3,0,4,1,2,0,2,1,0,0,1,3,2,0,Commerce,PhD,25-30,5,0,0,Flexible,Any,3,2,5,2,5,5,5,26.25,Healthcare,2,5,5,1,0,0,2,1,5,1,0,0,1,4,47.65
Education,Nurse,3.708506268656728,1,1,2,1,8,0,4,4,3,0,3,2,2,0,Arts,Bachelors,25-30,12,0,0,Office,Tier2_City,4,2,2,2,5,3,5,37.07,Healthcare,3,1,4,3,4,4,1,2,4,5,0,1,5,2,70.64
Chemistry,Conductor,4.64937513925927,1,0,1,1,5,1,0,2,0,0,3,3,2,0,Science,Masters,25-30,14,1,55,Remote,Any,3,4,4,2,5,5,3,12.09,Healthcare,5,5,5,4,2,3,4,1,5,1,1,1,5,3,60.25
Chemistry,Counselor,3.878767975178744,5,2,0,1,7,0,0,3,2,1,3,3,4,0,Science,Bachelors,31-35,12,0,0,Hybrid,Tier1_City,1,5,1,2,2,2,4,25.4,Other,4,1,1,1,0,4,3,1,4,2,0,0,5,4,57.13
Medicine,Brand Manager,4.084318392961871,0,2,2,0,6,1,2,2,1,1,1,3,3,0,Science,Masters,25-30,3,0,0,Remote,Tier3_City,3,2,5,3,2,4,3,8.5,Healthcare,1,3,1,3,1,5,5,1,1,4,1,0,2,5,43.42
Medicine,Fluid Mechanics Engineer,2.8989279591881902,5,0,2,1,6,1,2,0,3,0,2,2,1,1,Science,High School,18-24,9,1,16,Flexible,Tier3_City,4,2,4,1,0,3,5,27.94,Finance,2,2,2,3,5,1,3,5,3,1,0,1,2,2,42.47
Medicine,Biomedical Engineer,4.6208110180083874,6,1,1,0,0,1,4,4,3,2,0,1,0,0,Science,Masters,25-30,11,0,0,Hybrid,Tier3_City,4,2,0,5,5,2,3,29.96,Other,4,3,2,4,5,0,3,1,3,5,0,1,1,1,73.97
Computer Science,Web Developer,4.065320965477914,6,0,1,0,0,0,4,3,1,1,4,4,2,1,Science,Bachelors,36-40,10,0,0,Remote,Tier3_City,5,4,0,1,3,3,1,28.16,Other,3,1,1,5,2,2,2,3,5,2,0,0,5,3,71.34
Medicine,School Counselor,3.847949336726973,7,0,0,1,9,1,0,3,4,0,4,0,2,1,Science,Bachelors,31-35,2,1,42,Hybrid,Tier1_City,5,4,0,1,4,2,4,25.06,Manufacturing,4,3,3,5,3,2,1,1,4,2,1,0,5,1,50.71
Chemistry,Game Developer,3.120775347897351,4,0,4,0,6,0,3,4,1,4,1,3,2,1,Science,Masters,25-30,8,1,44,Hybrid,Tier2_City,3,5,2,5,5,5,3,30.61,Finance,5,2,2,2,2,2,4,2,2,1,1,0,5,4,57.27
Medicine,Music Therapist,2.882356840569029,5,1,2,1,0,0,0,2,1,1,2,3,4,1,Science,Masters,36-40,4,1,39,Hybrid,Tier1_City,3,1,0,2,0,5,5,49.85,Healthcare,3,2,4,5,2,4,2,1,1,5,1,0,4,5,45.5
Business,Cybersecurity Analyst,4.163446472249937,3,1,1,0,6,1,2,4,0,0,3,2,2,1,Commerce,Masters,18-24,9,0,0,Remote,Tier1_City,3,1,2,3,0,4,3,32.26,Healthcare,3,1,3,2,3,5,3,3,2,1,0,1,5,4,49.92
Law,Analytical Chemist,4.780740931377062,7,1,0,0,7,0,3,2,1,3,0,4,4,1,Arts,Masters,40+,9,1,29,Remote,Tier1_City,3,5,5,3,3,5,3,38.37,Manufacturing,2,1,4,1,4,2,3,2,3,5,1,0,4,4,62.79
Business,Biotechnologist,4.911854610701632,8,2,2,0,4,1,3,2,3,3,0,0,0,0,Commerce,Bachelors,18-24,3,1,21,Remote,Tier1_City,5,1,4,1,1,1,2,12.03,Education,5,5,4,1,3,4,1,5,4,2,1,0,4,3,44.47
Music,Art Director,4.714309488280131,8,2,4,1,2,1,1,1,2,4,1,4,3,0,Arts,Bachelors,18-24,5,0,0,Remote,Tier2_City,1,3,2,5,0,2,3,27.91,Tech,1,4,1,2,4,2,4,2,5,2,0,0,2,5,50.38
Finance,Landscape Architect,2.6149890717592426,4,1,4,0,2,0,0,4,2,1,1,4,0,1,Commerce,Bachelors,25-30,13,0,0,Hybrid,Tier2_City,1,1,1,4,2,2,1,3.35,Healthcare,4,3,3,4,0,2,1,3,5,4,0,0,1,5,61.85
Architecture,Fluid Mechanics Engineer,2.856435272391952,8,1,4,1,9,1,1,2,3,2,1,1,0,1,Interdisciplinary,High School,25-30,3,0,0,Office,Tier1_City,1,4,3,2,2,3,5,4.48,Healthcare,2,5,2,4,0,5,5,2,5,5,1,1,5,2,50.79
Psychology,Nurse,4.653937282716594,6,0,2,1,8,0,4,2,4,1,1,3,1,0,Arts,Masters,25-30,14,1,34,Remote,Tier2_City,5,4,0,1,4,4,2,18.16,Finance,2,3,1,5,0,3,5,4,3,5,0,0,4,1,76.29
Physics,Principal,3.9822694579537568,9,2,4,0,3,1,4,3,2,4,1,0,0,1,Science,Masters,31-35,5,1,47,Remote,Tier1_City,1,2,3,3,0,0,3,24.93,Healthcare,3,2,5,1,3,3,2,3,1,4,0,0,2,2,47.87
Law,Special Education Teacher,4.919653156432998,5,1,0,1,9,0,4,2,0,1,0,4,4,1,Arts,Masters,36-40,9,1,17,Office,Tier1_City,1,4,4,5,4,5,4,30.05,Healthcare,4,1,2,1,4,3,1,2,2,5,0,0,5,5,59.39
Music,Digital Marketing Specialist,2.9257188151670697,5,0,1,1,0,1,1,4,4,2,2,1,2,0,Arts,Masters,25-30,7,0,0,Flexible,Tier3_City,5,3,2,5,0,0,1,44.74,Tech,2,3,5,4,1,0,3,1,3,2,1,0,4,4,56.59
Law,Inorganic Chemist,3.525594135521954,2,0,4,1,3,0,4,1,2,4,1,3,4,1,Arts,Masters,25-30,7,0,0,Hybrid,Tier1_City,2,3,2,1,3,1,1,39.27,Finance,3,4,1,3,2,4,5,2,4,1,0,0,3,2,56.77
Architecture,Biologist,2.6120668918138312,5,2,2,0,6,0,1,1,2,0,3,2,3,1,Interdisciplinary,Bachelors,18-24,11,0,0,Remote,Tier2_City,3,3,3,4,5,4,1,17.1,Education,3,2,4,4,3,4,2,1,5,4,1,0,1,1,60.34
Music,Physicist,2.962500137664412,8,0,1,1,4,1,2,2,3,1,1,1,1,0,Arts,Bachelors,18-24,5,1,34,Office,Tier1_City,3,2,4,3,0,2,2,37.94,Healthcare,5,2,4,4,0,3,5,4,4,1,0,1,3,4,42.08
Architecture,Mechanical Engineer,4.527097623250823,2,1,2,0,5,0,4,1,2,0,0,4,4,0,Interdisciplinary,Masters,31-35,0,0,0,Remote,Tier2_City,2,1,3,1,1,0,3,28.82,Healthcare,3,5,3,3,1,5,5,5,3,3,1,0,2,5,45.51
Chemistry,Surgeon,2.526338753126979,9,2,4,1,8,1,4,3,3,3,0,2,2,0,Science,Bachelors,18-24,12,0,0,Flexible,Tier1_City,4,2,1,4,2,1,1,39.62,Education,1,4,2,5,4,3,5,3,4,5,1,1,3,5,70.01
Marketing,Paralegal,4.231144930696061,4,1,4,0,6,0,0,4,0,1,4,2,3,1,Commerce,Bachelors,31-35,0,0,0,Flexible,Tier1_City,1,4,0,5,3,4,3,22.32,Manufacturing,5,2,5,2,4,2,5,5,2,4,0,1,1,3,38.0
Finance,Entrepreneur,2.755894016894849,3,0,0,1,4,1,4,3,0,1,3,1,4,0,Commerce,Bachelors,25-30,13,0,0,Hybrid,Tier1_City,2,3,0,2,5,1,4,7.32,Education,5,4,5,5,4,2,1,2,5,3,1,1,5,5,67.06
Physics,Chemist,2.960479937423037,2,2,0,0,9,0,2,1,3,4,1,3,1,1,Science,Masters,18-24,2,0,0,Remote,Tier3_City,1,2,2,3,5,5,3,32.07,Education,1,1,3,3,3,2,3,4,2,5,0,0,3,1,57.02
Finance,Manager,3.331712156015434,3,1,0,0,8,0,1,4,3,4,3,3,3,0,Commerce,Bachelors,25-30,1,1,42,Remote,Tier1_City,2,2,5,3,2,0,3,29.18,Finance,1,4,2,3,2,0,1,2,5,1,1,1,4,1,51.22
Psychology,Architect,4.463357519625732,1,1,1,0,6,0,4,0,4,3,1,4,3,1,Arts,Masters,18-24,0,0,0,Flexible,Tier1_City,3,3,4,4,5,3,3,47.82,Other,2,5,4,5,2,3,2,4,5,1,1,1,5,2,57.15
Computer Science,School Psychologist,2.99244314280862,6,1,3,1,1,1,2,1,2,2,1,0,4,0,Science,Masters,25-30,0,0,0,Office,Tier1_City,1,5,4,1,4,3,5,10.62,Education,2,5,1,2,1,3,2,5,4,4,0,1,2,1,46.49
Music,Legal Analyst,4.2159562359922855,4,2,4,0,0,0,4,0,1,0,2,0,3,1,Arts,Bachelors,31-35,11,0,0,Hybrid,Tier2_City,5,3,2,5,3,4,2,33.84,Finance,1,3,3,5,5,5,2,4,4,1,0,1,5,4,54.57
Engineering,Nuclear Physicist,3.723386812561656,4,0,0,1,9,0,4,4,0,2,2,4,0,0,Science,Masters,25-30,11,0,0,Remote,Tier1_City,3,5,4,4,1,1,3,25.28,Other,2,1,1,1,0,5,3,2,5,1,1,1,2,4,64.89
Music,Curriculum Developer,4.31655628088126,4,1,3,0,0,0,4,2,3,3,1,0,0,0,Arts,Masters,18-24,11,1,33,Hybrid,Tier1_City,3,3,4,2,2,2,1,20.81,Education,1,1,1,1,5,3,1,4,5,5,1,0,5,3,70.09
Psychology,Dentist,3.03469871750085,5,0,3,0,7,0,1,4,2,2,2,0,3,1,Arts,Masters,31-35,5,0,0,Flexible,Any,3,1,0,2,0,0,5,40.34,Healthcare,1,4,3,1,5,2,2,1,4,1,1,0,3,4,47.72
Chemistry,Surgeon,2.535643717019474,8,2,0,1,3,1,4,1,3,1,0,1,2,1,Science,Masters,18-24,6,0,0,Office,Tier1_City,1,5,1,2,0,3,3,41.1,Healthcare,3,5,5,2,5,0,1,1,4,1,0,1,1,2,48.43
Marketing,Legal Analyst,4.99855720329769,9,2,1,1,8,1,4,2,3,0,0,2,0,1,Commerce,High School,31-35,14,1,37,Remote,Tier2_City,4,5,1,4,0,3,5,36.59,Other,2,5,2,2,0,1,3,4,3,4,0,1,4,2,52.92
Architecture,Manager,4.147155890187452,2,0,3,1,0,1,1,2,0,4,0,3,2,0,Interdisciplinary,Masters,25-30,7,0,0,Hybrid,Any,2,2,2,5,3,1,2,6.93,Manufacturing,5,5,5,3,0,1,3,4,4,3,1,0,5,1,56.97
Physics,School Psychologist,2.863263248577232,0,1,3,0,4,1,2,1,2,1,2,2,0,0,Science,Bachelors,25-30,2,1,10,Remote,Tier1_City,2,5,1,3,1,3,5,19.22,Other,5,1,4,4,0,2,2,4,2,1,1,0,5,5,38.77
Engineering,Teacher,2.6977110965628444,9,1,1,1,8,1,0,0,4,0,4,1,3,1,Science,PhD,36-40,0,0,0,Flexible,Tier2_City,5,4,1,1,5,1,1,5.2,Education,2,5,2,2,1,2,1,4,3,3,0,0,4,4,50.45
Architecture,Illustrator,4.73806349679869,1,1,3,1,5,0,2,3,3,1,3,3,4,1,Interdisciplinary,Masters,31-35,4,0,0,Hybrid,Tier1_City,4,2,0,3,1,0,3,19.15,Tech,2,3,3,4,1,5,4,4,2,4,0,1,3,2,56.62
Physics,Ecologist,4.515126926149204,5,1,0,0,1,0,0,1,3,3,3,3,2,0,Science,Masters,18-24,7,0,0,Office,Any,3,2,1,5,1,1,1,33.45,Education,2,2,3,1,4,3,3,1,3,3,0,1,2,4,52.64
Education,Special Education Teacher,4.448304903351634,9,2,0,1,3,1,2,2,0,4,0,1,3,0,Arts,Bachelors,25-30,11,0,0,Remote,Any,2,1,1,3,2,3,4,27.38,Other,2,5,3,1,3,4,2,3,3,4,0,0,3,4,53.63
Education,Ecologist,3.6468819435596567,8,1,4,0,1,0,2,0,0,4,4,3,3,1,Arts,Bachelors,36-40,10,1,28,Remote,Tier1_City,1,2,1,4,3,1,5,36.04,Tech,3,3,1,4,2,2,3,5,5,5,1,0,3,1,69.8
Business,Chemist,2.895173159217542,5,1,2,1,9,1,3,0,2,4,1,4,1,1,Commerce,Bachelors,18-24,13,1,21,Office,Tier1_City,3,2,5,2,0,3,5,28.92,Other,1,3,3,5,5,2,1,1,3,5,1,0,5,1,65.13
Psychology,Social Media Manager,3.6930877579636254,9,2,3,1,4,1,1,3,3,1,2,0,4,0,Arts,Bachelors,25-30,10,0,0,Office,Tier2_City,3,4,5,5,2,5,5,29.12,Education,2,2,4,3,1,1,4,4,1,5,1,1,2,2,52.25
Architecture,Dentist,3.403134327594183,9,0,1,1,4,1,3,1,3,3,3,0,1,1,Interdisciplinary,Bachelors,31-35,3,0,0,Remote,Any,4,2,3,5,5,4,2,27.02,Finance,2,1,4,3,5,5,4,3,3,1,0,0,1,2,50.14
Psychology,Physicist,3.504405819410085,5,1,3,0,4,1,2,1,2,3,3,3,4,1,Arts,Bachelors,31-35,1,1,34,Hybrid,Tier1_City,4,5,1,3,1,3,1,20.12,Healthcare,1,5,3,5,2,2,4,3,3,5,1,1,2,5,53.21
Computer Science,Zoologist,2.520177345944366,0,0,1,0,1,0,0,4,3,1,1,4,0,0,Science,Bachelors,31-35,8,0,0,Hybrid,Any,2,1,3,4,0,3,4,23.99,Tech,1,3,2,4,4,4,4,5,2,3,0,1,4,1,50.8
Marketing,Education Administrator,3.768929952376055,0,0,2,0,6,1,1,4,4,3,3,4,3,1,Commerce,PhD,31-35,11,0,0,Office,Tier3_City,2,4,0,3,3,3,2,8.28,Tech,1,3,4,4,4,3,5,2,3,3,1,1,2,2,75.96
Physics,Musician,3.614206934631615,6,0,4,1,4,1,0,4,2,4,0,2,4,0,Science,Bachelors,31-35,12,0,0,Hybrid,Tier1_City,3,3,1,3,4,4,2,42.22,Education,4,2,2,2,5,4,1,2,4,1,0,0,4,3,57.06
Art,Biomedical Engineer,3.6341895505674207,9,1,4,0,5,0,4,1,2,1,3,0,2,1,Arts,PhD,36-40,8,0,0,Remote,Tier3_City,5,3,4,5,1,5,3,44.79,Healthcare,5,3,2,1,1,0,4,2,2,1,0,0,5,1,49.76
